Affrica	Afrika
Iapan	Japan
Sūðamerica	Sør-Amerika
Norþweg	Norge
Englaland	England
Scotland	Skottland
Wēalas	Wales
Norðerne Īrland	Nord-Irland
Īrland Cynewīse	Irland
Ungerland	Ungarn
Spēonland	Spania
Geānedu Rīcu American	USA
Belgice	Belgia
Letseburg	Luxembourg
Eorðe	Jorden
Līf	Liv
George Washington	George Washington
Finnland	Finland
Swēoland	Sverige
Denemearc	Danmark
Polaland	Polen
Liþþuania	Litauen
Italia	Italia
Swissland	Sveits
Ēastrīce	Østerrike
Grēcland	Hellas
Turcland	Tyrkia
Bēor	Øl
Portugal	Portugal
Europe	Europa
Asia	Asia
Norðamerica	Nord-Amerika
Antarctica	Antarktika
Wikipǣdia	Wikipedia
Niðerland	Nederland
Nīweoforwīcburg	New York
Hwæsingatūn, D.C.	Washington, D.C.
Berlin	Berlin
Los Angeles	Los Angeles
Spearctelle	Datamaskin
Genf	Genève
Betweoxnett	Internett
Barack Obama	Barack Obama
Uruguay	Uruguay
Lunden	London
Æppel	Epleslekten
Paris	Paris
Abraham Lincoln	Abraham Lincoln
Android	Android
Google	Google
Mexico	Mexico
Atlantisc Gārsecg	Atlanterhavet
Sericus Gārsecg	Stillehavet
California	California
Mōnandæg	Mandag
Æfterra Gēola	Januar
Solmōnaþ	Februar
Hrēþmōnaþ	Mars (måned)
Tīw (tungol)	Mars (planet)
Cenia	Kenya
Sigelhearwenaland	Etiopia
Ēastermōnaþ	April
Þrimilcemōnaþ	Mai
Sēremōnaþ	Juni
Mǣdmōnaþ	Juli
Wēodmōnaþ	August
Hāligmōnaþ	September
Winterfylleþ	Oktober
Blōtmōnaþ	November
Gēolmōnaþ	Desember
Tīwesdæg	Tirsdag
Wēdnesdæg	Onsdag
Þunresdæg	Torsdag
Frīgedæg	Fredag
Sæternesdæg	Lørdag
Sunnandæg	Søndag
Lēo	Løve
Francland	Frankrike
Esperanto	Esperanto
Geāned Cynerīce	Storbritannia
Catte	Tamkatt
Cīnan Folclicu Cynewīse	Folkerepublikken Kina
Frencisc sprǣc	Fransk
Fisc	Fisk
Brasil	Brasil
Russland	Russland
Eoferwicscīr	Yorkshire
Sǣ	Hav
Euxinus	Svartehavet
Toronto	Toronto
Alabama	Alabama
São Paulo	São Paulo
São Paulo (rīce)	São Paulo (delstat)
Quebec	Québec
Piza	Pizza
Þēodscland	Tyskland
Hwītrussland	Hviterussland
Þēodsc sprǣc	Tysk
Īsland	Island
God	Gud
Estland	Estland
Sætern (tungol)	Saturn
Ceocōlāte	Sjokolade
2 (getæl)	2 (tall)
Þrīe	3 (tall)
Fēower	4 (tall)
Fīf	5 (tall)
George W. Bush	George W. Bush
Lettland	Latvia
Ucrægna	Ukraina
Cecland	Tsjekkia
Slofacia	Slovakia
Slofenia	Slovenia
Vilnius	Vilnius
Moldofa	Moldova
Rumǣnia	Romania
Pulgaraland	Bulgaria
Rōm	Roma
Macedonia Cynewīse	Republikken Makedonia
Albania	Albania
Grēneland	Grønland
Croatia	Kroatia
Bosnia and Herzegofina	Bosnia-Hercegovina
Godhopa	Nuuk
Azerbaijan	Aserbajdsjan
Andorra	Andorra
Cipros	Republikken Kypros
Georgia (land)	Georgia
Casahstan	Kasakhstan
Melita	Malta
Flandras	Flandern
Monaco	Monaco
Sweartbeorg	Montenegro
Faticanburg	Vatikanstaten
San Marino	San Marino
Cūba	Cuba
Barbados	Barbados
Cǣgbord (spearctellend)	Tastatur
Indonesia	Indonesia
Wolfgang Amadeus Mozart	Wolfgang Amadeus Mozart
Ludwig van Beethoven	Ludwig van Beethoven
Sūðaffrica	Sør-Afrika
Algeria	Algerie
Usbecastan	Usbekistan
Warsaw	Warszawa
Wīn (drinc)	Vin
Wæter	Vann
Holt	Treverk
Feorrsīen	Fjernsyn
Īslendisc sprǣc	Islandsk
Cile	Chile
Iesus	Jesus Kristus
Elvis Presley	Elvis Presley
Wōden (tungol)	Merkur
Stǣr	Historie
Apple Inc.	Apple
Frig (tungol)	Venus
Sprǣc	Språk
Lufu	Kjærlighet
Þunor (tungol)	Jupiter
Uranus	Uranus
Neptune (planēta)	Neptun (planet)
Tungolcræft	Astronomi
Witancræft	Vitenskap
Pluto	Pluto
Montreal	Montréal
Lēohtenstān	Liechtenstein
Plega	Sport
Grantanbrycg	Cambridge
Adolf Hitler	Adolf Hitler
Fyrst Woruldgūþ	Første verdenskrig
Ōðru Woruldgūþ	Andre verdenskrig
Wikibēc	Wikibøker
Augusto Pinochet	Augusto Pinochet
Geanca Cupala	Janka Kupala
Ubuntu	Ubuntu (operativsystem)
Stettin	Szczecin
Rīmcræft	Matematikk
U2	U2
Lǣden	Latin
Bahrain	Bahrain
Armenia	Armenia
Serbia	Serbia
Mōna	Månen
Constantinopolis	Istanbul
Australia	Australia
Bob Marley	Bob Marley
Argentina	Argentina
Peru	Peru
Norþcorēa	Nord-Korea
Cambodia	Kambodsja
Kuiperes gyrtel	Kuiperbeltet
Curān	Koranen
Alladōm	Islam
Lech Wałęsa	Lech Wałęsa
Europisce Gesamnung	Den europeiske union
Woruldwīd Webb	World Wide Web
Wīf	Kvinne
Wætertyge	Akvedukt
Don Quijote	Don Quijote
Megelan	Milano
Burg	By
Napoleon I Francena Cāsere	Napoléon Bonaparte
Uesuuius	Vesuv
Sunne	Solen
Lēohtgēar	Lysår
Sunnlicu Endebyrdnes	Solsystemet
Ostsǣ	Østersjøen
Wisle	Wisła
Tōþ	Tann
Wætertimber	Hydrogen
Wikimedia Commons	Wikimedia Commons
Dæg	Dag
Ēasttimor	Øst-Timor
Niht	Natt
Gēar	År
Hundgēar	Århundre
Rīn	Rhinen
Oslo	Oslo
Katowice	Katowice
1 Ceres	Ceres (dvergplanet)
Ii	Iona
Dubai	Dubai
Folga	Volga
Æðmlyft	Oksygen
Dweligende tungol	Planet
Venetia	Venezia
Naruto	Naruto
Moscow	Moskva
Italisc sprǣc	Italiensk
Cead	Tsjad
Nīwe Sǣland	New Zealand
Indea	India
Īsen	Jern
Willelm Scacaspere	William Shakespeare
Lēad	Bly
Mongolland	Mongolia
Ficgīege	Fiji
Feneswela	Venezuela
Blēobord	Sjakk
Maine	Maine
Hors	Hest
Amsterdam	Amsterdam
Wǣpen	Våpen
Dēor	Dyr
Paraguay	Paraguay
Ecuador	Ecuador
Colombia	Colombia
Strēawberge	Jordbærslekta
Buddendōm	Buddhisme
Bolifia	Bolivia
Coper	Kobber
Plante	Planter
Nīwu Hāmtūnscīr	New Hampshire
Iamaica	Jamaica
Massachusetts	Massachusetts
Connecticut	Connecticut
Henn	Tamhøns
Hawaii	Hawaii
Cēsarēa	Jersey
Swīn	Gris
Īshæf	Nordishavet
Persealand	Iran
Irac	Irak
Alaska	Alaska
Israhēl	Israel
Utrecht	Utrecht (by)
Gemen	Jemen
Clēofanwyrm	Virus
Polisc sprǣc	Polsk
Hascemisc Cynerīce þæs Iordanes	Jordan
Florida	Florida
Arizona	Arizona
Cuwait	Kuwait
Libanus	Libanon
Oregon	Oregon
Utah	Utah
Hriðer	Storfe
Malægsia	Malaysia
Burma	Myanmar
Oman	Oman
Pacistan	Pakistan
Qatar	Qatar
Tennis	Tennis
Saudisc Arabea	Saudi-Arabia
Tāprabane	Sri Lanka
Iosep Stalin	Josef Stalin
Syria	Syria
Plato	Platon
Tacgicastan	Tadsjikistan
Aristoteles	Aristoteles
Thailand	Thailand
Ūtƿeorp	Radio
Turcmenistan	Turkmenistan
Geānedu Arabisc Bregorīcu	De forente arabiske emirater
Fietnam	Vietnam
Sūþcorēa	Sør-Korea
Afghanistan	Afghanistan
J. R. R. Tolkien	J. R. R. Tolkien
Gold	Gull
Bængladesc	Bangladesh
Bleach (manga)	Bleach (manga)
Socrates	Sokrates
Angola	Angola
Tansania	Tanzania
Philippines	Filippinene
Middel Affricanisc Cynewīse	Den sentralafrikanske republikk
Sūþende þǣre eaxe	Sydpolen
Norþende þære eaxe	Nordpolen
Isaac Newton	Isaac Newton
Albert Einstein	Albert Einstein
Geolu	Gul
Tunisia	Tunisia
Simbabwe	Zimbabwe
Beicing	Beijing
Sūþsudan	Sør-Sudan
Botswana	Botswana
Burkina Faso	Burkina Faso
Folcrīcelicu Cynewīse þæs Congwes	Den demokratiske republikken Kongo
Bægwaraland	Bayern
Baden-Wyrttemberg	Baden-Württemberg
Æriþrea	Eritrea
Nīwe Delhi	New Delhi
Iohannes Paulus II Pāpa	Johannes Paul II
Gabon	Gabon
Mohandas Karamchand Gandhi	Mahatma Gandhi
Gambia	Gambia
Guinea	Guinea
Elpendbānrima	Elfenbenskysten
Camerun	Kamerun
Grēnenæs Īega	Kapp Verde
Lesotho	Lesotho
Liberia	Liberia
Libia	Libya
Madagascar	Madagaskar
Mauritania	Mauritania
Morocco	Marokko
Mosambice	Mosambik
Namibia	Namibia
Nigeria	Nigeria
Charles Darwin	Charles Darwin
Uganda	Uganda
Rwanda	Rwanda
Sōmalia	Somalia
Gaius Iulius Caesar	Julius Cæsar
Sudan	Sudan
Swasiland	Swaziland
Hamburg	Hamburg
Heorte	Hjerte
Brægen	Hjerne
Prag	Praha
Bleoh	Blå
Seolfor	Sølv
Tin	Tinn (grunnstoff)
Reddit	Reddit
Elsass	Alsace
Bihar	Bihar
Michigan	Michigan
Puerto Rico	Puerto Rico
Niðerseaxland	Niedersachsen
Hetwaraland	Hessen
Illinois	Illinois
Norþdakota	Nord-Dakota
Brandenburg	Brandenburg
Langbeardnaland	Lombardia
Sūþdakota	Sør-Dakota
Montǣna	Montana
Wyoming	Wyoming
Ierusalem	Jerusalem
Idaho	Idaho
Hwæsingatūn	Washington
Nevada	Nevada
Danais	Don
Indisc Gārsecg	Indiahavet
Caribisc Sǣ	Det karibiske hav
Colorado	Colorado
Tuscania	Toscana
Alpis	Alpene
Gænt	Gent
Chicago	Chicago
The Beatles	The Beatles
Winter	Vinter
Ēawielm	Vår
Efenniht	Jevndøgn
Spēonisc sprǣc	Spansk
Caligardamana	Kolkata
West Bengal	Vest-Bengal
Ātorcoppe	Edderkopper
Virginia	Virginia
Westvirginia	Vest-Virginia
Nīwe Eoforwīc	New York (delstat)
Rhode Īeg	Rhode Island
Ceorfdēor	Insekter
Marianland	Maryland
Delaware	Delaware
Fladimir Lenin	Vladimir Lenin
Ohio	Ohio
Pennsylvānia	Pennsylvania
Uetersen	Uetersen
Augustus	Augustus
Microsoft Windows	Microsoft Windows
Nīwe Cēsarēa	New Jersey
Calpis	Gibraltar
Finnisc sprǣc	Finsk
Indiǣna	Indiana
Selffērende wægn	Bil
Roger Federer	Roger Federer
Georgia (America)	Georgia (USA)
Marcus Aurelius	Marcus Aurelius
Texas	Texas
Puilla	Puglia
Norþcarolīna	Nord-Carolina
Sūþcarolīna	Sør-Carolina
Sicilia	Sicilia
Sardinia	Sardinia
Ligore	Loire
Sigen	Seine
Buenos Aires	Buenos Aires
Mexicoburg	Mexico by
Mississippi	Mississippi
Mississippi ēa	Mississippi (elv)
Mizoram	Mizoram
Tennessee	Tennessee
Abu Dhabi	Abu Dhabi (by)
Nīwe Mexico	New Mexico
Athēnas	Athen
Minnesota	Minnesota
Wisconsin	Wisconsin
Iowa	Iowa
Nebraska	Nebraska
Kansas	Kansas
Hafana	Havanna
Pīpwēod	Tobakk
Missouri	Missouri
Louisiāna	Louisiana
Nagaland	Nagaland
Kentucky	Kentucky
Arkansas	Arkansas
Ælf ēa	Elben
Oklahoma	Oklahoma
Donua	Donau
Hæfel	Havel
Norþsǣ	Nordsjøen
Flēogeball	Volleyball
Uigenna	Wien
Cēapmannahæfen	København
Stoccholm	Stockholm
Helsinki	Helsingfors
Difelin	Dublin
Rēcwīc	Reykjavík
Riga	Riga
Menuþias	Zanzibar
Dantsic	Gdańsk
Frankfurt	Frankfurt am Main
Death Note	Death Note
Biblioþēce	Bibelen
Ho Chi Minh Burg	Ho Chi Minh-byen
Nīwenglisc sprǣc	Engelsk
Andorra la Vella	Andorra la Vella
Đồng Hới	Dong Hoi
Concepcion	Concepción
Cænugeard	Kiev
Ontario	Ontario
Ottawa	Ottawa
Alberta	Alberta
Nīwe Scotland	Nova Scotia
Końskowola	Końskowola
Geocon Landscipe	Yukon
Florentia	Firenze
Ǣt	Mat
Snaca	Slanger
Halifax	Halifax (Nova Scotia)
Quebecceaster	Québec (by)
3. Æfterran Gēolan	3. januar
4. Æfterran Gēolan	4. januar
Región del Biobío (Cile)	Biobío
5. Æfterran Gēolan	5. januar
Arica	Arica
6. Æfterran Gēolan	6. januar
7. Æfterran Gēolan	7. januar
8. Æfterran Gēolan	8. januar
9. Æfterran Gēolan	9. januar
10. Æfterran Gēolan	10. januar
11. Æfterran Gēolan	11. januar
12. Æfterran Gēolan	12. januar
13. Æfterran Gēolan	13. januar
Beormingahām	Birmingham
14. Æfterran Gēolan	14. januar
15. Æfterran Gēolan	15. januar
16. Æfterran Gēolan	16. januar
17. Æfterran Gēolan	17. januar
18. Æfterran Gēolan	18. januar
Rōmānisc Rīce	Det romerske keiserriket
Microsoft	Microsoft
30. Æfterran Gēolan	30. januar
Kurów	Kurów
11. Solmōnðes	11. februar
11. Gēolmōnþes	11. desember
12. Gēolmōnðes	12. desember
17. Gēolmōnðes	17. desember
Wæþ	Forth
Þrittiggēara Orlege	Tredveårskrigen
Benedictus XVI Pāpa	Benedikt XVI
6. Ēastermōnðes	6. april
4. Ēastermōnþes	4. april
Helmut Kohl	Helmut Kohl
17. Ēastermōnðes	17. april
12. Þrimilcemōnþes	12. mai
13. Þrimilcemōnþes	13. mai
20. Þrimilcemōnðes	20. mai
31 Þrimilcemōnaþ	31. mai
6. Mǣdmōnðes	6. juli
1. Mǣdmōnðes	1. juli
18. Mǣdmōnðes	18. juli
Gyldfōtþōðer	Fotball
26. Gēolmōnðes	26. desember
Eallbærnet	Holocaust
IPad	IPad
Madrid	Madrid
Elton John	Elton John
Undersǣbāt	Undervannsbåt
26. Wēodmōnðes	26. august
24. Wēodmōnðes	24. august
2. Hāligmōnþes	2. september
Kassel	Kassel
Canadisc underrīcu	Canadas provinser og territorier
25. Hāligmōnðes	25. september
Santiago (Cile)	Santiago de Chile
1. Winterfylleðes	1. oktober
14. Winterfylleðes	14. oktober
8. Winterfylleðes	8. oktober
7. Winterfylleðes	7. oktober
Oldenburg (Oldenburg)	Oldenburg (Oldenburg)
26. Winterfylleðes	26. oktober
4. Blōtmōnðes	4. november
1. Blōtmōnðes	1. november
Wolfsburg	Wolfsburg
Carl Micela Francena Cyning	Karl den store
Canberra	Canberra
Sydney	Sydney
Grēne	Grønn
Rēad	Rød
Perþ (Australia)	Perth (Australia)
Fȳr	Ild
Westerne Australia	Vest-Australia
Nīwe Sūþwealas	New South Wales
Norþerne Landscipe	Nordterritoriet
Australisc Hēafodbyrig Landscipe	Australian Capital Territory
Fīfeldor	Eider
Nīl	Nilen
Heortfordscīr	Hertfordshire
Comēta	Komet
Antofagasta	Antofagasta
Ancyra	Ankara
Flocc:Bysen	Kategori:Maler
Castro (Cile)	Castro (Chile)
Frencisc Guiana	Fransk Guyana
Chillán (Cile)	Chillán
Amāzanēa	Amazonas
Tybingen	Tübingen
Coyhaique	Coyhaique
Flocc:Bysen Land	Kategori:Maler etter område
Willelmeshæfen	Wilhelmshaven
Copiapó (Cile)	Copiapó
Manama	Manama
Delmenhorst	Delmenhorst
Brandenburg (burg)	Brandenburg an der Havel
Wikipǣdia:Sandbox	Wikipedia:Sandkasse
Wikipǣdia:Inlǣdung	Wikipedia:Introduksjon
Cantabria	Cantabria
Hūs	Hus
Rīmagiefung	Algebra
Mennisc bodiglār	Menneskets anatomi
Osasco	Osasco
Fujairah	Fujairah
Glasgow	Glasgow
Donghoi Lyfthæfene	Dong Hoi lufthavn
Rodor	Ytre rom
Sweartweald	Schwarzwald
Curitiba	Curitiba
Weald	Skog
Flocc:Cliferfētedēor	Kategori:Partåede hovdyr
Talca	Talca
Flothere	Marine
Andalién	Andalién
Cwidbōc	Salomos ordspråk
Rancagua	Rancagua
Confucius	Konfucius
Corbin Bleu	Corbin Bleu
Flocc:Rīmcræft	Kategori:Matematikk
Faroisca Īega	Færøyene
Wendelsǣ	Middelhavet
Flocc:Nīwes Sǣlandes īga	Kategori:Øyer i New Zealand
Cōcnearuness	Cooksundet
Crīstendōm	Kristendom
Windows 8	Windows 8
Gandis	Ganges
Worulddǣl	Kontinent
Fugol	Fugler
Hēafodstōl	Hovedstad
Monzón	Monzón
Portuglisc sprǣc	Portugisisk
Mōnaþ	Måned
Almazán	Almazán
Huang Siānfan	Huang Xian-fan
Kescwisc sprǣccynn	Quechua
Bill Gates	Bill Gates
Iapanisc sprǣc	Japansk
Wīsdōmbōc	Encyklopedi
Hēafodtramet	Portal:Forside
Golf	Golf
Hrōcburhfōtþōðer	Rugby (sport)
Olympisc Gamen	Olympiske leker
Eurasia	Eurasia
Andes	Andes
Durban	Durban
Caspia	Det kaspiske hav
Uictoriamere	Victoriasjøen
Estmere	Wisłalagunen
Babilōn	Babylon
Ēalendisca Īega	Åland
Cægman Īegland	Caymanøyene
Novak Đoković	Novak Đoković
Fortunatus iegland	Kanariøyene
Hrōcburhgesamnunge plega	Rugby union
Ūðwitegung	Filosofi
Flocc:Candidates for speedy deletion	Kategori:Sider som er foreslått raskt slettet
Tē	Te
Hebe Camargo	Hebe Camargo
Gemǣnre ǣhte rǣd	Kommunisme
Wealdlīste rǣd	Anarkisme
Ǣhtwealdes endebyrdness	Kapitalisme
Frēodōmes þōht	Liberalisme
Gilmrǣd	Fascisme
Cofentreo	Coventry
Lodi	Lodi
Ōðre Penisc Gūþ	Andre punerkrig
Cartaina	Karthago
Bryttisc Museum	British Museum
Sund	Svømming
1451	1451
Ellaspontus	Dardanellene
Strǣtburg	Strasbourg
Gytārre	Gitar
Croatisc sprǣc	Kroatisk
Cesena	Cesena
Hāmburgere	Hamburger
Fédération Internationale de Volleyball	Fédération Internationale de Volleyball
20e gēarhundred	20. århundre
Stefan Raab	Stefan Raab
Catalan sprǣc	Katalansk
11e gēarhundred	11. århundre
Gelēaflēasnes	Ateisme
Cynn scī huang	Qin Shi Huangdi
Elisabeþ I Engla Cwēn	Elisabeth I av England
Cynewīse	Republikk
Þēodlices gemǣnscipes rǣd	Nasjonalsosialisme
Nazi Þēodscland	Tysklands historie (1933–1945)
Christopher Columbus	Christofer Columbus
Iacobus Cōc	James Cook
Ēare	Øre
Nasu	Nese
Ēage	Øye
Scēap	Tamsau
Sǣhund	Haier
Sycedēor	Pattedyr
Ǣmette	Maur
Bēo	Bier
Niðerlendisc sprǣc	Nederlandsk
Ǣȝƿyrt	Aubergine
Draca	Drage
Mōdor	Mor
Snāw	Snø
Wæterþōðer	Vannpolo
1865	1865
Napoleon III Francena Casere	Napoleon III av Frankrike
Russisc sprǣc	Russisk
Hloþwig XIV Francena Cyning	Ludvig XIV av Frankrike
Vladimir Putin	Vladimir Putin
Loðwic-Philippus Francena Cyning	Ludvig Filip av Frankrike
Þēodacynewīse	Samveldet av nasjoner
Hlāf	Brød
Taurica	Krim
Līfclēofa	Celle
Blōd	Blod
Īwungplega	Videospill
Rumǣnisc sprǣc	Rumensk
Regn	Regn
Medumweder	Klima
Woruldlicu wearmung	Global oppvarming
Eorþbeofung	Jordskjelv
Museum on Dēoraby	Derby Museum and Art Gallery
Winston Churchill	Winston Churchill
Nelson Mandela	Nelson Mandela
10. gēarhundred	10. århundre
Fȳrbeorg	Vulkan
Wolcen	Sky
Īwungplegtōl	Spillkonsoll
Wind	Vind
Lyfthelm	Atmosfære
Sprǣccræft	Lingvistikk
Flocc:Pulgaraland	Kategori:Bulgaria
Flocc:Francland	Kategori:Frankrike
Flocc:Glīƿdrēam	Kategori:Musikk
Flocc:Bōccræft	Kategori:Litteratur
Fox	Rødrev
Valladolid	Valladolid
Alexander Mæcedonia Cyning	Aleksander den store
Hēaphandþōðer	Håndball
Hugo Chávez	Hugo Chávez
Þēowdōm	Slaveri
Caffig	Kaffe
Meolc	Melk
Beorg	Fjell
Oferswefn	Hypnose
Andrew Johnson	Andrew Johnson
Miami	Miami
Americanisce Ingefeoht	Den amerikanske borgerkrigen
Rio de Janeiro	Rio de Janeiro
Bryttisce Rīce	Det britiske imperiet
Albanisc sprǣc	Albansk
Ucrægnisc sprǣc	Ukrainsk
Crabba (steorra)	Krepsen
Swēonisc sprǣc	Svensk
Denisc sprǣc	Dansk
Norðisc sprǣc	Norsk
Noam Chomsky	Noam Chomsky
Bæmisc sprǣc	Tsjekkisk
Karl Marx	Karl Marx
Lettisc sprǣc	Latvisk
Liþþuanisc sprǣc	Litauisk
Hinduismus	Hinduisme
Wīflicu brēost	Bryst
Mot	Atom
Crēacisc sprǣc	Gresk
Weorcendebyrdness	Operativsystem
Īrisc sprǣc	Irsk
Ambihtlic Cīnisc sprǣc/ᚱᚢᚾ	Mandarin (språk)
C. S. Lewis	C.S. Lewis
Baku	Baku
Hebrēisc sprǣc	Hebraisk
Azeri sprǣc	Aserbajdsjansk
Wilisc sprǣc	Walisisk
Scyttisce sprǣc	Skotsk-gælisk
John Locke	John Locke
Friedrich Nietzsche	Friedrich Nietzsche
Lifere	Lever
Drēag (Fūdū)	Zombie
Gārsecg	Verdenshav
Gautama Budda	Buddha
Premier League	Premier League
Mahomet	Muhammed
Ācweorna	Ekornfamilien
Rēmisc Cirice	Den katolske kirke
Bengalisc sprǣc	Bengali
Tunge	Tunge
Folcland Īegland	Falklandsøyene
Manīeg	Man
Wiht (īeg)	Wight
Heortford	Hertford
Elisabeþ II	Elisabeth II av Storbritannia
ß	ß
John F. Kennedy	John F. Kennedy
Ronald Reagan	Ronald Reagan
Æ	Æ
Ð	Edd
Fernando Alonso	Fernando Alonso
Flocc:Feneswela	Kategori:Venezuela
Þunreshæfen	Tórshavn
11. Hāligmōnþes 2001. torngemōt	Terrorangrepet 11. september 2001
Culfre	Duer
Trēow	Tre
Cīese	Ost
Wīnberge	Druer
Hunig	Honning
Eorþperu	Potet
Searuþræl	Robot
Searucræft	Teknologi
Feorrspreca	Telefon
Lugo	Lugo
Windows 7	Windows 7
Windows Vista	Windows Vista
World Trade Center	Verdens handelssenter i New York
Nelson Rockefeller	Nelson Rockefeller
David Rockefeller	David Rockefeller
One World Trade Center	One World Trade Center
Fidel Castro	Fidel Castro
Rockefeller Center	Rockefeller Center
Flocc:Brasil	Kategori:Brasil
Flocc:Rumǣnia	Kategori:Romania
Hēafodgesceaft	Grunnstoff
Gemot	Molekyl
Cræftlicu endebyrdung	Biologisk klassifikasjon
Lyft	Gass
Lyftcræft	Luftfartøy
Clāðas	Klær
Swēg	Lyd
Paper	Papir
Rīm	Tall
Bere	Bygg (korn)
Nirvana	Nirvana (band)
Weder	Vær (meteorologi)
Land þǣre worulde	Liste over stater
Bera	Bjørnefamilien
John Adams	John Adams
Thomas Jefferson	Thomas Jefferson
James Madison	James Madison
James Monroe	James Monroe
John Quincy Adams	John Quincy Adams
Andrew Jackson	Andrew Jackson
Martin Van Buren	Martin Van Buren
William Henry Harrison	William Henry Harrison
John Tyler	John Tyler
James K. Polk	James Knox Polk
Zachary Taylor	Zachary Taylor
Ǣtweg	Fordøyelse
Kylie Minogue	Kylie Minogue
Āc	Eikeslekten
Pīntrēow	Furuslekten
Āte	Havre
Hwǣte	Hveteslekten
Corn	Korn
Unmeaht	Funksjonshemning
Gerīmbōc	Kalender
Ādl	Sykdom
Gregorisc gerīmbōc	Gregoriansk kalender
Manisc sprǣc	Mansk
Bysen:Stedefindend scite Breten	Mal:Kartposisjon Storbritannia
Millard Fillmore	Millard Fillmore
Franklin Pierce	Franklin Pierce
James Buchanan	James Buchanan
Pireni	Pyreneene
Hālig Rōmānisc Rīce	Det tysk-romerske rike
Mongolrīce	Mongolriket
Oþomanisce Rīce	Det osmanske rike
Cirice Ednīwung	Reformasjonen
Wīcingas	Viking
Sweord	Sverd
Fȳrwǣpen	Skytevåpen
Iberia	Den iberiske halvøy
Fȳrspringend	Sprengstoff
Campwægn	Stridsvogn
Antwerpen	Antwerpen
Brycg (burh)	Brugge
Blæcberige	Bjørnebær
Fenberge	Tranebær
Cīnisc gōsberige	Kiwi (frukt)
Retoromanisc sprǣc	Retoromansk
Īsrēam	Iskrem
Ceace	Kake
Īsbrīw	Sorbet
Dinegisc sprǣc	Navajo (språk)
Meolcbrīw	Yoghurt
Montserrat	Montserrat
Bysen:Location map Greenland	Mal:Kartposisjon Grønland
Wikicynn	Wikispecies
Arabisc sprǣc	Arabisk
Ian Magen	Jan Mayen
Corsica	Korsika
Affricanisc sprǣc	Afrikaans
Santiago de Compostela	Santiago de Compostela
Fiscoþ	Fiske
Iquique	Iquique
La Serena (Cile)	La Serena
Niðerscyttisc sprǣc	Skotsk
Linux (cyrnel)	Linux (kjerne)
Emmen	Emmen (Nederland)
Sofiet Gesamnung	Sovjetunionen
Se Hlāford þāra Hringa	Ringenes herre
Hrūse	Jordskorpen
Sīensearu	Kamera
Gaðes	Cádiz
Fōt	Fot (kroppsdel)
Queen	Queen
Freddie Mercury	Freddie Mercury
Normandig	Normandie
Metallica	Metallica
Wikipǣdia:Fulgōd gewritu	Wikipedia:Utmerkede artikler
Lēoht (dæg)	Dagslys
Wikipǣdia:Se Þorpes Wella	Wikipedia:Tinget
Vermont	Vermont
Jacksonville, Florida	Jacksonville
Eþna	Etna
Æg	Egg
Tibet	Tibet
Handsprecend	Mobiltelefon
Strȳta	Struts
Corēa	Korea
Wesend	Bison
Mameceaster	Manchester
Turcas and Caicos Īegland	Turks- og Caicosøyene
Blēocræft	Broderi
Wulf	Ulv
Major League Soccer	Major League Soccer
Þōðer	Ball
Club de Gimnasia y Esgrima La Plata	Club de Gimnasia y Esgrima La Plata
Nīwu Gecȳþnes	Det nye testamente
Middelseaxe	Middlesex
Dūfedoppa	Pelikaner
Nha Trang	Nha Trang
Podolsk	Podolsk
Pāpa	Pave
Rafael Correa	Rafael Correa
5	5
Louvre	Louvre
Sæfern	Severn
Temes	Themsen
Tirana	Tirana
Motorhead	Motörhead
6	6
Josh Duhamel	Josh Duhamel
Stīðen Āc	Stevenage
Crīstesmæsse	Jul
Bises	Skuddår
Steve Jobs	Steve Jobs
Indo-Europisc sprǣchīred	Indoeuropeiske språk
Breinigerberg	Breinigerberg
Muammar al-Gaddafi	Muammar al-Gaddafi
Tiger	Tiger
Moru	Rotfrukt
Samsunghēap	Samsung
Ēaster	Påske
Germanisca sprǣca	Germanske språk
Windows Mobile	Windows Mobile
GNU Frēo Gewrita Amearcunge Lēaf	GNU fri dokumentasjonslisens
John Kerry	John Kerry
Taiwan (īeg)	Taiwan
Searusprecend	Smarttelefon
Trōia	Troja
Nīwe Eoforwīc (scīrung)	New York (andre betydninger)
Ceafer	Biller
Scōh	Sko
Baðanceaster	Bath
Īrland	Irland (øy)
Bradanford	Bradford
Ceasterscīr	Cheshire
Lonceasterscīr	Lancashire
Norþhymbraland	Northumberland
Dūnholmscīr	Durham (grevskap)
Lincolnscīr	Lincolnshire
Snotingahāmscīr	Nottinghamshire
Dēorabyscīr	Derbyshire
Scrobbesbyrigscīr	Shropshire
Stæffordscīr	Staffordshire
Lægreceastrescīr	Leicestershire
Roteland	Rutland
Norþfolc	Norfolk
Sūþfolc	Suffolk
Grantabrycgscīr	Cambridgeshire
Norþhāmtūnescīr	Northamptonshire
Westmidlandscīr	West Midlands
Herefordscīr	Herefordshire
Wigreceastrescīr	Worcestershire
Wæringscīr	Warwickshire
Beadanfordscīr	Bedfordshire
Cornweal	Cornwall
Bricgstōw	Bristol
Defenascīr	Devon
Sumorsǣte	Somerset
Dorsǣte	Dorset
Gleawcesterscīr	Gloucestershire
Oxnafordscīr	Oxfordshire
Wiltūnscīr	Wiltshire
Hāmtūnescīr	Hampshire
Bearrucscīr	Berkshire
Buccingahāmscīr	Buckinghamshire
Ēastseaxe	Essex
Sūþrīge	Surrey
Cent	Kent
Lundenceaster	City of London
Westmoringaland	Westmorland
Huntandūnscīr	Huntingdonshire
Sūþseaxe	Sussex
Seofon	7 (tall)
Taylor Lautner	Taylor Lautner
Jeremy Renner	Jeremy Renner
Īs	Is
Fæder ūre	Fader vår
Musée d'Orsay	Musée d'Orsay
Hwerhwette	Agurk
Edinburg	Edinburgh
Hwīt	Hvit
Sweart	Svart
Chris Pine	Chris Pine
Lordi	Lordi
6 (getæl)	6 (tall)
Ambihtlicu sprǣc	Offisielt språk
Heortæppel	Tomat
Phong Nha-Ke Bang	Phong Nha-Ke Bang nasjonalpark
Entrena	Entrena
Selena	Selena
NASA	NASA
Merida (Feneswela)	Mérida (Venezuela)
Atlanta	Atlanta
Benito Mussolini	Benito Mussolini
Bermuda	Bermuda
Hēafod	Hode
Weolingtūn (Nīwe Sǣland)	Wellington
Bryten	Storbritannia (øy)
Alfred Nobel	Alfred Nobel
Camb (tō hǣre)	Kam
Lila Downs	Lila Downs
Andrew Garfield	Andrew Garfield
Dottatiger	Gepard
Albany on Nīwum Eoforwīce	Albany (New York)
Ūle	Ugler
Anguilla	Anguilla
Guernsey	Guernsey
Scearpbeorgas	Svalbard
Hrycgdēor	Virveldyr
Nowy Dwór Królewski	Nowy Dwór Królewski
Faroisc sprǣc	Færøysk
Catt	Kattefamilien
Lytel Spēonland	Hispaniola
Harrisburg	Harrisburg
Hamor	Hammer (redskap)
Picilemo	Pichilemu
Bryttiscan Fæmne Īegland	De britiske jomfruøyene
Flēoge	Tovinger
Norða	Arktis
Hund	Hundefamilien
Fresisc sprǣc	Frisisk
Antoni Gaudí	Antoni Gaudí
Cliferfētedēor	Klovdyr
Steorrfisc	Sjøstjerner
Eurasisc bleohcrāwe	Nøtteskrike
Hrōc	Kornkråke
Ēotaland	Jylland
Niþeru Þēodsc sprǣc	Nedertysk
Mölnlycke	Mölnlycke
Coning	Kanin
Cuscan Rīce	Kushriket
Tromsīeg	Tromsø
Sandwīc	Sandwich (Kent)
Eormengyld Niccolò Cusano	Università degli Studi Niccolò Cusano
Montpelier on Uermonte	Montpelier
Geac	Jak
Palistiniscre Frēogunge Þēodnes	Palestinas frigjøringsorganisasjon
Westgermanisca sprǣca	Vestgermanske språk
Taylor Swift	Taylor Swift
Cōcīega	Cookøyene
Brocc	Grevling
Sealterisc sprǣc	Saterfrisisk
Middelasia	Sentral-Asia
Langaland	Langeland
Ofersǣwisc rind	Kanel
Jackson (Mississippi)	Jackson (Mississippi)
Concord (Nīwu Hāmtūnscīr)	Concord
Annapolis	Annapolis
Eald Corēa	Gojoseon
Hreaðemūs	Flaggermus
Ēastrīce-Ungerland	Østerrike-Ungarn
Tarnobrzeg	Tarnobrzeg
Scīr	Fylke
Sandwīc (ǣt)	Sandwich
Spearwa	Spurvefamilien
Eormanrīc	Ermanarik
Francisco Franco	Francisco Franco
Tarja Halonen	Tarja Halonen
Willis Tower	Willis Tower
Cantwaraburg	Canterbury (Kent)
Cīna	Kina
Tracter	Trakt
Englisc lagu	Common law
Seolh	Seler
Ecser	Ecser
Silesisc gereord	Schlesisk
Zhengzhou	Zhengzhou
Foresittend	President
Frencisc Polynesia	Fransk Polynesia
Roðem	Rouen
Crīstesmæsse Īeg	Christmasøya
Bleohfugol	Papegøyefugler
Cambihtere	Kakaduer
Arabea	Den arabiske halvøy
Fȳstlāc	Boksing
Seax	Kniv
Top Gear	Top Gear
Tasmansǣ	Tasmanhavet
Ceroke sprǣc	Cherokesisk
Campwīg be Tannebeorge	Slaget ved Tannenberg (1410)
Īsbera	Isbjørn
Hand	Hånd
Tu Fu	Du Fu
Nīwe Scotta Ēaland	Ny-Caledonia
Cecoslofacia	Tsjekkoslovakia
Lēaf	Blad
Nepal Bhasa	Nepal bhasa
Valparaíso (on Cilan)	Valparaíso
Fugolīeg, Sūþgeorgia	Birdøya
Annenkovīeg	Annenkovøya
Nathalia Dill	Nathalia Dill
Oaxaca	Oaxaca
Tahitisc sprǣc	Tahitisk
Flemisc sprǣc	Flamsk (språk)
Yasser Arafat	Yasir Arafat
Oxnaford	Oxford
Międzyrzec Podlaski	Międzyrzec Podlaski
Tasmania	Tasmania
Creto	Kreta
Saint-Dié-des-Vosges	Saint-Dié-des-Vosges
Eormengyld Oxnafordes	University of Oxford
Þyrla	Helikopter
Sancte Elene Īeg	St. Helena
Nicor	Vanlig flodhest
Egisca Sǣ	Egeerhavet
Anastacia	Anastacia
Eufrāte	Eufrat
James A. Garfield	James Garfield
Persisc Sǣ	Persiabukten
Sand	Sand (materiale)
Cyningestūn (Iamaica)	Kingston (Jamaica)
Lafor	Leopard
Age of Empires	Age of Empires
Tequixquiac	Tequixquiac
Ulysses S. Grant	Ulysses S. Grant
Oklahoma City	Oklahoma City
Meotedisca Mere	Azovhavet
William McKinley	William McKinley
Foresittend þāra Geāndena Rīca	Liste over USAs presidenter
Sūþgeorgia and þā Sūþsandwic Īegland	Sør-Georgia og Sør-Sandwichøyene
Webbsīde	Nettsted
Ealdfresisc sprǣc	Gammelfrisisk
Catalão	Catalão
Grover Cleveland	Grover Cleveland
Ealdhēahþēodisc	Gammelhøytysk
Ealdseaxisc sprǣc	Gammelsaksisk
Satan	Satan
Wordstǣrcræft	Etymologi
Beorglēo	Puma
Arabas	Arabere
Proponditis	Marmarahavet
Ēagduru	Vindu
Chester A. Arthur	Chester A. Arthur
Riffeng	Uralfjellene
Rīcu þāra Geāndena Rīca American	USAs delstater
Pitcearnīega	Pitcairnøyene
Benjamin Harrison	Benjamin Harrison
Rutherford B. Hayes	Rutherford B. Hayes
Wīnlendisc panðer	Jaguar
Sūþaustralia	Sør-Australia
Gotisc sprǣc	Gotisk (språk)
Boise	Boise
Bāt	Båt
Awaisc sprǣc	Guaraní (språk)
Gærsbēam	Bambus
Interlingua	Interlingua
Bosporos	Bosporos
Smyrna	Izmir
Lemburg	Lviv
Cwēneland	Queensland
Siligo	Siligo
Puerto Montt	Puerto Montt
Iane Austen	Jane Austen
Tægcwondo	Taekwondo
Middel Englisc sprǣc	Mellomengelsk
Māorisc sprǣc	Maorisk
Hannibal	Hannibal
Hōrdōm	Prostitusjon
Victoria (Australia)	Victoria (Australia)
Geugoslafia	Jugoslavia
Ætla	Attila
Scrælingas	Amerikanske urfolk og stammefolk
Arancón	Arancón
Willelm Heretoga of Grantanbrycge	William av Cambridge
Toshiro Mifune	Toshiro Mifune
Tallahassee	Tallahassee
Sundorrīcehād	Uavhengighet
Bismarck (Norþdakota)	Bismarck (Nord-Dakota)
Aucland	Auckland
Iohannes Paulus I Pāpa	Johannes Paul I
John Michael Talbot	John Michael Talbot
Acrotiri and Ðecelia	Akrotiri og Dekelia
Arara	Arara
Cnēo	Kne
Willelm I Engla Cyning	Vilhelm I av England
Sīde	Silke
Sint-Truiden	Sint-Truiden
Lēoðlic scātung	Kunstløp
Stefn (līfcræft)	Rekke (biologi)
Heanrig VIII Engla Cyning	Henrik VIII av England
Columbia (Sūþcarolīna)	Columbia (Sør-Carolina)
Xena: Warrior Princess	Xena: Warrior Princess
1880. gēar oþ 1889. gēar	1880-årene
Helena (Montana)	Helena (Montana)
Wælhwelp	Jakthunder
Eormengyld Biobiwes	Universitetet i Bio-Bio
Sufa	Suva
Muntgumniscīr	Montgomeryshire
Eorþmistel	Basilikum
Lēohtfȳsend	Laser
Prēossland	Preussen
Cheyenne (Wyoming)	Cheyenne
Norðerne healftrendel	Nordlige halvkule
Loidis	Leeds
Fūcgī Beorg	Fuji-san
Mūs	Mus (slekt)
Geolurēad	Oransje
Æcs	Øks
Seofonbyrig	Transilvania
Tōl	Verktøy
Alī	Ali ibn Abi Talib
Hrān	Rein
Stānhencg	Stonehenge
Ágreda	Ágreda
Amazonas	Amazonas (Brasil)
Ajaccio	Ajaccio
Rodorcræft	Romskip
Lisa Gerrard	Lisa Gerrard
Thirty Seconds to Mars	Thirty Seconds to Mars
Paulínia	Paulínia
Pierre	Pierre
Crabba	Krabber
God Nerie þā Cwēne	God Save the King/Queen
Meteūtsiht	Diaré
Anna Maria Jopek	Anna Maria Jopek
Horshwæl	Hvalross
Fōrhēafod	Panne
Haile Selassie	Haile Selassie I av Etiopia
Caðum	Caen
Sonygegyld	Sony
Mynet	Mynt
Sūðerne Healftrendel	Sydlige halvkule
Cnihtas þæm Temple	Tempelridderordenen
Americanisc fōtball	Amerikansk fotball
Tōþsticca	Tannpirker
Folcmorðor	Folkemord
Hociȝ	Ishockey
Swīnmūþa	Świnoujście
Īrisc Sǣ	Irskesjøen
Tracia	Trakia
Mongolas	Mongolene
Mǣs	Maas
Talcahuano	Talcahuano
Tahitīeg	Tahiti
Ontynung	Johannes' åpenbaring
Abel Tasman	Abel Janszoon Tasman
Gotan	Gotere
Nettfrumfindend	Uniform Resource Locator
Ænglisc sprǣc	Gammelengelsk
Englisc folc	Engelskmenn
Eoforwic	York
Iron Maiden	Iron Maiden
Asterix	Asterix
Grǣg	Grå
Wearm geard	Tropene
Hwælhuntoþ	Hvalfangst
Sǣcū	Manater
Gregorius Pāpa I	Gregor I den store
Cȳta (lyftcræft)	Drage (leketøy)
Þunor	Tor
Castel Goffredo	Castel Goffredo
Roðos	Rhodos
Sanct	Helgen
Wikipǣdia:FAQ	Wikipedia:OSS
Cycene	Kjøkken
Wæterdraca	Egentlige krokodiller
Hlæstwægn	Lastebil
Carl Wēala Þēoden	Charles, prins av Wales
Villeneuve-d'Ascq	Villeneuve-d'Ascq
Sūþtun on Defnum	Plymouth
Bryttisca Indisca Garsecg Landscipe	Det britiske territoriet i Indiahavet
Dēoraby	Derby (Derbyshire)
Francan	Frankere
Fealcen	Falker
Nightwish	Nightwish
Mattheus se Godspellere	Evangelisten Matteus
Mac OS	Mac OS
Leyden	Leiden
Fiðerlēasere	Kivier
Montehermoso	Montehermoso
Louis the Pious	Ludvig den fromme
Cwēnsǣ	Kvitsjøen
Jim Morrison	Jim Morrison
GNOME	GNOME
Hāt	Varme
Spere	Spyd
Ēadig getæl	Lykkelig tall
Charleston (Westvirginia)	Charleston (Vest-Virginia)
Mynster	Kloster
Oxnaford Englisc Wordbōc	Oxford English Dictionary
Īsearn	Isfugler
Carl XVI Gustaf Swēona Cyning	Carl XVI Gustav av Sverige
Świętochłowice	Świętochłowice
Zac Efron	Zac Efron
Monte Carlo	Monte Carlo
Elba	Elba
The Doors	The Doors
Fylfōt	Hakekors
Clerke Clūdas	Clerke Rocks
Hara	Harer
Rīcisc edisc	Nasjonalpark
Boga	Bue (våpen)
Byrdling	Landskilpadder
Bryttisc landbūnes	Britisk oversjøisk territorium
Handscēotend	Sidevåpen
Brūn	Brun
Hjaltland	Shetland
Byrddæg	Fødselsdag
Æx-in-Profentse	Aix-en-Provence
Gaza	Gaza (by)
Īsbeorg	Isfjell
Ephese	Efesos
Englisc wera rīcisc fōtballtēam	Englands herrelandslag i fotball
Pratibha Patil	Pratibha Patil
Minte	Mynteslekta
Spilcarte	Spillkort
Bysen:Commonscat	Mal:Commonscat
Hālig Land	Det hellige land
Folcland Gewinn	Falklandskrigen
Bēowulf	Beowulf
Marīahæfen	Mariehamn
Hrǣw	Lik
IOS	IOS
Lee Harvey Oswald	Lee Harvey Oswald
Frumtæl	Primtall
Þ	Þ
Orlando	Orlando
Saint Petersburg	St. Petersburg (Florida)
Hereðaland	Hordaland
Sogn and þa Flēotas	Sogn og Fjordane
Meore and Romsdæl	Møre og Romsdal
Troms	Troms
Australisc fōtþōðer	Australsk fotball
Secglēac	Grasløk
Punta Arenas	Punta Arenas
Aaron	Aron
Wu-Tang Clan	Wu-Tang Clan
Osgar I Swēona Cyning	Oscar I
Hwēolrinnung	Sykling
Aquilegia	Aquileia
Hyll	Ås
Beorneslēah	Barnsley
Banff	Banff (Skottland)
Soria (scīr)	Soria (provins)
Harold V Norrena Cyning	Harald V
Þēodlic Dæg	Nasjonaldag
John Key	John Key
Ēadweard I Engla Cyning	Edvard I av England
Sūþerne Thila	Southern Thule
Candelmæssanīega	Candlemas Islands
Vladimír Franz	Vladimír Franz
Ariel Sharon	Ariel Sharon
1050e	1050-årene
Æneid	Æneiden
Forma Frencisce Rīce	Det første franske keiserdømme
Brādford	Bredevoort
Se Holbytla	Hobbiten
Eocene	Eocen
Strǣt	Gate
Superman	Supermann
Heorotbrēr	Geitvedslekten
Wikipǣdia:Fulgōdra gewrita teohhunga	Wikipedia:Kandidatsider
Rætswīn	Marsvin
Iconium	Konya
Emma Goldman	Emma Goldman
Iacobus I Grēatre Bryten Cyning	Jakob I av England
Crīstcirice	Christchurch
Coronel Fabriciano	Coronel Fabriciano
Babsk	Babsk
Englisca Ingewinn	Den engelske borgerkrigen
Bengal	Bengal
Morgenmete	Frokost
1060e	1060-årene
Pippen III Francena Cyning	Pipin den yngre
Carl I (Grēatre Bryten Cyning)	Karl I av England
Ȝealdor/ᚷᛖᚪᛚᛞᚩᚱ	Magi
Cucler	Skje
Geþofted Rīcu American	Amerikas konfødererte stater
Elpendbān	Elfenben
Villarrobledo	Villarrobledo
Temuco	Temuco
Hloðwic I Francena Cyning	Klodvig I
William Wallace	William Wallace
Bundesliga	Bundesligaen i fotball for menn
Fȳrland	Ildlandet
Maria I Engla Cwēn	Maria I av England
Angelcirice	Den engelske kirke
Lencten (tīd)	Fastetiden
Fuþorc	Runer
Beadu Hǣstingum	Slaget ved Hastings
Ēadweard VI Engla Cyning	Edvard VI av England
Jacques-Yves Cousteau	Jacques-Yves Cousteau
Horatio Nelson	Horatio Nelson
Galilēa	Galilea
Gaderscypefāna	Storbritannias flagg
Foldlic clūt	Litosfære
Þūma	Tommel
Ælfrēd Micela	Alfred av England
Hāmlǣrung	Hjemmeundervisning
Teutoburg Weald Beadu	Slaget ved Teutoburgerskogen
Bysen:Cite book	Mal:Kilde bok
O Canada	O Canada
Biobío	Biobío (elv)
Orcanege	Orknøyene
Profentse	Provence
Seaxe	Saksere
Willelm II Engla Cyning	Vilhelm II av England
Limburgisc	Limburgsk
Eallerīca Gotena Cyning	Alarik I
Tygelwīg	Tautrekking
Boētius	Boëthius
Hunigbēo	Honningbier
Abbod	Abbed
Sameramis	Semiramis
Pīp	Tobakkspipe
Aerosol	Aerosol
Gangnihessou	Gangnihessou
Ilfingburg	Elbląg
Mierce	Kongedømmet Mercia
Þēodrīc Ēastgotena Cyning	Teoderik den store
Westseaxena Rīce	Wessex
Hēahland	Det skotske høylandet
Norþhymbra Rīce	Northumbria
Wulfila	Wulfila
Bram Stoker's Dracula	Bram Stoker's Dracula
Angeow	Anjou
2011 FIFA Frēona Woruldceampscipe	VM i fotball for kvinner 2011
Alexander VI Pāpa	Alexander VI
Æppellēaf	Marsfiol
Edward Braddock	Edward Braddock
Cethāmīga	Chathamøyene
Norþīg	Nordøya (New Zealand)
Anne Cwēn	Anne av Storbritannia
Sūþīeg	Sørøya (New Zealand)
Husvik	Husvik (Sør-Georgia)
Dziecinów	Dziecinów
Sunnstede	Solverv
Wynton Rufer	Wynton Rufer
Kara	Kara (band)
Ceadmere	Tsjadsjøen
Getalu Rōmāniscra Cāsera	Liste over romerske keisere
Heantun	Wolverhampton
Wascas	Baskere
Minerva	Minerva
Fȳræg	Bombe
Ashley Tisdale	Ashley Tisdale
Þrondham	Trøndelag
Nīwe Woruld	Den nye verden
Fȳrweorc	Fyrverkeri
Æsc	Askeslekten
Galwæg	Galway
Ēadweard Andettere	Edvard Bekjenneren
Hramsa	Ramsløk
Scīdfarung	Skiidrett
World of Warcraft	World of Warcraft
Byrig þāra Geāndena Rīca	Liste over byer i USA med mer enn 100 000 innbyggere
Nemniendlic cāsus	Nominativ
Folcawanderung	Folkevandringstiden
Slayer	Slayer
Biliþ and lēoþcræft	IMMAGINE&POESIA
Maria Scotta Cwēn	Maria I av Skottland
Indisc rīce	Indias delstater og territorier
Scield	Skjold (beskyttelse)
Henry V Englalandes	Henrik V av England
Universidade Federal de Minas Gerais	Universidade Federal de Minas Gerais
Pulgare	Bulgarere
Lyftscip	Luftskip
Cnut se Micela	Knut II av Danmark
Saturnus	Saturn (gud)
Exanceaster	Exeter
Sanctes Laurentes Ēa	St. Lawrence (elv)
Mundlēow	Vaskeservant
Sūþhjaltland	Sør-Shetlandsøyene
Cartespil	Kortspill
Iscimbag	Isjimbaj
Basu Heorte	Purple Heart
Marianburg	Malbork
Rosseg	Mainland (Orknøyene)
Carl Fǣtta Francena Cyning	Karl den tykke
Þēodisc Āþbēorscipe	Det tyske forbund
Wikipǣdia:How to edit a page	Hjelp:Redigering
Cantwarabyrig eorþbeofung 2011.	Jordskjelvet i Christchurch 2011
Eorðæppelstycce	Pommes frites
Rīnland	Rhinland
Eormengyld Tybingenes	Eberhard-Karls-Universität Tübingen
Blōdmearh	Blodpølse
Timborwyrhta	Tømrer
Anlaf V Norrena Cyning	Olav V
Ēadweard Westseaxna Eorl	Edward, jarl av Wessex
Hacun VII Norrena Cyning	Haakon VII
Ecgbryht	Egbert av Wessex
Earnulf Carendran	Arnulf av Det tysk-romerske rike
Bēda	Beda den ærverdige
Laplandes Gūþ	Lapplandskrigen
Willelm-Alexander Niðerlanda Cyning	Willem-Alexander av Nederland
Bredspearctellend	Nettbrett
Mathusal	Metusalem
Universidade Estadual de Feira de Santana	Universidade Estadual de Feira de Santana
Pontcysyllte Wætertyge	Pontcysyllteakvedukten
Universidade Federal da Bahia	Universidade Federal da Bahia
Centro Federal de Educação Tecnológica de Minas Gerais	Centro Federal de Educação Tecnológica de Minas Gerais
Nēohwæl	Narhval
Ajman	Ajman
Harold Godwinson	Harald II av England
Ȳþrīdung	Surfing
Brū	Øyenvipp
Port:Stǣr	Tadsjikistans flagg
Kiæresburh	Cherbourg-Octeville
CONCACAF	CONCACAF
Searoburg	Salisbury
Lunden Ēage	London Eye
Valdivia	Valdivia
Pachuca de Soto	Pachuca de Soto
Landbūnes	Biland
Rēadingas	Reading (Berkshire)
Grēate Bryten Cynerīce	Kongeriket Storbritannia
Iane Grey Hlæfdige	Lady Jane Grey
Charmed	Charmed
Grammatisc cyn	Kjønn (grammatikk)
Nica Ūphebbung	Nikaopprøret
Brycgāðexe	Broøgler
Hetware	Chattere
Americanisc wera rīcisc fōtballtēam	USAs herrelandslag i fotball
Maywood, Illinois	Maywood (Illinois)
Þrēo Coreaniscu Cynerīcu	Koreas tre kongedømmer
Feðer (blæces)	Penn
Bryttisca Antarctisca Landscipe	Britisk Antarktis
Starcraft	StarCraft
Seofon dēadlica synna	De syv dødssynder
Zavodovski-īeg	Zavodovski Island
Finger	Langfinger
Midwearme geardas	Temperert klima
Angleseg	Anglesey
Niðerseaxisc sprǣc	Vestnedertysk
Māse	Meisefamilien
Penwiðsteort	Land's End
Æðelstān Engla Cyning	Adalstein av England
Ras al-Khaimah	Ras al-Khaimah
Elene Constantinoples	Helena (keiserinne)
Nintendo DS	Nintendo DS
Ēse	Æser
Nīwe Francland	Ny-Frankrike
Englalandes Fana	Englands flagg
Cyclades	Kykladene
Trafalgar Sǣfeoht	Slaget ved Trafalgar
Iosephine Francena Caserin	Joséphine de Beauharnais
Sōlate	Solsikke
Cynelica Sciphere	Royal Navy
Inbærnes	Virak
Difelinscīr	Dublin (grevskap)
Æppelcyrnel (wǣpen)	Håndgranat
Helm	Hjelm
Umm Al Quwain	Umm al-Qaiwain
Nīwes Sǣlandes þēodlīc fōtþōðerhēap	New Zealands herrelandslag i fotball
Ingang:Stǣr	Portal:Historie
The Oval	The Oval (Belfast)
2010 FIFA Woruldceampscipe	VM i fotball 2010
Grīpfealcen	Jaktfalk
Snāwbordfarung	Snøbrett
Ōsgeard	Åsgard
Glīdflēogung	Paragliding
Mageoscīr	Mayo (grevskap)
Blizzard Entertainment	Blizzard Entertainment
Dofras	Dover (England)
Cannae Beadu	Slaget ved Cannae
Herenuma	Krigsfange
Dȳfung	Dykking
Daguerreotype	Daguerreotypi
Dūnholm	Durham (England)
Þrēotīene Landbūnessa	De tretten koloniene
Brenda Song	Brenda Song
Lincoln	Lincoln (England)
Syllīega	Scillyøyene
Smallville (TV endebyrdnes)	Smallville
Helen Clark	Helen Clark
Būr	Husrom
Wēala Þēoden	Prince of Wales
Scōnīeg	Skåne
Milanes Bann	Milanoediktet
Francforta	Pølse i brød
Gelocen boge	Armbrøst
Meremægden	Havfrue
Wichlawscīr	Wicklow (grevskap)
Striuelin	Stirling
Æðelred Unrǣd	Ethelred II av England
Twentig Þūsend Lēowena Under þǣm Sǣ	En verdensomseiling under havet
Baius	Bayeux
Colneceaster	Colchester (England)
Meodu	Mjød
Met (Grammaticcræft)	Grammatisk modus
Sǣelpend	Elefantsel
Grytviken	Grytviken
Fox News	Fox News Channel
Brīw	Grøt
Ēadweard se Ieldra	Edvard den eldre
Iþacige	Ithaka
Baius tæpped	Bayeux-teppet
Montréal Canadiens	Montreal Canadiens
Underburg	Forstad
Sharjah	Sharjah
Antrimscīr	Antrim (grevskap)
Vigdís Finnbogadóttir	Vigdís Finnbogadóttir
Final Fantasy	Final Fantasy
Norrena Cyning	Liste over Norges monarker
Westmynster	Westminster
Ēadmund Æðeling	Edmund I av England
Rachel McAdams	Rachel McAdams
Fermanagh	Fermanagh (grevskap)
Dūnscīr	Down (grevskap)
New Jersey Devils	New Jersey Devils
Philadelphia Flyers	Philadelphia Flyers
Yun Chi-ho	Yun Chi-ho
Sancte Elene Īeg, Upstigeīeg and Tristan da Cunha	St. Helena, Ascension og Tristan da Cunha
Tirowen	Tyrone (grevskap)
Jack Ruby	Jack Ruby
Ardmachusscīr	Armagh (grevskap)
Scene	Shannon
Wīnland	Vinland
Venom (trūðhlōð)	Venom
Luel	Carlisle
Ēadgar Engla Cyning	Edgar av England
Itumbiara	Itumbiara
A Night at the Opera	A Night at the Opera (album)
Queen (album)	Queen (album)
Þunres Hamor	Mjølner
Oben am jungen Rhein	Oben am jungen Rhein
Guinness	Guinness
Scræfclūdas (Sūþgeorgia)	Shag Rocks (Sør-Georgia)
Łobez	Łobez
Liðere	Slynge
Thomas Cranmer	Thomas Cranmer
Tawpomere	Taupo
Hameldūn (Nīwe Sǣland)	Hamilton (New Zealand)
Stǣr þǣre Worulde	Verdens historie
Rēad wulf	Rødulv
Normandisca Forcyme	Normannernes erobring av England
Fif Scīr	Fife
Stǣrwrītere	Historiker
Carolina Hurricanes	Carolina Hurricanes
Nebrond	Nimrod
Tampa Bay Lightning	Tampa Bay Lightning
Scrobbesburh	Shrewsbury
Fæger hǣr	Blond
Napier (Nīwe Sǣland)	Napier (New Zealand)
Myrra	Myrra
Harold III Norrena Cyning	Harald Hardråde
Fisc and styccu	Fish and chips
Middeltūn þǣra de Cahaignes	Milton Keynes
Florida Panthers	Florida Panthers
Washington Capitals	Washington Capitals
Īrisc fōtþōðer	Gælisk fotball
West Loðene	West Lothian
Sūþalpis	Søralpene
Midloðene	Midlothian
Neamere	Lough Neagh
Wyrt	Urt
Maðante	Mantes-la-Jolie
Ēast Loðene	East Lothian
Fermat tæl	Fermat-tallene
Clackmannanscīr	Clackmannanshire
Liccidfeld	Lichfield
Sūþorcanege	Sør-Orknøyene
Rænkīnes hātȝemet	Rankine
Se Fēolagascipe þæs Hringes	Ringens brorskap
Cod	Torskefamilien
Holstānburg	Sisimiut
Micel Ficgīeg	Viti Levu
Ciricewæl	Kirkwall
1984 (bōc)	1984 (roman)
Folcaþing	Folketinget
Underset gamen	Ekspansjonspakke
Elig	Ely
Getalu burga in Þēodsclande	Liste over byer i Tyskland
Innuendo	Innuendo
The Game	The Game (album)
Bancorena burg	Bangor
Gēol	Yule
Washington Redskins	Washington Redskins
Swīma	Svimmelhet
Ægelesburg	Aylesbury
Tristania	Tristania (band)
Wuldor	Ull (norrøn mytologi)
Ēsatrēowþ	Åsatru
Lāmwic	Lerwick
Westgeatland	Västergötland
Rosenrot	Rosenrot (album)
Wīcinga Ieldu	Vikingtiden
Victory (scip)	HMS «Victory»
Sihhem	Nablus
Beatrix Potter	Beatrix Potter
Ēadgar Æðeling	Edgar Ætheling
Grēat Rōmisc Fȳr	Brannen i Roma år 64
Tollund wer	Tollundmannen
Levanger	Levanger
Ynce	Tomme (mål)
Gearwung (plega)	Fysisk aktivitet
Diablo (gamen)	Diablo
Anggun	Anggun
Wīfa rihta forðung	Kvinnerettigheter
Apaxco	Apaxco
Cham	Kam (bibelsk person)
Zune	Microsoft Zune
Nettþōðer	Nettball
Lox	Lynx (andre betydninger)
In	IN
Cnut	Knut (andre betydninger)
Acan tūn	Acton
Eormengyld Ciles	Universitetet i Chile
Offa Miercna Cyning	Offa av Mercia
Engel	Engel
Sasha Cohen	Sasha Cohen
Æðelflǣd	Æthelflæd
Pat Benatar	Pat Benatar
Michelle Kwan	Michelle Kwan
Beate Eriksen	Beate Eriksen
Berhte Cent Cwēn	Bertha av Kent
D.C. United	D.C. United
Eowland	Öland
Starcraft II	StarCraft II: Wings of Liberty
Allan Kardec	Allan Kardec
Diablo III	Diablo III
Sceadu (gyden)	Skade
Diablo II	Diablo II
Atlanta Thrashers	Atlanta Thrashers
The God Delusion	Gud – en vrangforestilling
Canadisc fōtþōðer	Canadisk fotball
Ealra Hālgena Ǣfen	Allehelgensaften
Weorcdæg	Arbeidstid
Leðerhosu	Lederhosen
Vampire Knight	Vampire Knight
Ælfrīc Abbod of Egoneshame	Ælfric av Eynsham
Ælle Sūþseaxna cyning	Ælle av Sussex
Æðelbald West-Seaxna Cyning	Ethelbald av Wessex
Ælfweard West-Seaxes	Ethelweard av England
Rēcels	Røkelse
Ūtwyrp	Kringkasting
Stromnæss, Sūþgeorgia	Strømnes
Woruldlic Gemōt þāra Ciricena	Kirkenes Verdensråd
Blæcesburg, Virginia	Blacksburg (Virginia)
Harriet Miers	Harriet Miers
Ériu	Ériu
Marjorie Estiano	Marjorie Estiano
Ítróttarfelag Fuglafjarðar	ÍF Fuglafjørður
Fotþōðer	Football
Oresundes brycg	Øresundsforbindelsen
Denegield	Danegeld
Spell Twēgra Burga	A Tale of Two Cities
Morbid Angel	Morbid Angel
John Ashcroft	John Ashcroft
Alexander Ovechkin	Aleksandr Ovetsjkin
Orosius	Orosius
Alexis Tsipras	Alexis Tsipras
Dufenal I Scotta	Donald I av Skottland
Constontinus I Scotta Cyning	Konstantin I av Skottland
Wælheall Herig	Walhalla
Æbbandūn	Abingdon (Oxfordshire)
Law & Order	Lov og orden (TV-serie)
Westmannland	Västmanland
Hengest	Hengest av Kent
Moretoin	Mortain
Leaves' Eyes	Leaves' Eyes
Jeanette Biedermann	Jeanette Biedermann
Corn Flakes	Cornflakes
Penda Miercna Cyning	Penda av Mercia
Mælcolm II Scotta Cyning	Malcolm II av Skottland
Ēadgar Scotta Cyning	Edgar av Skottland
Constontinus II Scotta Cyning	Konstantin II av Skottland
Pak Hon-yong	Park Hon-young
Americanisc frēona rīcisc fōtballtēam	USAs kvinnelandslag i fotball
Obituary	Obituary
Berserca	Berserk
Jordan Galland	Jordan Galland
Minoru Yamasaki	Minoru Yamasaki
Īslendisc stæfrǣw	Det islandske alfabetet
Canceler	Kansler
Wīfel	Curculionoidea
Agalloch	Agalloch
Godspell Mattheus	Evangeliet etter Matteus
Ēadweard Cyning Næss	King Edward Point
Palestinisce Landscipas	De palestinske territoriene
Ajattara	Ajattara
James Ēa	James (Virginia)
Ȝ	Yogh
Nazarēth	Nasaret
Rise of Nations	Rise of Nations
Getalu Smallville-belimpdǣla	Liste over Smallville-episoder
Kwara Rīce	Kwara
Windlesōra	Windsor (England)
America's Cup	America's Cup
Rædwald Ēastengla Cyning	Raedwald av East Anglia
Ēadbald	Eadbald av Kent
Oswiu Norþhymbra Cyning	Oswiu av Northumbria
Brian Jacques	Brian Jacques
Agmodesham	Amersham
Paramore	Paramore
Recedham	Rochdale
Illative cāsus	Illativ
Coritiba Foot Ball Club	Coritiba Foot Ball Club
Tansonnhates Geondrīciscum Lyfthæfene	Tan Son Nhat internasjonale lufthavn
Þresc stīele	Thrash metal
The Chronicles of Narnia	Narnia
James Hetfield	James Hetfield
Keane	Keane
Láchar	Láchar
Pensacola	Pensacola
Anath	Anat
Barbourscīr, Westvirginia	Barbour County (Vest-Virginia)
Duval Scīr, Florida	Duval County (Florida)
Hāmtūnscīr Scīr, West Virginia	Hampshire County (Vest-Virginia)
Sūþtūn Hōh	Sutton Hoo
Tuidi	Tweed (Skottland)
Sǣbeorg	Undervannsfjell
Dornwaraceaster	Dorchester (Dorset)
Chris Pratt	Chris Pratt
Ēadƿeard Æðeling Scīr, Virginia	Prince Edward County
Angul	Angeln
Cambihtuc	Nymfeparakitt
Hwælsang	Hvalsang
Boston Breakers	Boston Breakers
Lanercscīr	Lanarkshire
Wyr, Orcanege	Wyre (Orknøyene)
Dasaratha Maurya	Dasaratha
Þrīnessunnandæg	Treenighetssøndag
Brecenscīr	Brecknockshire
Simeon Varlamov	Semjon Varlamov
Cannae	Cannae
Wettersteinplatz	Wettersteinplatz undergrunnsstasjon
Punt	Vlet
Olympia-Einkaufszentrum	Olympia-Einkaufszentrum undergrunnsstasjon
Þunresbeorg mōr	Thorsbjerg Mose
Niht (gyden)	Natt (mytologi)
Tamer	Tamar (England)
Scīrburna	Sherborne
Mexicanisc frēona rīcisc fōtballtēam	Mexicos kvinnelandslag i fotball
Læland	Lolland
Bukan	Bukan
God Hates Us All	God Hates Us All
FC Gold Pride	FC Gold Pride
Ælmer	Eilmer av Malmesbury
Grahamland	Graham Land
Wikipǣdia:Sceortpæþ	Wikipedia:Snarvei
Eormengyld Juraj Dobrila on Pula	Universitetet Juraj Dobrila i Pula
Sybelhūs on Lundne	Banqueting House
Beadu þæs Bogn	Slaget ved Boyne
Puebla FC	Puebla FC
MorphOS	MorphOS
Atari Jaguar	Atari Jaguar
Tīdunghēap	Diskusjonsgruppe
Nile (trūðhlōð)	Nile
Stǣr Angelþēode ciricean	Anglernes kirkes historie
Rēan	Rån
Vindicationīeg	Vindication Island
Tæfingstoc	Tavistock
Negombo	Negombo
Selesdūn	Selsdon
Blecinga īeg	Blekinge
Lox (catte)	Ekte gauper
Huntandūn	Huntingdon
Scotburg ēa	Kongeå
Tomtun	Tamworth
World of Warcraft: Wrath of the Lich King	World of Warcraft: Wrath of the Lich King
Ambihtlicu Cīnisc sprǣc	Standard kinesisk
Leþ Hæfen	Leith Harbour
Mans	Maine (Frankrike)
Hwicce	Hwicce
Falster	Falster
Difelinburg	Dublin Castle
Atlanta Beat	Atlanta Beat
Centro Federal de Educação Tecnológica Celso Suckow da Fonseca	Centro Federal de Educação Tecnológica Celso Suckow da Fonseca
Chrono Trigger	Chrono Trigger
Antônio Fagundes	Antônio Fagundes
Cippanhamm	Chippenham (Wiltshire)
Selfrīcsiendlica landbūnessa	Selvstyrt område
Banffscīr	Banffshire
Bardanstapol	Barnstaple
Bellingshausenīeg	Bellingshausen Island
Wedrebi	Wetherby
Stæfford	Stafford (England)
Abejar	Abejar
Stromnæs	Stromness
Weogornaceasterscīrsēaw	Worcestersaus
Getalu ambihtlicra sprǣca	Liste over offisielle språk
Maybach Exelero	Maybach Exelero
Īslendisc frēona rīcisc fōtþōðerhēap	Islands kvinnelandslag i fotball
Dēaðas in 2005. gēare	Dødsfall i 2005
York University	York University
Cirenceaster	Cirencester
Strēoneshalh	Whitby
Skræling	Skræling
Brytenwealda	Bretwalda
Glamorgan	Glamorgan
Sǣearmlandes Rīcisc Edisc	Fiordland nasjonalpark
Port Authority of New York and New Jersey	Port Authority of New York and New Jersey
Getalu īega be landware	Liste over øyer etter innbyggertall
Denisc and Norþwegisc stæfrǣw	Det dansk-norske alfabetet
Cwatbrycg	Bridgnorth
Help:Innoþ	Hjelp:Portal
Wikipǣdia:Tutorial	Wikipedia:Veiledning
Wīntrēow	Klatreplante
Brycgstōwīeg	Bristol Island
Twilight of the Thunder God	Twilight of the Thunder God
Pontifícia Universidade Católica de Minas Gerais	Pontifícia Universidade Católica de Minas Gerais
Deorwente	Derwent (Derbyshire)
Granta	Cam (elv)
Los Angeles Sol	Los Angeles Sol
Rūnstæfisc gerīmbōc	Primstav
Waneting	Wantage
Hrodulf se rēadnosoda hrāndēor	Rudolf er rød på nesen
Elpendīeg	Elefantøya
Elenesburh	Helensburgh
Sūþern Strēamflēot	Kangerlussuaq
Vrahovice	Vrahovice
Gēatland	Gotland
Būc	Magesekk
Candelmæssanīeg	Candlemas Island
Loppestre	Hummere
Simeon II Pulgara Cyning	Simeon av Sachsen-Coburg-Gotha
Lopphāma	Wetaer
Heortæppelbroþ	Tomatsuppe
Chicago Red Stars	Chicago Red Stars
Clarenceīeg, Sūþhjaltland	Clarence Island
Umm Culþþūm	Umm Kulthum
Tenercebrai	Tinchebray
Germanisc Hǣðenscipe	Germansk religion
Cōcīeg (þāra Sūþsandwic Īeglanda)	Cook Island (Sør-Sandwichøyene)
Cooperīeg	Cooperøya
Froggmann	Kampsvømmere
Beadu Omdurmanes	Slaget ved Omdurman
Ƿ	Ƿ
Ninus	Ninos
Lundene Foreweard (1839.)	Londontraktaten av 1839
Harrogætes hord	Depotfunnet ved Harrogate
Æsir–Vanir þurhgefeht	Vanekrigen
Wikipǣdia:Ambihtsecghof	Wikipedia:Ambassade
Mǣþ	Slåttonn
National Hockey League	National Hockey League
Dorceceaster	Dorchester-on-Thames
Perþscīr	Perthshire
Flyhthæfen	Flyplass
Drēag	Draug (vesen)
Mare	Mare (mytologi)
Sandeg, Orcanege	Sanday
Sundrodland	City of Sunderland
Egilseg	Egilsay
Leskovīeg	Leskov Island
Stǣrlice gemynddagas	Historiske datoer
Pecland	Peak District
Women's Professional Soccer	Women's Professional Soccer
Sǣweardþrēat	Kystvakt
Agnes Monica	Agnes Monica
Montaguīeg	Montagu Island
Windlesōra and Mægdenhȳþ	Windsor and Maidenhead
Wīdsīð	Widsith
Evile	Evile
Flocc:Ƿeras	Kategori:Menn
Flocc:Ƿīf	Kategori:Kvinner
Flocc:Þēodscland	Kategori:Tyskland
Flocc:Italia	Kategori:Italia
Flocc:Geānedu Rīcu American	Kategori:USA
Flocc:Russland	Kategori:Russland
Flocc:Canada	Kategori:Canada
Flocc:Geānede Cynerīce	Kategori:Storbritannia
Flocc:Spēonland	Kategori:Spania
Flocc:Cīna	Kategori:Kina
Flocc:Iapan	Kategori:Japan
Flocc:Australia	Kategori:Australia
Flocc:Mexico	Kategori:Mexico
Flocc:Indea	Kategori:India
Flocc:Saudisc Arabea	Kategori:Saudi-Arabia
Flocc:Israhēl	Kategori:Israel
Flocc:Turcland	Kategori:Tyrkia
Flocc:Sūðaffrica	Kategori:Sør-Afrika
Flocc:Ǣgypt	Kategori:Egypt
Flocc:Persealand	Kategori:Iran
Flocc:Nīwe Sǣland	Kategori:New Zealand
Flocc:Argentina	Kategori:Argentina
Traversayīega	Traversay Islands
Sky Blue FC	Sky Blue FC
Flocc:Afghanistan	Kategori:Afghanistan
Flocc:Algeria	Kategori:Algerie
Flocc:Ēastrīce	Kategori:Østerrike
Flocc:Bangladesc	Kategori:Bangladesh
Flocc:Cūba	Kategori:Cuba
Flocc:Sigelhearwenaland	Kategori:Etiopia
Flocc:Indonesia	Kategori:Indonesia
Flocc:Irac	Kategori:Irak
Flocc:Niðerland	Kategori:Nederland
Flocc:Nigeria	Kategori:Nigeria
Flocc:Pacistan	Kategori:Pakistan
Flocc:Pōlaland	Kategori:Polen
Flocc:Portugal	Kategori:Portugal
Flocc:Sudan	Kategori:Sudan
Flocc:Tansania	Kategori:Tanzania
Flocc:Ucrægna	Kategori:Ukraina
Flocc:Fietnam	Kategori:Vietnam
Flocc:Rōmānisc Cāsere	Kategori:Romerske keiserriket
Flocc:Sycedēor	Kategori:Pattedyr
Flocc:Fugolas	Kategori:Fugler
Flocc:Plantan	Kategori:Planter
Flocc:Stǣr	Kategori:Historie
Flocc:Ferscipe	Kategori:Samfunn
Flocc:Gelēafan	Kategori:Religion
Flocc:Plegan	Kategori:Sport
Flocc:Eorþ	Kategori:Jorden
Victor Iusccenco	Viktor Jusjtsjenko
Thila-īeg	Thule Island
Lēo Hlāford Wǣponcyning	Lord Lyon King of Arms
Godmundesceaster	Godmanchester
Saint Louis Athletica	Saint Louis Athletica
Pagetbeorg	Mount Paget
Phil Keaggy	Phil Keaggy
Hocig	Hockey
Frēodōm	Freedom
MTB	Motortorpedobåt
Īsensmiþ	Smed
Visokoi-īeg	Visokoi Island
Willisīega	Willisøyene
Wiogoraceastre	Worcester (England)
Mōr	Myr
Pickersgillīega	Pickersgilløyene
Três Pontas	Três Pontas
Saundersīeg	Saunders Island (Sør-Sandwichøyene)
Ānlāfes Æþelinges Hæfen	Prince Olav Harbour
The Miracles	The Miracles
Loch a' Choire	Tjern
Smith & Wesson 500	S&W Modell 500
Philadelphia Independence	Philadelphia Independence
Flocc:Scīrung	Kategori:Pekere
Flocc:Olympisc Gamen	Kategori:Olympiske leker
Flocc:Crīstendōm	Kategori:Kristendom
Flocc:Alladōm	Kategori:Islam
Ieldra Fuþark	Den eldre futharken
Wilcumanīega	Welcome Islands
Ammomanes	Ammomanes
Earn	Ørner
Skaugum	Skaugum
Washington Freedom	Washington Freedom
Scyrte	Kjole og skjørt
Abercurnig	Abercorn
Wyomingdenu wæl	Massakren i Wyoming Valley
Bochotnica	Bochotnica
Universidade do Estado de Minas Gerais	Universidade do Estado de Minas Gerais
Āhyrstod cȳse	Ostesmørbrød
Harads	Harads
Sceota	Ørret
Flocc:Styccelicu gewritu	Kategori:Stubber
Flocc:Sidaþing	Kategori:Kultur
Flocc:Gēar	Kategori:Årstall
Flocc:Worulddǣl	Kategori:Kontinenter
Flocc:Lyftcræftas	Kategori:Luftfartøyer
Wikipǣdia:Gecorene gemynddagas	Wikipedia:Hendelser
Wikipǣdia:Tutorial (Editing)	Wikipedia:Veiledning/Redigering
Bysen:Stēorungsunnanendebyrdnes	Mal:Solsystem
Smiþþfeld, Lunden	Smithfield (London)
Wikipǣdia:Wikibōceras	Wikipedia:Wikipedianere
Wikipǣdia:Recentchanges	Wikipedia:Siste endringer
Yrse	Yrsa
Flocc:Flēogeball	Kategori:Volleyball
Flocc:Wikipedia bots	Kategori:Boter
Port:Gefērscipe	Portal:Samfunn
Ened	Ender
Bysen:Cquote	Mal:Sitat
Flocc:Þēodisc	Kategori:Tyskere
Flocc:Land	Kategori:Land
Wikipǣdia:Bewitendas	Wikipedia:Administratorer
Flocc:Lēode	Kategori:Personer
Flocc:Tīd	Kategori:Tid
Flocc:Bodiȝlār	Kategori:Anatomi
Flocc:Leornung	Kategori:Utdanning
Cyningesbeorg	Königsberg
Ægypt	Egypt
Yulia Lipnitskaya	Julija Lipnitskaja
Flocc:Ūtwitan	Kategori:Filosofer
Bysen:Bot	Mal:Bot
Wikipǣdia:Hwæt Wikipǣdia Nis	Wikipedia:Hva Wikipedia ikke er
Canada	Canada
Flocc:Ungerland	Kategori:Ungarn
Flocc:Belgice	Kategori:Belgia
Flocc:Cipros	Kategori:Kypros
Flocc:Cecland	Kategori:Tsjekkia
Flocc:Denemearc	Kategori:Danmark
Flocc:Estland	Kategori:Estland
Flocc:Finnland	Kategori:Finland
Flocc:Crecaland	Kategori:Hellas
Flocc:Lettland	Kategori:Latvia
Flocc:Īsland	Kategori:Island
Flocc:Letseburg	Kategori:Luxembourg
Flocc:Liþuania	Kategori:Litauen
Flocc:Melita	Kategori:Malta
Flocc:Swēoland	Kategori:Sverige
Flocc:Slofacia	Kategori:Slovakia
Flocc:Īrland Cynewīse	Kategori:Republikken Irland
Flocc:Fulgōd ȝeƿritu	Kategori:Utmerkede artikler
Flocc:Spærcletelle gamen	Kategori:Videospill
Heofon	Himmelen
Fresland	Friesland
Flocc:Microsoft	Kategori:Microsoft
Wikipǣdia:Edit summary	Hjelp:Redigeringsforklaring
Bysen:Flagicon	Mal:Flagicon
Flocc:Land on Europan	Kategori:Land i Europa
Flocc:Europe	Kategori:Europa
Flocc:Wikipedia:Help	Kategori:Hjelp
Lefenax	Lennox (distrikt)
Help:Mōtungtramet	Hjelp:Diskusjonsside
Bysen:Documentation	Mal:Dokumentasjon
Wikipǣdia:Protected pages	Wikipedia:Denne siden er beskyttet
Flocc:Wikibōceras	Kategori:Wikipedia-brukere
Wikipǣdia:Gemǣnscipes Ingang	Wikipedia:Portal
Flocc:Brūcendsprǣc	Kategori:Wikipedia-brukere etter språk
Wikipǣdia:Fīf styde	Wikipedia:Fem søyler
Wikipǣdia:Ānsund styccegewrit	Wikipedia:Stubb
Wikipǣdia:Bealu	Wikipedia:Vandalisme
Instituto Federal da Bahia	Instituto Federal da Bahia
Bysen:Softredirect	Mal:Softredirect
Bysen:Delete	Mal:Hurtigsletting
Snægel	Snegler
Bryttisce Wealdendas	Liste over britiske monarker
Flocc:Searucræft	Kategori:Teknologi
Flocc:Sprǣca	Kategori:Språk
Flocc:Gerīmbōc	Kategori:Kalendere
Flocc:Hāliȝdagas	Kategori:Høytider og helligdager
Help:Onbregdan nīwne tramet	Hjelp:Hvordan starte en side
Flocc:Wikipǣdia	Kategori:Wikipedia
Flocc:Pages with broken file links	Kategori:Sider med brutte fillenker
Wikipǣdia:Manual of Style	Wikipedia:Stilmanual
Bysen:-	Mal:-
Bysen:Navbox	Mal:Navboks
Flocc:Byrig on Persum	Kategori:Byer i Iran
Bysen:Sēðung þurfed	Mal:Trenger referanse
Angelfresisca sprǣca	Anglo-frisiske språk
Bysen:!	Mal:!
Flocc:Fana bysen	Kategori:Flaggmaler
Bysen:((	Mal:((
Bysen:!!	Mal:!!
Bysen:=	Mal:=
Bysen:Navbar	Mal:Tnavbar
Bysen:Unicode	Mal:Unicode
Bysen:E	Mal:E
Bysen:Clear	Mal:Clear
Bysen:Col-break	Mal:Col-break
Bysen:Col-begin	Mal:Col-begin
Bysen:Col-end	Mal:Col-end
Bysen:Color	Mal:Farve
Bysen:Anchor	Mal:Anchor
Wikipǣdia:List of articles all languages should have	Wikipedia:Liste over artikler vi bør ha
Flocc:Affrica	Kategori:Afrika
Flocc:Mǣdmōnaþ	Kategori:Dager i juli
Flocc:Bēc	Kategori:Bøker
Flocc:Mōnþas	Kategori:Måneder
Bysen:Wikisource	Mal:Wikisource
Bysen:Babel	Mal:Babel
Bysen:Commons	Mal:Commons
Bysen:Reflist	Mal:Referanser
Bysen:Stycce	Mal:Stubb
Bysen:Brūcend de	Mal:Bruker de
Bysen:Brūcend de-1	Mal:Bruker de-1
Bysen:Brūcend el	Mal:Bruker el
Bysen:Brūcend es	Mal:Bruker es
Bysen:Brūcend de-3	Mal:Bruker de-3
Bysen:Brūcend en-3	Mal:Bruker en-3
Bysen:Brūcend el-1	Mal:Bruker el-1
Bysen:Brūcend en-1	Mal:Bruker en-1
Bysen:Brūcend en-2	Mal:Bruker en-2
Bysen:Brūcend eo-2	Mal:Bruker eo-2
Bysen:Brūcend en-4	Mal:Bruker en-4
Bysen:Brūcend fi	Mal:Bruker fi
Bysen:Brūcend en-0	Mal:Bruker en-0
Bysen:Brūcend es-4	Mal:Bruker es-4
Bysen:Brūcend en	Mal:Bruker en
Bysen:Brūcend de-2	Mal:Bruker de-2
Bysen:Brūcend es-1	Mal:Bruker es-1
Bysen:Brūcend fi-1	Mal:Bruker fi-1
Bysen:Brūcend fr-1	Mal:Bruker fr-1
Flocc:Līf	Kategori:Livet
Bysen:Brūcend he-2	Mal:Bruker he-2
Bysen:Brūcend it-3	Mal:Bruker it-3
Bysen:User sk	Mal:Bruker sk
Bysen:Brūcend fr-2	Mal:Bruker fr-2
Bysen:Brūcend ja	Mal:Bruker ja
Bysen:Brūcend ja-1	Mal:Bruker ja-1
Bysen:Brūcend it-1	Mal:Bruker it-1
Bysen:Brūcend fr	Mal:Bruker fr
Cosco	Cuzco
Flocc:Solmōnaþ	Kategori:Dager i februar
Flocc:1949	Kategori:1949
Bysen:Stedefindend scite/Writ	Mal:Kartposisjon/Info
Flocc:Ceorfdēor	Kategori:Insekter
Bysen:Fs mid	Mal:Fs mid
Flocc:Asia	Kategori:Asia
Flocc:Cile	Kategori:Chile
Flocc:21e gēarhundred	Kategori:2000-tallet
Flocc:Lesotho	Kategori:Lesotho
Flocc:Brūcend uk	Kategori:Bruker uk
Flocc:Sūðamerica	Kategori:Sør-Amerika
Flocc:Brūcend uk-M	Kategori:Bruker uk-N
Flocc:1918	Kategori:1918
Flocc:1954	Kategori:1954
Flocc:Ǣt	Kategori:Mat
Flocc:1946	Kategori:1946
Bysen:Fs player	Mal:Fs player
Flocc:Gyldfōtþōðer	Kategori:Fotball
Flocc:1945	Kategori:1945
Bysen:Mod	Mal:Mod
Flocc:1926	Kategori:1926
Bysen:NowCommons	Mal:NowCommons
Bysen:Brūcend sv	Mal:Bruker sv
Flocc:1920	Kategori:1920
Bysen:Brūcend it	Mal:Bruker it
Bysen:Brūcend uk	Mal:Bruker uk
Bysen:Brūcend es-2	Mal:Bruker es-2
Bysen:Welcome	Mal:Reg-velkommen
Flocc:Bysen mid ūtweardum hlence	Kategori:Maler for eksterne lenker
Bysen:Scire in Irlande	Mal:Irske grevskap
Bysen:Wikivar	Mal:Wikivar
Flocc:Brūcend fr-1	Kategori:Bruker fr-1
Bysen:Wikiquote	Mal:Wikiquote
Bysen:Country showdata	Mal:Country showdata
Bysen:Affrica	Mal:Afrikaland
Bysen:Infobox television	Mal:Infobox Television
Bysen:Geānedu Rīcu American	Mal:USAs delstater
Bysen:Cyþþubox ieg	Mal:Infoboks øy
Bysen:Ambox	Mal:Amboks
Flocc:Americanisc stǣr	Kategori:USAs historie
Bysen:Rnd	Mal:Rnd
Bysen:Infobox Country	Mal:Infoboks land2
Bysen:Max	Mal:Max
Wikipǣdia:Tutorial (Wikipedia links)	Wikipedia:Veiledning/Wikipedia-lenker
Bysen:Start box	Mal:S-start
Bysen:Infobox U.S. Scīr	Mal:Infoboks USA fylke
Bysen:Cleanup	Mal:Opprydning
Flocc:Crabbas	Kategori:Krabber
Bysen:Xpd	Mal:Xpd
Bysen:Lang-ar	Mal:Ar
Bysen:Cite news	Mal:Kilde avis
Bysen:Featured article	Mal:Utmerket
Flocc:Paris	Kategori:Paris
Flocc:Brūcend en-4	Kategori:Bruker en-4
Flocc:Brūcend en	Kategori:Bruker en
Flocc:Croatia	Kategori:Kroatia
Flocc:Brūcend en-2	Kategori:Bruker en-2
Bysen:Infobox	Mal:Infoboks
Bysen:Main other	Mal:Main other
Bysen:Image class names	Mal:Image class names
Flocc:Stafas	Kategori:Alfabeter
Bysen:Documentation/start box	Mal:Dokumentasjon/start boks
Bysen:Documentation/end box2	Mal:Dokumentasjon/end boks 2
Wikipǣdia:Gecorene gemynddagas/23 Hāligmōnaþ	Mal:September 23
Bysen:Documentation/start box2	Mal:Dokumentasjon/start boks 2
Wikipǣdia:Gecorene gemynddagas/4 Solmōnaþ	Mal:Februar 4
Wikipǣdia:Gecorene gemynddagas/22 Hāligmōnaþ	Mal:September 22
Wikipǣdia:Gecorene gemynddagas/30 Blōtmōnaþ	Mal:November 30
Wikipǣdia:Gecorene gemynddagas/18 Solmōnaþ	Mal:Februar 18
Wikipǣdia:Gecorene gemynddagas/28 Æfterra Gēola	Mal:Januar 28
Bysen:Legend	Mal:Legend
Wikipǣdia:Gecorene gemynddagas/14 Æfterra Gēola	Mal:Januar 14
Wikipǣdia:Gecorene gemynddagas/25 Solmōnaþ	Mal:Februar 25
Wikipǣdia:Gecorene gemynddagas/10 Wēodmōnaþ	Mal:August 10
Flocc:Bryttisce wrīteras	Kategori:Britiske forfattere
Wikipǣdia:Gecorene gemynddagas/15 Winterfylleþ	Mal:Oktober 15
Wikipǣdia:Gecorene gemynddagas/31 Wēodmōnaþ	Mal:August 31
Wikipǣdia:Gecorene gemynddagas/12 Blōtmōnaþ	Mal:November 12
Wikipǣdia:Gecorene gemynddagas/30 Mǣdmōnaþ	Mal:Juli 30
Wikipǣdia:Gecorene gemynddagas/3 Wēodmōnaþ	Mal:August 3
Wikipǣdia:Gecorene gemynddagas/27 Wēodmōnaþ	Mal:August 27
Bysen:Cite web	Mal:Kilde www
Wikipǣdia:Gecorene gemynddagas/21 Æfterra Gēola	Mal:Januar 21
Wikipǣdia:Gecorene gemynddagas/8 Solmōnaþ	Mal:Februar 8
Wikipǣdia:Gecorene gemynddagas/20 Æfterra Gēola	Mal:Januar 20
Wikipǣdia:Gecorene gemynddagas/23 Æfterra Gēola	Mal:Januar 23
Wikipǣdia:Gecorene gemynddagas/28 Hāligmōnaþ	Mal:September 28
Bysen:Imdb title	Mal:Imdb tittel
Wikipǣdia:Gecorene gemynddagas/31 Gēolmōnaþ	Mal:Desember 31
Wikipǣdia:Gecorene gemynddagas/1 Solmōnaþ	Mal:Februar 1
Wikipǣdia:Gecorene gemynddagas/14 Gēolmōnaþ	Mal:Desember 14
Wikipǣdia:Gecorene gemynddagas/25 Æfterra Gēola	Mal:Januar 25
Wikipǣdia:Gecorene gemynddagas/6 Wēodmōnaþ	Mal:August 6
Wikipǣdia:Gecorene gemynddagas/24 Wēodmōnaþ	Mal:August 24
Wikipǣdia:Gecorene gemynddagas/9 Blōtmōnaþ	Mal:November 9
Wikipǣdia:Gecorene gemynddagas/18 Æfterra Gēola	Mal:Januar 18
Wikipǣdia:Gecorene gemynddagas/17 Wēodmōnaþ	Mal:August 17
Wikipǣdia:Gecorene gemynddagas/27 Mǣdmōnaþ	Mal:Juli 27
Wikipǣdia:Gecorene gemynddagas/20 Wēodmōnaþ	Mal:August 20
Wikipǣdia:Gecorene gemynddagas/1 Winterfylleþ	Mal:Oktober 1
Wikipǣdia:Gecorene gemynddagas/5 Winterfylleþ	Mal:Oktober 5
Wikipǣdia:Gecorene gemynddagas/8 Winterfylleþ	Mal:Oktober 8
Wikipǣdia:Gecorene gemynddagas/15 Solmōnaþ	Mal:Februar 15
Bysen:Coor URL	Mal:Koor URL
Bysen:Pp-template	Mal:Beskyttet side
Bysen:·	Mal:,
Bysen:Brūcend nl-1	Mal:Bruker nl-1
Bysen:Min	Mal:Min
Bysen:Wiktionarypar2	Mal:Wiktionary
Bysen:Brūcend nl-2	Mal:Bruker nl-2
Flocc:Byrig on Dēnum	Kategori:Byer i Danmark
Flocc:Eorþtilþ	Kategori:Landbruk
Bysen:Babel-4	Mal:Babel-4
Wikipǣdia:Gecorene gemynddagas/26 Blōtmōnaþ	Mal:November 26
Wikipǣdia:Gecorene gemynddagas/26 Wēodmōnaþ	Mal:August 26
Wikipǣdia:Gecorene gemynddagas/12 Gēolmōnaþ	Mal:Desember 12
Wikipǣdia:Gecorene gemynddagas/25 Gēolmōnaþ	Mal:Desember 25
Wikipǣdia:Gecorene gemynddagas/10 Æfterra Gēola	Mal:Januar 10
Wikipǣdia:Gecorene gemynddagas/31 Æfterra Gēola	Mal:Januar 31
Wikipǣdia:Gecorene gemynddagas/6 Winterfylleþ	Mal:Oktober 6
Wikipǣdia:Gecorene gemynddagas/6 Hrēþmōnaþ	Mal:Mars 6
Wikipǣdia:Gecorene gemynddagas/18 Hrēþmōnaþ	Mal:Mars 18
Wikipǣdia:Gecorene gemynddagas/17 Winterfylleþ	Mal:Oktober 17
Wikipǣdia:Gecorene gemynddagas/27 Hrēþmōnaþ	Mal:Mars 27
Wikipǣdia:Gecorene gemynddagas/19 Hrēþmōnaþ	Mal:Mars 19
Wikipǣdia:Gecorene gemynddagas/2 Winterfylleþ	Mal:Oktober 2
Wikipǣdia:Gecorene gemynddagas/2 Mǣdmōnaþ	Mal:Juli 2
Wikipǣdia:Gecorene gemynddagas/10 Hrēþmōnaþ	Mal:Mars 10
Wikipǣdia:Gecorene gemynddagas/1 Ēastermōnaþ	Mal:April 1
Wikipǣdia:Gecorene gemynddagas/31 Mǣdmōnaþ	Mal:Juli 31
Wikipǣdia:Gecorene gemynddagas/12 Wēodmōnaþ	Mal:August 12
Wikipǣdia:Gecorene gemynddagas/26 Solmōnaþ	Mal:Februar 26
Wikipǣdia:Gecorene gemynddagas/17 Mǣdmōnaþ	Mal:Juli 17
Wikipǣdia:Gecorene gemynddagas/5 Wēodmōnaþ	Mal:August 5
Wikipǣdia:Gecorene gemynddagas/16 Hāligmōnaþ	Mal:September 16
Wikipǣdia:Gecorene gemynddagas/31 Winterfylleþ	Mal:Oktober 31
Wikipǣdia:Gecorene gemynddagas/12 Solmōnaþ	Mal:Februar 12
Wikipǣdia:Gecorene gemynddagas/15 Æfterra Gēola	Mal:Januar 15
Wikipǣdia:Gecorene gemynddagas/19 Hāligmōnaþ	Mal:September 19
Wikipǣdia:Gecorene gemynddagas/16 Æfterra Gēola	Mal:Januar 16
Wikipǣdia:Gecorene gemynddagas/13 Mǣdmōnaþ	Mal:Juli 13
Wikipǣdia:Gecorene gemynddagas/2 Æfterra Gēola	Mal:Januar 2
Wikipǣdia:Gecorene gemynddagas/9 Mǣdmōnaþ	Mal:Juli 9
Wikipǣdia:Gecorene gemynddagas/10 Solmōnaþ	Mal:Februar 10
Wikipǣdia:Gecorene gemynddagas/5 Hrēþmōnaþ	Mal:Mars 5
Wikipǣdia:Gecorene gemynddagas/29 Sēremōnaþ	Mal:Juni 29
Wikipǣdia:Gecorene gemynddagas/14 Blōtmōnaþ	Mal:November 14
Wikipǣdia:Gecorene gemynddagas/6 Æfterra Gēola	Mal:Januar 6
Wikipǣdia:Gecorene gemynddagas/18 Mǣdmōnaþ	Mal:Juli 18
Wikipǣdia:Gecorene gemynddagas/23 Mǣdmōnaþ	Mal:Juli 23
Wikipǣdia:Gecorene gemynddagas/1 Mǣdmōnaþ	Mal:Juli 1
Wikipǣdia:Gecorene gemynddagas/20 Gēolmōnaþ	Mal:Desember 20
Wikipǣdia:Gecorene gemynddagas/30 Wēodmōnaþ	Mal:August 30
Wikipǣdia:Gecorene gemynddagas/11 Wēodmōnaþ	Mal:August 11
Wikipǣdia:Gecorene gemynddagas/9 Wēodmōnaþ	Mal:August 9
Wikipǣdia:Gecorene gemynddagas/29 Blōtmōnaþ	Mal:November 29
Wikipǣdia:Gecorene gemynddagas/2 Ēastermōnaþ	Mal:April 2
Wikipǣdia:Gecorene gemynddagas/12 Mǣdmōnaþ	Mal:Juli 12
Wikipǣdia:Gecorene gemynddagas/29 Wēodmōnaþ	Mal:August 29
Wikipǣdia:Gecorene gemynddagas/24 Sēremōnaþ	Mal:Juni 24
Wikipǣdia:Gecorene gemynddagas/25 Blōtmōnaþ	Mal:November 25
Wikipǣdia:Gecorene gemynddagas/21 Wēodmōnaþ	Mal:August 21
Wikipǣdia:Gecorene gemynddagas/29 Mǣdmōnaþ	Mal:Juli 29
Wikipǣdia:Gecorene gemynddagas/29 Æfterra Gēola	Mal:Januar 29
Wikipǣdia:Gecorene gemynddagas/5 Gēolmōnaþ	Mal:Desember 5
Wikipǣdia:Gecorene gemynddagas/25 Hrēþmōnaþ	Mal:Mars 25
Wikipǣdia:Gecorene gemynddagas/22 Hrēþmōnaþ	Mal:Mars 22
Wikipǣdia:Gecorene gemynddagas/9 Hrēþmōnaþ	Mal:Mars 9
Wikipǣdia:Gecorene gemynddagas/12 Hrēþmōnaþ	Mal:Mars 12
Wikipǣdia:Gecorene gemynddagas/11 Hrēþmōnaþ	Mal:Mars 11
Wikipǣdia:Gecorene gemynddagas/19 Gēolmōnaþ	Mal:Desember 19
Wikipǣdia:Gecorene gemynddagas/24 Solmōnaþ	Mal:Februar 24
Wikipǣdia:Gecorene gemynddagas/13 Solmōnaþ	Mal:Februar 13
Wikipǣdia:Gecorene gemynddagas/20 Solmōnaþ	Mal:Februar 20
Wikipǣdia:Gecorene gemynddagas/5 Æfterra Gēola	Mal:Januar 5
Wikipǣdia:Gecorene gemynddagas/15 Hrēþmōnaþ	Mal:Mars 15
Wikipǣdia:Gecorene gemynddagas/23 Solmōnaþ	Mal:Februar 23
Wikipǣdia:Gecorene gemynddagas/13 Hrēþmōnaþ	Mal:Mars 13
Wikipǣdia:Gecorene gemynddagas/15 Hāligmōnaþ	Mal:September 15
Wikipǣdia:Gecorene gemynddagas/15 Gēolmōnaþ	Mal:Desember 15
Wikipǣdia:Gecorene gemynddagas/4 Hāligmōnaþ	Mal:September 4
Wikipǣdia:Gecorene gemynddagas/8 Hāligmōnaþ	Mal:September 8
Wikipǣdia:Gecorene gemynddagas/18 Gēolmōnaþ	Mal:Desember 18
Wikipǣdia:Gecorene gemynddagas/4 Hrēþmōnaþ	Mal:Mars 4
Wikipǣdia:Gecorene gemynddagas/4 Winterfylleþ	Mal:Oktober 4
Wikipǣdia:Gecorene gemynddagas/21 Blōtmōnaþ	Mal:November 21
Wikipǣdia:Gecorene gemynddagas/1 Hāligmōnaþ	Mal:September 1
Wikipǣdia:Gecorene gemynddagas/3 Mǣdmōnaþ	Mal:Juli 3
Wikipǣdia:Gecorene gemynddagas/4 Mǣdmōnaþ	Mal:Juli 4
Wikipǣdia:Gecorene gemynddagas/13 Æfterra Gēola	Mal:Januar 13
Wikipǣdia:Gecorene gemynddagas/28 Sēremōnaþ	Mal:Juni 28
Wikipǣdia:Gecorene gemynddagas/7 Sēremōnaþ	Mal:Juni 7
Wikipǣdia:Gecorene gemynddagas/6 Hāligmōnaþ	Mal:September 6
Wikipǣdia:Gecorene gemynddagas/25 Hāligmōnaþ	Mal:September 25
Wikipǣdia:Gecorene gemynddagas/27 Æfterra Gēola	Mal:Januar 27
Wikipǣdia:Gecorene gemynddagas/6 Mǣdmōnaþ	Mal:Juli 6
Wikipǣdia:Gecorene gemynddagas/15 Mǣdmōnaþ	Mal:Juli 15
Wikipǣdia:Gecorene gemynddagas/10 Hāligmōnaþ	Mal:September 10
Wikipǣdia:Gecorene gemynddagas/26 Hāligmōnaþ	Mal:September 26
Wikipǣdia:Gecorene gemynddagas/20 Hāligmōnaþ	Mal:September 20
Wikipǣdia:Gecorene gemynddagas/16 Mǣdmōnaþ	Mal:Juli 16
Wikipǣdia:Gecorene gemynddagas/14 Mǣdmōnaþ	Mal:Juli 14
Wikipǣdia:Gecorene gemynddagas/25 Mǣdmōnaþ	Mal:Juli 25
Wikipǣdia:Gecorene gemynddagas/12 Æfterra Gēola	Mal:Januar 12
Wikipǣdia:Gecorene gemynddagas/23 Wēodmōnaþ	Mal:August 23
Wikipǣdia:Gecorene gemynddagas/22 Sēremōnaþ	Mal:Juni 22
Wikipǣdia:Gecorene gemynddagas/16 Wēodmōnaþ	Mal:August 16
Wikipǣdia:Gecorene gemynddagas/30 Gēolmōnaþ	Mal:Desember 30
Wikipǣdia:Gecorene gemynddagas/4 Blōtmōnaþ	Mal:November 4
Wikipǣdia:Gecorene gemynddagas/3 Æfterra Gēola	Mal:Januar 3
Wikipǣdia:Gecorene gemynddagas/30 Hāligmōnaþ	Mal:September 30
Wikipǣdia:Gecorene gemynddagas/8 Æfterra Gēola	Mal:Januar 8
Wikipǣdia:Gecorene gemynddagas/1 Hrēþmōnaþ	Mal:Mars 1
Wikipǣdia:Gecorene gemynddagas/14 Solmōnaþ	Mal:Februar 14
Wikipǣdia:Gecorene gemynddagas/7 Winterfylleþ	Mal:Oktober 7
Wikipǣdia:Gecorene gemynddagas/19 Solmōnaþ	Mal:Februar 19
Wikipǣdia:Gecorene gemynddagas/28 Hrēþmōnaþ	Mal:Mars 28
Wikipǣdia:Gecorene gemynddagas/20 Hrēþmōnaþ	Mal:Mars 20
Wikipǣdia:Gecorene gemynddagas/6 Solmōnaþ	Mal:Februar 6
Wikipǣdia:Gecorene gemynddagas/7 Solmōnaþ	Mal:Februar 7
Wikipǣdia:Gecorene gemynddagas/21 Solmōnaþ	Mal:Februar 21
Wikipǣdia:Gecorene gemynddagas/1 Wēodmōnaþ	Mal:August 1
Wikipǣdia:Gecorene gemynddagas/14 Hrēþmōnaþ	Mal:Mars 14
Wikipǣdia:Gecorene gemynddagas/28 Solmōnaþ	Mal:Februar 28
Wikipǣdia:Gecorene gemynddagas/27 Hāligmōnaþ	Mal:September 27
Wikipǣdia:Gecorene gemynddagas/8 Mǣdmōnaþ	Mal:Juli 8
Wikipǣdia:Gecorene gemynddagas/11 Hāligmōnaþ	Mal:September 11
Wikipǣdia:Gecorene gemynddagas/22 Mǣdmōnaþ	Mal:Juli 22
Wikipǣdia:Gecorene gemynddagas/28 Wēodmōnaþ	Mal:August 28
Wikipǣdia:Gecorene gemynddagas/1 Blōtmōnaþ	Mal:November 1
Wikipǣdia:Gecorene gemynddagas/2 Solmōnaþ	Mal:Februar 2
Wikipǣdia:Gecorene gemynddagas/4 Wēodmōnaþ	Mal:August 4
Wikipǣdia:Gecorene gemynddagas/22 Gēolmōnaþ	Mal:Desember 22
Wikipǣdia:Gecorene gemynddagas/20 Winterfylleþ	Mal:Oktober 20
Wikipǣdia:Gecorene gemynddagas/28 Mǣdmōnaþ	Mal:Juli 28
Wikipǣdia:Gecorene gemynddagas/17 Æfterra Gēola	Mal:Januar 17
Wikipǣdia:Gecorene gemynddagas/3 Solmōnaþ	Mal:Februar 3
Wikipǣdia:Gecorene gemynddagas/7 Mǣdmōnaþ	Mal:Juli 7
Wikipǣdia:Gecorene gemynddagas/24 Mǣdmōnaþ	Mal:Juli 24
Wikipǣdia:Gecorene gemynddagas/21 Mǣdmōnaþ	Mal:Juli 21
Wikipǣdia:Gecorene gemynddagas/6 Sēremōnaþ	Mal:Juni 6
Wikipǣdia:Gecorene gemynddagas/11 Mǣdmōnaþ	Mal:Juli 11
Wikipǣdia:Gecorene gemynddagas/8 Wēodmōnaþ	Mal:August 8
Wikipǣdia:Gecorene gemynddagas/15 Wēodmōnaþ	Mal:August 15
Wikipǣdia:Gecorene gemynddagas/10 Mǣdmōnaþ	Mal:Juli 10
Wikipǣdia:Gecorene gemynddagas/16 Hrēþmōnaþ	Mal:Mars 16
Wikipǣdia:Gecorene gemynddagas/14 Winterfylleþ	Mal:Oktober 14
Wikipǣdia:Gecorene gemynddagas/17 Hrēþmōnaþ	Mal:Mars 17
Wikipǣdia:Gecorene gemynddagas/24 Hrēþmōnaþ	Mal:Mars 24
Wikipǣdia:Gecorene gemynddagas/21 Hrēþmōnaþ	Mal:Mars 21
Wikipǣdia:Gecorene gemynddagas/5 Solmōnaþ	Mal:Februar 5
Wikipǣdia:Gecorene gemynddagas/3 Winterfylleþ	Mal:Oktober 3
Wikipǣdia:Gecorene gemynddagas/7 Hāligmōnaþ	Mal:September 7
Wikipǣdia:Gecorene gemynddagas/26 Mǣdmōnaþ	Mal:Juli 26
Wikipǣdia:Gecorene gemynddagas/14 Sēremōnaþ	Mal:Juni 14
Flocc:Beorgas	Kategori:Fjell
Bysen:Brūcend ru	Mal:Bruker ru
Flocc:20e gēarhundred	Kategori:1900-tallet
Bysen:IPA	Mal:IPA
Bysen:USpresidents	Mal:USAs presidenter
Wikipǣdia:Gecorene gemynddagas/7 Hrēþmōnaþ	Mal:Mars 7
Wikipǣdia:Gecorene gemynddagas/29 Hrēþmōnaþ	Mal:Mars 29
Flocc:Bysen Brūcend Box Spræc	Kategori:Babel-maler
Wikipǣdia:Gecorene gemynddagas/28 Ēastermōnaþ	Mal:April 28
Bysen:LangWithName	Mal:Language with name
Flocc:Hwæsingatūn	Kategori:Washington
Flocc:Wihta	Kategori:Fabeldyr
Wikipǣdia:Gecorene gemynddagas/30 Hrēþmōnaþ	Mal:Mars 30
Wikipǣdia:Gecorene gemynddagas/22 Solmōnaþ	Mal:Februar 22
Wikipǣdia:Gecorene gemynddagas/31 Hrēþmōnaþ	Mal:Mars 31
Wikipǣdia:Gecorene gemynddagas/23 Hrēþmōnaþ	Mal:Mars 23
Wikipǣdia:Gecorene gemynddagas/17 Solmōnaþ	Mal:Februar 17
Bysen:Birth date and age	Mal:Fødselsdato og alder
Bysen:MONTHNAME	Mal:MONTHNAME
Wikipǣdia:Gecorene gemynddagas/30 Æfterra Gēola	Mal:Januar 30
Wikipǣdia:Gecorene gemynddagas/9 Solmōnaþ	Mal:Februar 9
Wikipǣdia:Gecorene gemynddagas/8 Hrēþmōnaþ	Mal:Mars 8
Bysen:Sortname	Mal:Sorterbart navn
Wikipǣdia:Gecorene gemynddagas/29 Solmōnaþ	Mal:Februar 29
Wikipǣdia:Gecorene gemynddagas/2 Hrēþmōnaþ	Mal:Mars 2
Wikipǣdia:Gecorene gemynddagas/27 Solmōnaþ	Mal:Februar 27
Wikipǣdia:Gecorene gemynddagas/26 Hrēþmōnaþ	Mal:Mars 26
Bysen:Namespace detect	Mal:Namespace detect
Wikipǣdia:Gecorene gemynddagas/Solmōnaþ	Wikipedia:Hendelser/Februar
Bysen:Fmbox	Mal:Fmbox
Flocc:19e gēarhundred	Kategori:1800-tallet
Flocc:Wrīteras	Kategori:Forfattere
Flocc:Eormengyld	Kategori:Universiteter
Bysen:Lang-he	Mal:Lang-he
Bysen:Both	Mal:Both
Bysen:Brūcend pt-1	Mal:Bruker pt-1
Flocc:Æfterra Gēola	Kategori:Dager i januar
Bysen:Lang-fa	Mal:Lang-fa
Bysen:Brūcend nl	Mal:Bruker nl
Wikipǣdia:Gecorene gemynddagas/12 Winterfylleþ	Mal:Oktober 12
Bysen:Brūcend no-2	Mal:Bruker no-2
Wikipǣdia:Gecorene gemynddagas/11 Solmōnaþ	Mal:Februar 11
Bysen:Australia	Mal:Australske delstater
Wikipǣdia:Gecorene gemynddagas/5 Blōtmōnaþ	Mal:November 5
Wikipǣdia:Gecorene gemynddagas/11 Æfterra Gēola	Mal:Januar 11
Wikipǣdia:Gecorene gemynddagas/3 Hāligmōnaþ	Mal:September 3
Wikipǣdia:Gecorene gemynddagas/24 Hāligmōnaþ	Mal:September 24
Bysen:Please don't change this page	Wikipedia:Introduksjon 2
Bysen:Tlx	Mal:Malp
Bysen:Sæternes Bōtm	Mal:Saturns måner
Wikipǣdia:Gecorene gemynddagas/Gēolmōnaþ	Wikipedia:Hendelser/Desember
Bysen:Infobox Album	Mal:Infoboks musikk
Bysen:User	Mal:Bruker
Wikipǣdia:Gecorene gemynddagas/16 Gēolmōnaþ	Mal:Desember 16
Wikipǣdia:Gecorene gemynddagas/9 Æfterra Gēola	Mal:Januar 9
Wikipǣdia:Gecorene gemynddagas/7 Æfterra Gēola	Mal:Januar 7
Wikipǣdia:Gecorene gemynddagas/19 Mǣdmōnaþ	Mal:Juli 19
Wikipǣdia:Gecorene gemynddagas/13 Wēodmōnaþ	Mal:August 13
Wikipǣdia:Gecorene gemynddagas/12 Hāligmōnaþ	Mal:September 12
Wikipǣdia:Gecorene gemynddagas/2 Hāligmōnaþ	Mal:September 2
Wikipǣdia:Gecorene gemynddagas/7 Wēodmōnaþ	Mal:August 7
Wikipǣdia:Gecorene gemynddagas/4 Ēastermōnaþ	Mal:April 4
Wikipǣdia:Gecorene gemynddagas/22 Æfterra Gēola	Mal:Januar 22
Wikipǣdia:Gecorene gemynddagas/4 Æfterra Gēola	Mal:Januar 4
Wikipǣdia:Gecorene gemynddagas/19 Wēodmōnaþ	Mal:August 19
Wikipǣdia:Gecorene gemynddagas/18 Hāligmōnaþ	Mal:September 18
Wikipǣdia:Gecorene gemynddagas/4 Gēolmōnaþ	Mal:Desember 4
Wikipǣdia:Gecorene gemynddagas/2 Wēodmōnaþ	Mal:August 2
Wikipǣdia:Gecorene gemynddagas/21 Gēolmōnaþ	Mal:Desember 21
Wikipǣdia:Gecorene gemynddagas/20 Mǣdmōnaþ	Mal:Juli 20
Wikipǣdia:Gecorene gemynddagas/18 Wēodmōnaþ	Mal:August 18
Wikipǣdia:Gecorene gemynddagas/24 Æfterra Gēola	Mal:Januar 24
Flocc:Flyhthæfenan on Fietname	Kategori:Flyplasser i Vietnam
Bysen:Brūcend pl-1	Mal:Bruker pl-1
Flocc:Cyningas of Englalande	Kategori:Engelske monarker
Flocc:Bryttisce cyningas	Kategori:Britiske monarker
Bysen:Brūcend fr-3	Mal:Bruker fr-3
Bysen:Imdb name	Mal:Imdb navn
Flocc:Tunisia	Kategori:Tunisia
Bysen:PD	Mal:PD
Bysen:Cyþþubox Ira tun	Mal:Infoboks Irland sted
Bysen:Wikispell	Mal:Wikinews
Bysen:Brūcend lt	Mal:Bruker lt
Bysen:Cc-by-sa-2.0	Mal:Cc-by-sa-2.0
Bysen:Mbox	Mal:Mbox
Bysen:Oppose	Mal:Imot
Bysen:Coord/link	Mal:Koord/lenke
Bysen:Dagas þǣre wuce	Mal:Ukedager
Flocc:Þēodisc burg	Kategori:Byer i Tyskland
Bysen:Brūcend fr-0	Mal:Bruker fr-0
Flocc:Norþ Carolīna	Kategori:Nord-Carolina
Flocc:Puerto Rico	Kategori:Puerto Rico
Flocc:Byrig þāra Geāndena Rīca American	Kategori:Byer i USA
Bysen:Lang-ru	Mal:Lang-ru
Flocc:Brittisca Here	Kategori:British Army
Bysen:Disambig	Mal:Peker
Flocc:Byrig on Israhēlum	Kategori:Byer og landsbyer i Israel
Bysen:Selectskin	Mal:Select skin
Bysen:Doi	Mal:Doi
Flocc:Coreanisc stǣr	Kategori:Koreas historie
Bysen:Fb	Mal:Fotballflagg
Bysen:Infobox Film	Mal:Infoboks film
Bysen:Lang-en	Mal:Lang-en
Bysen:Fix	Mal:Fix
Bysen:Brūcend sv-2	Mal:Bruker sv-2
Bysen:Brūcend it-2	Mal:Bruker it-2
Flocc:Angelseaxisc Englaland	Kategori:Angelsakserne
Bysen:Editnotice	Mal:Redigeringsnotis
Bysen:Betwuxwici	Mal:InterWiki
Flocc:Byrig in þǣm Niðerlandum	Kategori:Byer i Nederland
Wikipǣdia:Gecorene gemynddagas/Hāligmōnaþ	Wikipedia:Hendelser/September
Bysen:Coord	Mal:Koord
Flocc:Byrig on Lincolnscīre	Kategori:Byer i Lincolnshire
Bysen:TemplatePAGENAME	Mal:TemplatePAGENAME
Flocc:Wyoming	Kategori:Wyoming
Wikipǣdia:Gecorene gemynddagas/14 Hāligmōnaþ	Mal:September 14
Wikipǣdia:Gecorene gemynddagas/20 Sēremōnaþ	Mal:Juni 20
Wikipǣdia:Gecorene gemynddagas/22 Wēodmōnaþ	Mal:August 22
Wikipǣdia:Gecorene gemynddagas/9 Hāligmōnaþ	Mal:September 9
Wikipǣdia:Gecorene gemynddagas/13 Hāligmōnaþ	Mal:September 13
Wikipǣdia:Gecorene gemynddagas/1 Æfterra Gēola	Mal:Januar 1
Wikipǣdia:Gecorene gemynddagas/14 Wēodmōnaþ	Mal:August 14
Wikipǣdia:Gecorene gemynddagas/6 Gēolmōnaþ	Mal:Desember 6
Bysen:Brūcend fr-4	Mal:Bruker fr-4
Flocc:Grēneland	Kategori:Grønland
Wikipǣdia:Gecorene gemynddagas/Winterfylleþ	Wikipedia:Hendelser/Oktober
Bysen:Brūcend la-1	Mal:Bruker la-1
Bysen:Land on Europan	Mal:Europa
Flocc:User sk	Kategori:Bruker sk
Flocc:Brūcend eo	Kategori:Bruker eo
Flocc:Brūcend fr	Kategori:Bruker fr
Flocc:Brūcend cy	Kategori:Bruker cy
Flocc:Brūcend ang	Kategori:Bruker ang
Flocc:Brūcend la	Kategori:Bruker la
Flocc:Brūcend lt	Kategori:Bruker lt
Flocc:Brūcend pt	Kategori:Bruker pt
Flocc:Brūcend sv	Kategori:Bruker sv
Flocc:Brūcend fr-3	Kategori:Bruker fr-3
Flocc:Brūcend cy-3	Kategori:Bruker cy-3
Flocc:Brūcend ang-3	Kategori:Bruker ang-3
Flocc:Brūcend it-3	Kategori:Bruker it-3
Flocc:Brūcend pl-3	Kategori:Bruker pl-3
Flocc:Brūcend fi-1	Kategori:Bruker fi-1
Flocc:Brūcend cy-1	Kategori:Bruker cy-1
Flocc:Brūcend ang-1	Kategori:Bruker ang-1
Flocc:Brūcend nl-1	Kategori:Bruker nl-1
Flocc:Brūcend pl-1	Kategori:Bruker pl-1
Flocc:Brūcend fr-4	Kategori:Bruker fr-4
Flocc:Brūcend it-4	Kategori:Bruker it-4
Flocc:Brūcend pl-4	Kategori:Bruker pl-4
Flocc:Brūcend fr-2	Kategori:Bruker fr-2
Flocc:Brūcend cy-2	Kategori:Bruker cy-2
Flocc:Brūcend ang-2	Kategori:Bruker ang-2
Flocc:Brūcend it-2	Kategori:Bruker it-2
Flocc:Brūcend la-2	Kategori:Bruker la-2
Flocc:Brūcend pl-2	Kategori:Bruker pl-2
Flocc:Brūcend sv-2	Kategori:Bruker sv-2
Flocc:Brūcend fr-M	Kategori:Bruker fr-N
Flocc:Brūcend cy-M	Kategori:Bruker cy-N
Flocc:Brūcend is-M	Kategori:Bruker is-N
Flocc:Brūcend lt-N	Kategori:Bruker lt-N
Flocc:Brūcend nl-M	Kategori:Bruker nl-N
Flocc:Brūcend ru-M	Kategori:Bruker ru-N
Flocc:Feormung	Kategori:Underholdning
Flocc:Hēafodstōlas þæs Sericus Gārsecges	Kategori:Hovedsteder i Oseania
Flocc:Turcas and Caicos Īegland	Kategori:Turks- og Caicosøyene
Flocc:Tudoryld	Kategori:Tudortiden
Flocc:Articles that need to be wikified	Kategori:Artikler som trenger å wikifiseres
Flocc:Īega	Kategori:Øyer
Flocc:Sericus Garsecg	Kategori:Stillehavet
Flocc:User sk-N	Kategori:Bruker sk-N
Flocc:Brūcend de	Kategori:Bruker de
Flocc:Brūcend de-2	Kategori:Bruker de-2
Flocc:Brūcend de-3	Kategori:Bruker de-3
Flocc:Brūcend de-4	Kategori:Bruker de-4
Flocc:Brūcend el	Kategori:Bruker el
Flocc:Brūcend el-1	Kategori:Bruker el-1
Flocc:Brūcend el-2	Kategori:Bruker el-2
Flocc:Brūcend el-3	Kategori:Bruker el-3
Flocc:Brūcend el-N	Kategori:Bruker el-N
Flocc:Sūþgeorgia and þā Sūþsandwic Īegland	Kategori:Sør-Georgia og Sør-Sandwichøyene
Flocc:Brūcend en-3	Kategori:Bruker en-3
Flocc:Brūcend en-M	Kategori:Bruker en-N
Flocc:Brūcend eo-2	Kategori:Bruker eo-2
Flocc:Brūcend es	Kategori:Bruker es
Flocc:Brūcend es-1	Kategori:Bruker es-1
Flocc:Brūcend es-2	Kategori:Bruker es-2
Flocc:Puilla	Kategori:Puglia
Flocc:Brūcend es-3	Kategori:Bruker es-3
Flocc:Brūcend es-4	Kategori:Bruker es-4
Flocc:Brūcend es-N	Kategori:Bruker es-N
Flocc:Brūcend fi	Kategori:Bruker fi
Flocc:Brūcend fi-M	Kategori:Bruker fi-N
Flocc:Brūcend fo	Kategori:Bruker fo
Flocc:Brūcend fo-1	Kategori:Bruker fo-1
Flocc:Brūcend fo-2	Kategori:Bruker fo-2
Flocc:Brūcend fo-4	Kategori:Bruker fo-4
Flocc:Brūcend fo-M	Kategori:Bruker fo-N
Flocc:Brūcend is	Kategori:Bruker is
Flocc:Brūcend is-1	Kategori:Bruker is-1
Flocc:Brūcend is-2	Kategori:Bruker is-2
Flocc:Brūcend is-3	Kategori:Bruker is-3
Flocc:Brūcend is-4	Kategori:Bruker is-4
Flocc:Mexiciscu rīce	Kategori:Politisk oppdeling i Mexico
Bysen:Brūcend la-3	Mal:Bruker la-3
Flocc:Frencisc Guiana	Kategori:Fransk Guyana
Ǣht	Eiendomsrett
Flocc:Hebrēisc sprǣc	Kategori:Hebraisk
Flocc:Brūcend pt-3	Kategori:Bruker pt-3
Flocc:Bryttisc bōccræft	Kategori:Britisk litteratur
Flocc:Brūcend pl-N	Kategori:Bruker pl-N
Flocc:Brūcend pt-1	Kategori:Bruker pt-1
Wikipǣdia:Gecorene gemynddagas/17 Gēolmōnaþ	Mal:Desember 17
Wikipǣdia:Gecorene gemynddagas/Mǣdmōnaþ	Wikipedia:Hendelser/Juli
Bysen:Cite encyclopedia	Mal:Kilde oppslagsverk
Wikipǣdia:Tutorial (Formatting)	Wikipedia:Veiledning/Formatering
Flocc:Brūcend it	Kategori:Bruker it
Flocc:Brūcend it-1	Kategori:Bruker it-1
Flocc:Rīcu þāra Geāndena Rīca American	Kategori:USAs delstater
Flocc:Brūcend ksh	Kategori:Bruker ksh
Bysen:Mpl	Mal:Spl
Flocc:Brūcend la-1	Kategori:Bruker la-1
Wikipǣdia:Gecorene gemynddagas/29 Hāligmōnaþ	Mal:September 29
Flocc:Brūcend la-3	Kategori:Bruker la-3
Wikipǣdia:Gecorene gemynddagas/5 Hāligmōnaþ	Mal:September 5
Bysen:Cite doi	Mal:Kilde doi
Flocc:Fȳrbeorgas	Kategori:Vulkaner
Flocc:Dēorabyscīr	Kategori:Derbyshire
Flocc:Byrig on Latie	Kategori:Byer i Lazio
Bysen:Englaland Scīra	Mal:Engelske counties
Flocc:Blōtmōnaþ	Kategori:Dager i november
Wikipǣdia:Babel	Wikipedia:Babel
Bysen:Help contents back	Mal:Hjelp-portal-tilbake
Flocc:Scopas	Kategori:Lyrikere
Flocc:Hāligmōnaþ	Kategori:Dager i september
Flocc:Winterfylleþ	Kategori:Dager i oktober
Flocc:Sǣ	Kategori:Hav
Flocc:Gēolmōnaþ	Kategori:Dager i desember
Flocc:Wēodmōnaþ	Kategori:Dager i august
Flocc:Þrimilcemōnaþ	Kategori:Dager i mai
Flocc:Brandenburg	Kategori:Brandenburg
Flocc:Englaland	Kategori:England
Seringas	Kinesere
Wikipǣdia:Gecorene gemynddagas/22 Blōtmōnaþ	Mal:November 22
Flocc:Ēastermōnaþ	Kategori:Dager i april
Bysen:IPA2	Mal:IPA2
Flocc:Līfnamrǣden	Kategori:Systematisk biologi
Flocc:Gestorfen in 988	Kategori:Dødsfall i 988
Flocc:Wæter	Kategori:Vann
Flocc:Geboren in 121	Kategori:Fødsler i 121
Flocc:180	Kategori:180
Flocc:Gestorfen in 180	Kategori:Dødsfall i 180
Flocc:Drincas	Kategori:Drikke
Flocc:Gestorfen in 2005	Kategori:Dødsfall i 2005
Flocc:450	Kategori:450
Bysen:Start date and age	Mal:Startdato og alder
Flocc:Geboren in 1974	Kategori:Fødsler i 1974
Flocc:Geboren in 1899	Kategori:Fødsler i 1899
Flocc:Oklahoma	Kategori:Oklahoma
Flocc:Iapanisc sangeras	Kategori:Japanske sangere
Flocc:Geboren in 1954	Kategori:Fødsler i 1954
Flocc:850	Kategori:850
Flocc:Geboren in 850	Kategori:Fødsler i 850
Flocc:Hwītrussland	Kategori:Hviterussland
Flocc:Alberta	Kategori:Alberta
Flocc:Ontario	Kategori:Ontario
Flocc:Nīwe Scotland	Kategori:Nova Scotia
Flocc:899	Kategori:899
Flocc:Gestorfen in 899	Kategori:Dødsfall i 899
Flocc:Geocon Landscipe	Kategori:Yukon
Flocc:Massachusetts	Kategori:Massachusetts
Flocc:924	Kategori:924
Flocc:Gestorfen in 924	Kategori:Dødsfall i 924
Bysen:Editprotected	Mal:Redigerbeskyttet
Flocc:Land on Affrice	Kategori:Land i Afrika
Bysen:Canadan underrīce	Mal:Canadas provinser og territorier
Flocc:Geboren in 1239	Kategori:Fødsler i 1239
Flocc:1249	Kategori:1249
Flocc:1289	Kategori:1289
Flocc:1305	Kategori:1305
Flocc:Gestorfen in 1305	Kategori:Dødsfall i 1305
Flocc:1307	Kategori:1307
Wikipǣdia:Gecorene gemynddagas/Blōtmōnaþ	Wikipedia:Hendelser/November
Bysen:Brūcend es-3	Mal:Bruker es-3
Flocc:Ēa Franclandes	Kategori:Elver i Frankrike
Flocc:Brūcend pt-2	Kategori:Bruker pt-2
Flocc:Brūcend pt-N	Kategori:Bruker pt-N
Flocc:Brūcend ru	Kategori:Bruker ru
Flocc:Brūcend sv-M	Kategori:Bruker sv-N
Flocc:1634	Kategori:1634
Flocc:1638	Kategori:1638
Flocc:1719	Kategori:1719
Flocc:Gestorfen in 1719	Kategori:Dødsfall i 1719
Flocc:121	Kategori:121
Bysen:Lang	Mal:Språk
Wikipǣdia:Gecorene gemynddagas/21 Hāligmōnaþ	Mal:September 21
Bysen:Template example row	Mal:Template example row
Flocc:Trēowu	Kategori:Tresorter
Bysen:Infobox ea	Mal:Infoboks elv
Flocc:Geboren in 1634	Kategori:Fødsler i 1634
Flocc:Geboren in 1638	Kategori:Fødsler i 1638
Flocc:Geboren in 1852	Kategori:Fødsler i 1852
Flocc:Geboren in 1892	Kategori:Fødsler i 1892
Flocc:Geboren in 1918	Kategori:Fødsler i 1918
Flocc:Geboren in 1945	Kategori:Fødsler i 1945
Flocc:Geboren in 1949	Kategori:Fødsler i 1949
Flocc:Geboren in 1981	Kategori:Fødsler i 1981
Flocc:Geboren in 1993	Kategori:Fødsler i 1993
Flocc:1715	Kategori:1715
Wikipǣdia:Gecorene gemynddagas/Ēastermōnaþ	Wikipedia:Hendelser/April
Flocc:11e gēarhundred	Kategori:1000-tallet
Flocc:988	Kategori:988
Flocc:10e gēarhundred	Kategori:900-tallet
Flocc:7e gēarhundred	Kategori:600-tallet
Flocc:1239	Kategori:1239
Flocc:Gestorfen in 1307	Kategori:Dødsfall i 1307
Flocc:Corsica	Kategori:Korsika
Flocc:Gestorfen in 1715	Kategori:Dødsfall i 1715
Flocc:Russisce bōccræft	Kategori:Russisk litteratur
Flocc:Sardinia	Kategori:Sardinia
Flocc:Florida	Kategori:Florida
Flocc:Normandig	Kategori:Normandie
Bysen:Coord/dec2dms/dm	Mal:Koord/dec2dms/dm
Flocc:Francena caseras	Kategori:Franske keisere
Flocc:Nevada	Kategori:Nevada
Flocc:Nebraska	Kategori:Nebraska
Flocc:Norþ Dakota	Kategori:Nord-Dakota
Flocc:Nīwe Eoforwīc	Kategori:New York State
Flocc:Rhode Īeg	Kategori:Rhode Island
Flocc:Louisiāna	Kategori:Louisiana
Flocc:Marianland	Kategori:Maryland
Flocc:Maine	Kategori:Maine
Flocc:Minnesota	Kategori:Minnesota
Flocc:Michigan	Kategori:Michigan
Flocc:Mississippi	Kategori:Mississippi
Flocc:Missouri	Kategori:Missouri
Flocc:Vermont	Kategori:Vermont
Flocc:Virginia	Kategori:Virginia
Flocc:Idaho	Kategori:Idaho
Flocc:Iowa	Kategori:Iowa
Flocc:Arkansas	Kategori:Arkansas
Flocc:Alaska	Kategori:Alaska
Flocc:Arizona	Kategori:Arizona
Flocc:Alabama	Kategori:Alabama
Flocc:Ohio	Kategori:Ohio
Flocc:Westvirginia	Kategori:Vest-Virginia
Flocc:Wisconsin	Kategori:Wisconsin
Flocc:Indiāna	Kategori:Indiana
Flocc:Illinois	Kategori:Illinois
Flocc:Kansas	Kategori:Kansas
Flocc:California	Kategori:California
Flocc:Kentucky	Kategori:Kentucky
Flocc:Connecticut	Kategori:Connecticut
Flocc:Colorado	Kategori:Colorado
Flocc:Texas	Kategori:Texas
Flocc:Hawaii	Kategori:Hawaii
Bysen:Fs end	Mal:Fs end
Bysen:Fs start	Mal:Fs start
Flocc:Ōðru Woruldgūþ	Kategori:Andre verdenskrig
Flocc:Nīwes Sǣlandes byrig	Kategori:Byer på New Zealand
Flocc:Hundas	Kategori:Hunder
Flocc:Cattas	Kategori:Kattedyr
Wikipǣdia:Gecorene gemynddagas/16 Solmōnaþ	Mal:Februar 16
Wikipǣdia:Gecorene gemynddagas/25 Wēodmōnaþ	Mal:August 25
Flocc:Russisce wrīteras	Kategori:Russiske forfattere
Flocc:1066	Kategori:1066
Flocc:Gestorfen in 1066	Kategori:Dødsfall i 1066
Flocc:Angola	Kategori:Angola
Flocc:Botswana	Kategori:Botswana
Flocc:Elpendbānrima	Kategori:Elfenbenskysten
Flocc:Æriþrea	Kategori:Eritrea
Flocc:Gabon	Kategori:Gabon
Flocc:Gambia	Kategori:Gambia
Flocc:Guinea	Kategori:Guinea
Flocc:Camerun	Kategori:Kamerun
Flocc:Grēnenæs Īega	Kategori:Kapp Verde
Flocc:Cenia	Kategori:Kenya
Flocc:Liberia	Kategori:Liberia
Flocc:Libia	Kategori:Libya
Flocc:Morocco	Kategori:Marokko
Flocc:Mauritania	Kategori:Mauritania
Flocc:1451	Kategori:1451
Flocc:Namibia	Kategori:Namibia
Flocc:Delaware	Kategori:Delaware
Flocc:Georgia (America)	Kategori:Georgia (USA)
Flocc:Montāna	Kategori:Montana
Bysen:Merge	Mal:Fletting
Flocc:Tennessee	Kategori:Tennessee
Bysen:Sūðamerica	Mal:Sør-Amerika
Flocc:Baden-Wyrttemberg	Kategori:Baden-Württemberg
Flocc:1852	Kategori:1852
Flocc:1892	Kategori:1892
Flocc:Gestorfen in 1926	Kategori:Dødsfall i 1926
Flocc:1973	Kategori:1973
Flocc:Gestorfen in 1973	Kategori:Dødsfall i 1973
Flocc:1975	Kategori:1975
Flocc:1981	Kategori:1981
Flocc:Gestorfen in 1982	Kategori:Dødsfall i 1982
Flocc:2004	Kategori:2004
Flocc:Gestorfen in 2004	Kategori:Dødsfall i 2004
Flocc:2005	Kategori:2005
Flocc:2006	Kategori:2006
Flocc:2007	Kategori:2007
Flocc:2008	Kategori:2008
Flocc:Ēa	Kategori:Elver
Bysen:Brūcend el-2	Mal:Bruker el-2
Bysen:Brūcend fo-1	Mal:Bruker fo-1
Bysen:Brūcend la-2	Mal:Bruker la-2
Bysen:Brūcend no-1	Mal:Bruker no-1
Bysen:Brūcend pt	Mal:Bruker pt
Flocc:Sūþsudan	Kategori:Sør-Sudan
Flocc:Cead	Kategori:Tsjad
Flocc:Uganda	Kategori:Uganda
Flocc:Rōmānisce Cāseras	Kategori:Romerske keisere
Flocc:Brūcend nl	Kategori:Bruker nl
Flocc:Sūþhjaltland	Kategori:Sør-Shetlandsøyene
Flocc:Brūcend no-1	Kategori:Bruker no-1
Flocc:Brūcend no-2	Kategori:Bruker no-2
Flocc:Brūcend no	Kategori:Bruker no
Flocc:Norrena cyningas	Kategori:Norske monarker
Flocc:Swēona cyningas	Kategori:Svenske monarker
Flocc:Armenia	Kategori:Armenia
Flocc:Bahrain	Kategori:Bahrain
Flocc:Mennisc bodiȝlār	Kategori:Menneskets anatomi
Flocc:Feorrsīen	Kategori:TV
Flocc:14e gēarhundred	Kategori:1300-tallet
Flocc:13e gēarhundred	Kategori:1200-tallet
Flocc:2e gēarhundred	Kategori:100-tallet
Flocc:4e gēarhundred	Kategori:300-tallet
Flocc:5e gēarhundred	Kategori:400-tallet
Flocc:18e gēarhundred	Kategori:1700-tallet
Flocc:6e gēarhundred	Kategori:500-tallet
Flocc:Nīwesǣlendisce wrīteras	Kategori:Newzealandske forfattere
Flocc:Seaxland-Anhalt	Kategori:Sachsen-Anhalt
Flocc:Niðerseaxland	Kategori:Niedersachsen
Flocc:Russe	Kategori:Russere
Flocc:Unƿǣre lēode	Kategori:Fiktive personer
Flocc:Crēcisc ūtwitan	Kategori:Greske filosofer
Flocc:Sūþseaxe	Kategori:Sussex
Flocc:Bægwaraland	Kategori:Bayern
Flocc:Ēage	Kategori:Øyet
Flocc:Corn	Kategori:Korn
Flocc:Nīweoforwīcburg	Kategori:New York
Flocc:Norþfolc	Kategori:Norfolk
Flocc:Norþhāmtūnescīr	Kategori:Northamptonshire
Flocc:Gamen	Kategori:Rekreasjon
Flocc:Snotingahāmscīr	Kategori:Nottinghamshire
Flocc:15e gēarhundred	Kategori:1400-tallet
Flocc:Georgia (land)	Kategori:Georgia
Flocc:Cambodia	Kategori:Kambodsja
Flocc:Americanisc sangeras	Kategori:Sangere fra USA
Flocc:Bryttisce scopas	Kategori:Britiske lyrikere
Flocc:Stǣr þæs Cynerices Greatbryttenes	Kategori:Storbritannias historie
Flocc:Iamaica	Kategori:Jamaica
Flocc:Scotta cyningas	Kategori:Skotske monarker
Flocc:Corēa	Kategori:Korea
Flocc:Burma	Kategori:Myanmar
Flocc:Taprabane	Kategori:Sri Lanka
Flocc:Tacgicastan	Kategori:Tadsjikistan
Flocc:Ēasttimor	Kategori:Øst-Timor
Flocc:Turcmenistan	Kategori:Turkmenistan
Flocc:Usbecastan	Kategori:Usbekistan
Flocc:Geānedan Arabiscan Bregorīce	Kategori:De forente arabiske emirater
Flocc:9e gēarhundred	Kategori:800-tallet
Flocc:Sofiet Gesamnung	Kategori:Sovjetunionen
Wikipǣdia:Sēðung þurfed	Hjelp:Trenger referanse
Bysen:Brūcend de-4	Mal:Bruker de-4
Flocc:Wēalas	Kategori:Wales
Flocc:Foresittendas þāra Geāndena Rīca American	Kategori:USAs presidenter
Flocc:Europisc stǣr	Kategori:Europas historie
Flocc:Hascemisce Cynerīce þæs Iordanes	Kategori:Jordan
Flocc:Bosnia and Herzegovina	Kategori:Bosnia-Hercegovina
Flocc:Norþweg	Kategori:Norge
Flocc:Barbados	Kategori:Barbados
Flocc:Paraguay	Kategori:Paraguay
Flocc:Ficgiege	Kategori:Fiji
Flocc:Lēohtenstān	Kategori:Liechtenstein
Flocc:Uruguay	Kategori:Uruguay
Flocc:Andorra	Kategori:Andorra
Flocc:Serbia	Kategori:Serbia
Flocc:Ecuador	Kategori:Ecuador
Flocc:Peru	Kategori:Peru
Flocc:Bolifia	Kategori:Bolivia
Flocc:Albania	Kategori:Albania
Flocc:Monaco	Kategori:Monaco
Flocc:Land on Norðamerican	Kategori:Land i Nord-Amerika
Flocc:Fiscas	Kategori:Fisk
Flocc:Wyrta	Kategori:Grønnsaker
Flocc:Ofet	Kategori:Frukt
Flocc:Nīwu Gecȳþnes	Kategori:Det nye testamente
Flocc:Musea	Kategori:Museer
Flocc:Rímcræft	Kategori:Funksjoner
Flocc:Landscipas Swēolandes	Kategori:Sveriges len
Flocc:Dūnholmscīr	Kategori:Durham
Flocc:Manga	Kategori:Manga
Flocc:Eoferwicscīr	Kategori:Yorkshire
Flocc:Calpis	Kategori:Gibraltar
Flocc:Beadwe	Kategori:Slag
Flocc:Weorcendebyrdnessa	Kategori:Operativsystemer
Flocc:Mexicorīce	Kategori:Mexicos delstater
Flocc:Hidalgo Rīce	Kategori:Hidalgo
Flocc:Hetwaraland	Kategori:Hessen
Flocc:Canadan underrīce and landscipas	Kategori:Canadas provinser og territorier
Flocc:Lunden	Kategori:London
Flocc:Lincolnscīr	Kategori:Lincolnshire
Flocc:Dæg þæs gēares	Kategori:Dager i året
Flocc:Wikimedian geweorc	Kategori:Wikimedia
Flocc:Byrig on Buccingahamscīre	Kategori:Byer i Buckinghamshire
Flocc:Wiltūnscīr	Kategori:Wiltshire
Flocc:Wigreceastrescīr	Kategori:Worcestershire
Flocc:Americanisce Ingefeoht	Kategori:Den amerikanske borgerkrigen
Flocc:Byrig on Tuscanie	Kategori:Byer i Toscana
Flocc:Wyrt	Kategori:Urter
Flocc:Dēor	Kategori:Dyr
Flocc:Hweorfdēor	Kategori:Virveldyr
Flocc:Pitcearnīega	Kategori:Pitcairnøyene
Flocc:Cægman Īegland	Kategori:Caymanøyene
Flocc:Folcland Īegland	Kategori:Falklandsøyene
Flocc:Land on Sūðamerican	Kategori:Land i Sør-Amerika
Flocc:Colombia	Kategori:Colombia
Flocc:Anime	Kategori:Anime
Flocc:Oxnafordscīr	Kategori:Oxfordshire
Flocc:Heortfordscīr	Kategori:Hertfordshire
Flocc:Sicilia	Kategori:Sicilia
Flocc:Grantabrycgscīr	Kategori:Cambridgeshire
Flocc:Þēodacynewīse	Kategori:Samveldet av nasjoner
Flocc:Līþ	Kategori:Alkoholholdige drikker
Flocc:Spearctellas	Kategori:Spillkonsoller
Flocc:Englisc scīr	Kategori:Grevskap i England
Flocc:Ceasterscīr	Kategori:Cheshire
Flocc:Sūþrige	Kategori:Surrey
Flocc:Defenascīr	Kategori:Devon
Flocc:Rōmāniscu Folclār	Kategori:Romersk mytologi
Flocc:Beadanfordscīr	Kategori:Bedfordshire
Flocc:Bergan	Kategori:Bær
Flocc:Bēor	Kategori:Øl
Flocc:Sang	Kategori:Sanger
Flocc:Hēafodstōlas	Kategori:Hovedsteder
Flocc:Stōwlice hēafodstōlas Canadan	Kategori:Byer i Canada
Flocc:Ēastseaxe	Kategori:Essex
Flocc:Middelasia	Kategori:Sentral-Asia
Flocc:Indisca Underworulddǣl	Kategori:Sør-Asia
Flocc:NFL	Kategori:National Football League
Flocc:Tuscania	Kategori:Toscana
Flocc:Latium	Kategori:Latium
Flocc:Lonceasterscīr	Kategori:Lancashire
Flocc:Hāmtūnescīr	Kategori:Hampshire
Flocc:Brūcend pl	Kategori:Bruker pl
Flocc:Gleawcesterscīr	Kategori:Gloucestershire
Flocc:Rōmānisca sprǣca	Kategori:Romanske språk
Flocc:Fōr	Kategori:Transport
Flocc:Sund	Kategori:Svømming
Flocc:Hēapplegan	Kategori:Lagsport
Flocc:Toys	Kategori:Leketøy
Flocc:Hīwscipe	Kategori:Familie
Flocc:Cornweall	Kategori:Cornwall
Flocc:Cīna Caseras	Kategori:Kinesiske keisere
Flocc:Tūnas on Sūþfolce	Kategori:Landsbyer i Suffolk
Flocc:Norðamerica	Kategori:Nord-Amerika
Flocc:Sangestre	Kategori:Sangere
Flocc:Euxinus	Kategori:Svartehavet
Flocc:Meras	Kategori:Innsjøer
Flocc:Sweartbeorg	Kategori:Montenegro
Flocc:Indisc Gārsecg	Kategori:Indiahavet
Flocc:Wægnas	Kategori:Biler
Bysen:Brūcend af-2	Mal:Bruker af-2
Wealhmoru	Gulrot
Flocc:Cent	Kategori:Kent
Flocc:Byrig on Fietname	Kategori:Byer i Vietnam
Flocc:Byrig on þǣm Ucrægnan	Kategori:Byer i Ukraina
Flocc:Byrig on Eotolwarum	Kategori:Byer i Italia
Flocc:Beorgas on Brettum	Kategori:Fjell i Storbritannia
Flocc:Scotland	Kategori:Skottland
Flocc:Spēonisc bōccræft	Kategori:Spansk litteratur
Flocc:Hēafodstōlas in Europe	Kategori:Hovedsteder i Europa
Flocc:Hēafodstōlas in Asie	Kategori:Hovedsteder i Asia
Flocc:Norðerne Īrland	Kategori:Nord-Irland
Flocc:Īrisc bōccræft	Kategori:Irsk litteratur
Bysen:CompactTOC	Mal:KompaktTOC
Flocc:Geāsparedu līc	Kategori:Mumier
Flocc:Wendelsǣ	Kategori:Middelhavet
Flocc:Byrig on Cile	Kategori:Byer i Chile
Bysen:Rounddown	Mal:Rounddown
Flocc:Loidis	Kategori:Leeds
Flocc:Angleseg	Kategori:Anglesey
Bysen:Coord/dec2dms	Mal:Koord/dec2dms
Bysen:Coord/display/inline	Mal:Koord/vis/tekst
Bysen:Coord/input/d	Mal:Koord/innputt/d
Bysen:Coord/input/dec	Mal:Koord/innputt/dec
Bysen:Coord/input/dm	Mal:Koord/innputt/dm
Bysen:Coord/input/dms	Mal:Koord/innputt/dms
Bysen:Coord/prec dec	Mal:Koord/prec dec
Bysen:Brūcend pl-3	Mal:User pl-3
Flocc:Flæmingaland	Kategori:Flandern
Flocc:Byrig on Difelinscīre	Kategori:Byer og forsteder i Dublin
Trojany (Masovian Voivodship)	Trojany
Flocc:Willelm Shakespeare	Kategori:William Shakespeare
Flocc:Byrig þāra Faroiscan Īegena	Kategori:Byer på Færøyene
Flocc:Sigelhearwena Cāseras	Kategori:Etiopiske keisere
Flocc:Land on Asie	Kategori:Land i Asia
Flocc:Windows gamen	Kategori:Windows-spill
Bysen:Plegere-stycce	Mal:Skuespillerstubb
Bysen:Nigerie Rīce	Mal:Nigerias delstater
Flocc:Wikipedia protected edit requests	Kategori:Wikipedia anmodning om redigering av beskyttet side
Bysen:Brūcend el-3	Mal:Bruker el-3
Flocc:Westmidlandscīr	Kategori:West Midlands
Flocc:West Loðene	Kategori:West Lothian
Flocc:Wæringscīr	Kategori:Warwickshire
Flocc:Tūnas on Norþhāmtūnescīre	Kategori:Landsbyer i Northamptonshire
Flocc:Tūnas on Beadanfordscīre	Kategori:Landsbyer i Bedfordshire
Flocc:Wīcinga Ieldu	Kategori:Vikingtiden
Wikipǣdia:Gecorene gemynddagas/Wēodmōnaþ	Wikipedia:Hendelser/August
Flocc:Seolh	Kategori:Seler
Flocc:Engla cyningas	Kategori:Angelsaksiske monarker
Flocc:Quebec	Kategori:Québec
Flocc:Ostsǣ	Kategori:Østersjøen
Flocc:Bysen Brūcend Box	Kategori:Brukerbokser
Flocc:Dēaþstīele glīwdrēame clīwene	Kategori:Death metal-band
Flocc:Clackmannanscīr	Kategori:Clackmannanshire
Flocc:Gūþ	Kategori:Krig
Flocc:Ēast Loðene	Kategori:East Lothian
Flocc:Fermanagh	Kategori:Fermanagh
Flocc:Tirowen	Kategori:Tyrone
Flocc:Fif Scīr	Kategori:Fife
Flocc:Lēoðlic scātung	Kategori:Kunstløp
Bysen:Lang-sv	Mal:Lang-sv
Flocc:Frencisc Polynesia	Kategori:Fransk Polynesia
Flocc:Germanisca sprǣca	Kategori:Germanske språk
Bysen:Precision1	Mal:Precision1
Flocc:Herefordscīr	Kategori:Herefordshire
Flocc:Īshocig	Kategori:Ishockey
Wikipǣdia:Edit conflicts	Hjelp:Redigeringskonflikt
Flocc:Īrland	Kategori:Irland
Flocc:Constantinopolis	Kategori:Istanbul
Wikipǣdia:Page history	Hjelp:Revisjonshistorikk
Flocc:Mintan	Kategori:Leppeblomstfamilien
Flocc:Lægreceastrescīr	Kategori:Leicestershire
Flocc:Langbeardnaland	Kategori:Lombardia
Wikipǣdia:Snellbred	Wikipedia:Jukselapp
Wikipǣdia:Show preview	Hjelp:Forhåndsvisning
Flocc:Midloðene	Kategori:Midlothian
Flocc:Rōm	Kategori:Roma
Flocc:Norþhymbraland	Kategori:Northumberland
Flocc:Roteland	Kategori:Rutland
Flocc:Sancte Elene Īeg, Upstigeīeg and Tristan da Cunha	Kategori:St. Helena, Ascension og Tristan da Cunha
Flocc:Seaxe	Kategori:Sakserne
Flocc:Hjaltland	Kategori:Shetland
Flocc:Scipu	Kategori:Skip
Flocc:Scrobbesbyrigscīr	Kategori:Shropshire
Flocc:Byrig on Gleawcesterscīre	Kategori:Byer i Gloucestershire
Flocc:NHL	Kategori:NHL
Flocc:Byrig on Nīwum Hāmtūnscīre	Kategori:Byer i New Hampshire
Flocc:Byrig on Dūnholmscīre	Kategori:Byer i Durham
Flocc:Byrig on Dēorabyscīre	Kategori:Byer i Derbyshire
Flocc:Byrig on Defenum	Kategori:Byer i Devon
Flocc:Byrig on Lonceasterscīre	Kategori:Byer i Lancashire
Flocc:Americanisc fōtball	Kategori:Amerikansk fotball
Flocc:Stæffordscīr	Kategori:Staffordshire
Flocc:Bermuda	Kategori:Bermuda
Flocc:Bearrucscīr	Kategori:Berkshire
Flocc:Byrig on Bearrucscīre	Kategori:Byer i Berkshire
Flocc:Norþgermanisca sprǣca	Kategori:Nordiske språk
Flocc:São Paulo	Kategori:São Paulo
Flocc:Byrig on Sūþrigum	Kategori:Byer i Surrey
Flocc:Byrig on Grantabrycgscīre	Kategori:Byer i Cambridgeshire
Flocc:Byrig on Cornweallum	Kategori:Byer i Cornwall
Flocc:Byrig on Cent	Kategori:Byer i Kent
Flocc:Byrig on Midloðene	Kategori:Byer i Midlothian
Flocc:Byrig on Oxnafordscīre	Kategori:Byer i Oxfordshire
Flocc:Byrig on Westmidlandscīre	Kategori:Byer i West Midlands
Flocc:Dȳfung	Kategori:Dykking
Flocc:Byrig on Scrobbesbyrigscīre	Kategori:Byer i Shropshire
Flocc:Byrig on Stæffordscīre	Kategori:Byer i Staffordshire
Flocc:Ardmachusscīr	Kategori:Armagh
Flocc:Tūnas on Ceasterscīre	Kategori:Landsbyer i Cheshire
Flocc:Byrig on Wigreceastrescīre	Kategori:Byer i Worcestershire
Flocc:Byrig on Wæringscīre	Kategori:Byer i Warwickshire
Flocc:Wichlawscīr	Kategori:Wicklow
Flocc:Byrig on Wiltūnscīre	Kategori:Byer i Wiltshire
Flocc:Nīwre Gecȳþnesse bōc	Kategori:Bøker i Det nye testamente
Flocc:Antrimscīr	Kategori:Antrim
Flocc:Mageoscīr	Kategori:Mayo
Flocc:Celtisc sprǣc	Kategori:Keltiske språk
Flocc:Coritiba Foot Ball Club	Kategori:Coritiba Foot Ball Club
Flocc:Bryttisce Scīre	Kategori:Grevskap i Storbritannia
Flocc:Wendelsǣs īega	Kategori:Øyer i Middelhavet
Flocc:Orcanege	Kategori:Orknøyene
Flocc:Byrig on Ēastseaxum	Kategori:Byer i East Sussex
Flocc:Gyldfōtþōðres styccelicu gewritu	Kategori:Fotballstubber
Flocc:Byrig	Kategori:Byer
Flocc:Brūcend fo-3	Kategori:Bruker fo-3
Wikipǣdia:Tutorial (External links)	Wikipedia:Veiledning/Sitere kilder
Flocc:Personal life	Kategori:Dagligliv
Flocc:Brūcend ang-0	Kategori:Bruker ang-0
Flocc:Middelseaxe	Kategori:Middlesex
Flocc:Byrig on Brettum	Kategori:Byer i Storbritannia
Bysen:Coord/display/title	Mal:Koord/vis/tittel
Bysen:Year in other calendars	Mal:Årstall i andre kalendere
Flocc:Brūcend en-1	Kategori:Bruker en-1
Flocc:Geboren in 1946	Kategori:Fødsler i 1946
Flocc:Brūcend de-1	Kategori:Bruker de-1
Flocc:Geboren in 1920	Kategori:Fødsler i 1920
Flocc:Īrisce Scīre	Kategori:Grevskap i Irland
Flocc:Skrælingcynn	Kategori:Indianere
Flocc:Byrig on Heortfordscīre	Kategori:Byer i Hertfordshire
Bysen:Virginia	Mal:Virginia
Bysen:Bo	Mal:Bo
Bysen:Kylie Minogue	Mal:Kylie Minogue
Wikipǣdia:Gecorene gemynddagas/Sēremōnaþ	Wikipedia:Hendelser/Juni
Wikipǣdia:Gecorene gemynddagas/Æfterra Gēola	Wikipedia:Hendelser/Januar
Wikipǣdia:Gecorene gemynddagas/Hrēþmōnaþ	Wikipedia:Hendelser/Mars
Wikipǣdia:Gecorene gemynddagas/Þrimilcemōnaþ	Wikipedia:Hendelser/Mai
Bysen:Start date	Mal:Startdato
Wikipǣdia:Inlǽdung 3	Wikipedia:Introduksjon 3
Bysen:Brūcend fo-0	Mal:Bruker fo-0
Meore	Møre (andre betydninger)
Bysen:Brūcend ang-2	Mal:Bruker ang-2
Bysen:Brūcend ang-1	Mal:Bruker ang-1
Bysen:Brūcend ang-3	Mal:Bruker ang-3
Bysen:Eald-Rōm-stycce	Mal:AntikkensRomastubb
Amy McCarthy	Amy McCarthy
Wikipǣdia:Lārcwide/TabsHeader	Wikipedia:Veiledning/Faner
Swǣfe	Schwaben
Wikipǣdia:Templates	Wikipedia:Maler
Hindberge	Bringebær
Læsse Asia	Lilleasia
Bysen:End	Mal:End
Peru (ofet)	Pære
Bysen:Syndrigebocstafas	Mal:Spesialtegn
Lorde	Lorde
Georgius Grantanbrycge Æþeling	George av Storbritannia
Module:Yesno	Modul:Yesno
Module:Category handler	Modul:Category handler
Module:Arguments	Modul:Arguments
Syndrig:RecentChanges	Spesial:Siste endringer
Flocc:Byrig on Langbeardum	Kategori:Byer i Lombardia
Module:Namespace detect	Modul:Namespace detect
Flocc:Gestorfen in 1975	Kategori:Dødsfall i 1975
Module:Namespace detect/data	Modul:Namespace detect/data
Module:Namespace detect/config	Modul:Namespace detect/config
Tæfl	Hnefatafl
