ܐܦܪܝܩܐ	Afrika
ܝܦܢ	Japan
ܐܡܪܝܩܐ ܬܝܡܢܝܬܐ	Sør-Amerika
ܢܘܪܒܝܓ	Norge
ܩܘܛܢܝܘܬܐ ܕܐܝܪܠܢܕ	Irland
ܡܓܪ	Ungarn
ܐܣܦܢܝܐ	Spania
ܐܘܚܕܢܐ ܡܚܝܕܐ	USA
ܒܠܓܝܩܐ	Belgia
ܠܘܟܣܡܒܘܪܓ	Luxembourg
ܬܒܝܠ	Universet
ܐܪܥܐ	Jorden
ܡܘܬܐ	Død
ܒܪ ܐܢܫܐ	Menneske
ܓܘܪܓ ܘܐܫܝܢܓܛܘܢ	George Washington
ܦܝܢܠܢܕ	Finland
ܣܘܝܕ	Sverige
ܕܐܢܡܐܪܩ	Danmark
ܦܘܠܢܕ	Polen
ܠܬܘܢܝܐ	Litauen
ܐܝܛܠܝܐ	Italia
ܣܘܝܣܪܐ	Sveits
ܢܡܣܐ	Østerrike
ܝܘܢ	Hellas
ܛܘܪܩܝܐ	Tyrkia
ܦܘܪܛܘܓܠ	Portugal
ܐܘܪܘܦܐ (ܝܒܫܬܐ)	Europa
ܐܣܝܐ (ܝܒܫܬܐ)	Asia
ܐܡܪܝܩܐ ܓܪܒܝܝܬܐ	Nord-Amerika
ܐܢܛܐܪܩܛܝܩܐ	Antarktika
ܘܝܩܝܦܕܝܐ	Wikipedia
ܗܘܠܢܕܐ	Nederland
ܢܝܘ ܝܘܪܩ (ܡܕܝܢܬܐ)	New York
ܘܐܫܢܓܛܘܢ (ܐܪܫܟܝܬܐ)	Washington, D.C.
ܒܪܠܝܢ	Berlin
ܚܫܘܒܐ (ܡܐܟܢܐ)	Datamaskin
ܒܪܢ	Bern
ܬܣܝܪܝܟ	Zürich
ܐܢܛܪܢܛ	Internett
ܒܪܐܩ ܐܘܒܐܡܐ	Barack Obama
ܠܘܢܕܘܢ	London
ܐܠܟܣܢܕܪܝܐ	Alexandria
ܚܙܘܪܐ	Epleslekten
ܦܐܪܝܣ	Paris
ܡܟܣܝܩܘ	Mexico
ܐܘܩܝܢܘܣ ܐܛܠܢܛܝܐ	Atlanterhavet
ܐܘܩܝܢܘܣ ܫܝܢܝܐ	Stillehavet
ܒܘܣܛܘܢ	Boston
ܬܪܝܢܒܫܒܐ	Mandag
ܟܢܘܢ ܒ	Januar
ܫܒܛ	Februar
ܐܕܪ	Mars (måned)
ܟܘܫ	Etiopia
ܢܝܣܢ	April
ܐܝܪ	Mai
ܚܙܝܪܢ	Juni
ܬܡܘܙ	Juli
ܐܒ	August
ܐܝܠܘܠ	September
ܬܫܪܝܢ ܐ	Oktober
ܬܫܪܝܢ ܒ	November
ܟܢܘܢ ܐ	Desember
ܬܠܬܒܫܒܐ	Tirsdag
ܐܪܒܥܒܫܒܐ	Onsdag
ܚܡܫܒܫܒܐ	Torsdag
ܥܪܘܒܬܐ	Fredag
ܫܒܬܐ (ܙܒܢܐ)	Lørdag
ܚܕܒܫܒܐ	Søndag
ܐܪܝܐ	Løve
ܦܪܢܣܐ	Frankrike
ܟܠܒܐ	Tamhund
ܡܠܟܘܬܐ ܡܚܝܕܬܐ	Storbritannia
ܩܛܐ	Tamkatt
ܩܘܛܢܝܘܬܐ ܥܡܡܝܬܐ ܕܨܝܢ	Folkerepublikken Kina
ܠܫܢܐ ܦܪܢܣܝܐ	Fransk
ܒܪܐܙܝܠ	Brasil
ܪܘܣܝܐ	Russland
ܝܡܐ	Hav
ܝܡܐ ܐܘܟܡܐ	Svartehavet
Π	Pi (bokstav)
ܐܠܒܐܡܐ	Alabama
ܣܐܘ ܦܐܘܠܘ	São Paulo
ܩܝܒܩ (ܗܘܦܪܟܝܐ)	Québec
ܓܪܡܢ	Tyskland
ܒܠܐܪܘܣ	Hviterussland
ܠܫܢܐ ܓܪܡܢܝܐ	Tysk
ܐܠܗܐ	Gud
ܐܣܛܘܢܝܐ	Estland
ܛܝܣܬܐ	Fly
ܩܪܒܐ	Krig
1 (ܡܢܝܢܐ)	1 (tall)
2 (ܡܢܝܢܐ)	2 (tall)
3 (ܡܢܝܢܐ)	3 (tall)
4 (ܡܢܝܢܐ)	4 (tall)
5 (ܡܢܝܢܐ)	5 (tall)
ܠܐܛܒܝܐ	Latvia
ܐܘܩܪܐܝܢܐ	Ukraina
ܬܫܝܟ	Tsjekkia
ܣܠܘܒܩܝܐ	Slovakia
ܣܠܘܒܢܝܐ	Slovenia
ܡܘܠܕܘܒܐ	Moldova
ܪܘܡܢܝܐ	Romania
ܒܘܠܓܐܪܝܐ	Bulgaria
ܪܗܘܡܐ (ܡܕܝܢܬܐ)	Roma
ܩܘܛܢܝܘܬܐ ܕܡܩܕܘܢܝܐ	Republikken Makedonia
ܐܠܒܢܝܐ	Albania
ܩܪܘܐܛܝܐ	Kroatia
ܒܘܣܢܐ ܘܗܪܬܣܓܘܒܝܢܐ	Bosnia-Hercegovina
ܐܙܪܒܝܓܐܢ	Aserbajdsjan
ܐܢܕܘܪܐ	Andorra
ܩܘܦܪܘܣ	Republikken Kypros
ܓܘܪܓܝܐ (ܐܬܪܐ)	Georgia
ܩܙܩܣܛܐܢ	Kasakhstan
ܡܝܠܛܐ	Malta
ܡܘܢܐܩܘ	Monaco
ܛܘܪܐ ܐܘܟܡܐ	Montenegro
ܡܕܝܢܬܐ ܕܘܛܝܩܢ	Vatikanstaten
ܣܢ ܡܪܝܢܘ	San Marino
ܒܪܘܟܣܠ	Brussel
ܠܘܕܒܝܓ ܒܐܢ ܒܝܛܗܘܒܢ	Ludwig van Beethoven
ܠܫܢܐ ܛܘܪܩܝܐ	Tyrkisk
ܓܙܐܐܪ	Algerie
ܐܘܙܒܩܣܛܐܢ	Usbekistan
ܘܐܪܣܘ	Warszawa
ܚܡܪܐ (ܫܬܝܐ)	Vin
ܡܝܐ	Vann
ܦܪܣ ܚܙܘܐ	Fjernsyn
ܬܫܝܠܝ	Chile
ܐܠ ܓܪܝܩܘ	El Greco
ܝܫܘܥ	Jesus Kristus
ܠܫܢܐ (ܡܡܠܠܐ)	Språk
ܫܘܠܛܢ ܛܪܘܢܘܬܐ	Diktatur
ܡܡܠܠܘܬ ܟܘܟܒܐ	Astronomi
ܡܪܝܡ (ܐܡܗ ܕܝܫܘܥ)	Jomfru Maria
ܠܝܟܛܢܫܛܝܢ	Liechtenstein
ܐܕܘܠܦ ܗܝܛܠܪ	Adolf Hitler
ܠܫܢܐ ܠܐܛܝܢܝܐ	Latin
ܒܚܪܝܢ	Bahrain
ܐܪܡܢܝܐ	Armenia
ܣܪܒܝܐ	Serbia
ܣܗܪܐ	Månen
ܐܝܣܛܢܒܘܠ (ܡܕܝܢܬܐ)	Istanbul
ܐܘܣܛܪܠܝܐ (ܐܬܪܐ)	Australia
ܦܝܣܝܟ	Fysikk
ܩܘܪܐܢ	Koranen
ܐܣܠܐܡ	Islam
ܠܟ ܒܐܘܢܣܐ	Lech Wałęsa
ܫܠܡܐ (ܫܝܢܐ)	Fred
ܚܘܝܕܐ ܐܘܪܘܦܝܐ	Den europeiske union
ܐܢܬܬܐ	Kvinne
ܛܝܙܐ	Anus
ܗܒܒܐ	Blomst
ܝܘܠܦܢ ܨܪܘܝܘܬܐ	Anatomi
ܡܕܝܢܬܐ	By
ܢܐܦܠܝܘܢ ܒܘܢܐܦܪܛ	Napoléon Bonaparte
ܟܘܟܒܐ	Stjerne
ܫܡܫܐ	Solen
ܩܪܝܬܐ	Landsby
ܝܡܐ ܕܡܕܢܚܐ	Østersjøen
ܫܢܐ	Tann
ܘܝܩܝܡܝܕܝܐ ܩܘܡܡܘܢܣ	Wikimedia Commons
ܟܬܒܐ (ܣܦܪܐ)	Bok
ܝܘܡܐ	Dag
ܠܠܝܐ	Natt
ܫܢܬܐ (ܙܒܢܐ)	År
ܕܪܐ	Århundre
ܐܘܣܠܘ	Oslo
ܠܫܒܘܢܐ	Lisboa
ܦܠܝܛܐ	Planet
ܙܡܪܘܬܐ	Musikk
ܡܘܣܩܒܐ	Moskva
ܠܫܢܐ ܐܝܛܠܝܐ	Italiensk
ܬܫܐܕ	Tsjad
ܬܝܡܢܐ	Nord
ܢܝܘ ܙܝܠܢܕ	New Zealand
ܓܪܒܝܐ	Sør
ܗܢܕܘ	India
ܦܪܙܠܐ	Jern
ܡܥܪܒܐ	Vest
ܡܕܢܚܐ	Øst
ܒܢܙܘܝܠܐ	Venezuela
ܛܠܦܣܢܐ	Sjakk
ܡܝܢ	Maine
ܣܘܣܝܐ	Hest
ܐܡܣܛܪܕܐܡ	Amsterdam
ܙܝܢܐ	Våpen
ܚܝܘܬܐ	Dyr
ܩܘܠܘܡܒܝܐ	Colombia
ܢܝܘ ܗܐܡܦܫܪ	New Hampshire
ܠܝܘܢܪܕܘ ܕܗ ܒܢܬܫܝ	Leonardo da Vinci
ܡܐܣܐܬܫܘܣܬܣ	Massachusetts
ܐܘܛܪܝܟܛ (ܗܘܦܪܟܝܐ)	Utrecht (provins)
ܟܘܢܝܬܝܟܬ	Connecticut
ܐܝܪܐܢ	Iran
ܥܝܪܐܩ	Irak
ܐܠܐܣܟܐ	Alaska
ܐܝܣܪܐܝܠ	Israel
ܐܘܛܪܝܟܛ (ܡܕܝܢܬܐ)	Utrecht (by)
ܝܡܢ	Jemen
ܠܫܢܐ ܦܘܠܢܕܝܐ	Polsk
ܝܘܪܕܢܢ	Jordan
ܩܝܪܓܝܙܣܛܐܢ	Kirgisistan
ܐܪܝܙܘܢܐ	Arizona
ܟܘܘܝܬ (ܐܬܪܐ)	Kuwait
ܠܒܢܢ	Libanon
ܐܘܪܝܓܘܢ	Oregon
ܐܡܪܝܩܐ	Amerika
ܝܘܬܐ	Utah
ܥܘܡܐܢ	Oman
ܦܐܩܣܛܐܢ	Pakistan
ܩܛܪ	Qatar
ܣܥܘܕܝܐ	Saudi-Arabia
ܝܘܣܦ ܣܛܐܠܝܢ	Josef Stalin
ܣܘܪܝܐ	Syria
ܛܐܓܝܩܣܛܐܢ	Tadsjikistan
ܦܪܣ ܩܠܐ	Radio
ܛܘܪܩܡܢܣܛܐܢ	Turkmenistan
ܐܡܝܪܘܬܐ ܥܪܒܝܬܐ ܡܚܝܕܬܐ	De forente arabiske emirater
ܐܦܓܐܢܣܛܐܢ	Afghanistan
ܕܗܒܐ	Gull
ܡܠܝ	Mali
ܦܝܠܝܦܝܢܝܐ	Filippinene
ܩܘܛܢܝܘܬܐ ܕܐܦܪܝܩܐ ܡܨܥܝܬܐ	Den sentralafrikanske republikk
ܐܝܣܚܩ ܢܝܘܛܢ	Isaac Newton
ܫܥܘܬܐ (ܓܘܢܐ)	Gul
ܬܘܢܣ (ܐܬܪܐ)	Tunisia
ܬܝܡܢܐ ܕܣܘܕܐܢ	Sør-Sudan
ܩܘܛܢܝܘܬܐ ܕܩܘܢܓܘ	Republikken Kongo
ܩܘܛܢܝܘܬܐ ܕܩܘܢܓܘ ܕܝܡܘܩܪܛܝܬܐ	Den demokratiske republikken Kongo
ܦܐܦܐ ܝܘܚܢܢ ܦܘܠܘܣ ܬܪܝܢܐ	Johannes Paul II
ܛܒܝܠܝܣܝ	Tbilisi
ܩܐܡܪܘܢ	Kamerun
ܠܘܒܐ	Libya
ܡܘܪܝܛܢܝܐ	Mauritania
ܡܓܪܒ	Marokko
ܢܝܓܪ	Niger
ܣܘܕܐܢ	Sudan
ܩܫܬܐ ܕܡܪܢ	Regnbue
ܗܐܡܒܘܪܓ	Hamburg
ܝܡܬܐ ܕܐܘܢܛܪܝܘ	Ontariosjøen
ܝܡܬܐ ܕܣܘܦܝܪܝܘܪ	Lake Superior
ܓܐܘܓܪܦܝܐ	Geografi
ܠܒܐ	Hjerte
ܡܘܚܐ	Hjerne
ܓܠܕܐ	Hud
ܓܘܢܐ	Farge
ܦܪܐܓ	Praha
ܙܪܩܐ	Blå
ܟܣܦܐ (ܣܐܡܐ)	Sølv
ܡܫܝܓܢ	Michigan
ܝܡܬܐ ܕܡܝܫܝܓܢ	Michigansjøen
ܐܠܝܢܘܝ	Illinois
ܢܘܪܬ ܕܐܟܘܬܐ	Nord-Dakota
ܣܐܘܬ ܕܐܟܘܬܐ	Sør-Dakota
ܡܘܢܬܐܢܐ	Montana
ܘܐܝܘܡܝܢܓ	Wyoming
ܐܘܪܫܠܡ	Jerusalem
ܐܝܕܐܗܘ	Idaho
ܢܝܒܐܕܐ	Nevada
ܐܘܩܝܢܘܣ ܗܢܕܘܝܐ	Indiahavet
ܟܘܠܘܪܐܕܘ	Colorado
ܫܝܩܓܘ	Chicago
ܣܬܘܐ	Vinter
ܬܕܐܐ	Vår
ܩܝܛܐ	Sommer
ܬܫܪܝܬܐ	Høst
ܨܕܐܡ ܚܘܣܝܢ	Saddam Hussein
ܠܫܢܐ ܐܣܦܢܝܐ	Spansk
ܓܘܓܝ	Edderkopper
ܐܒܐ (ܦܐܪܐ)	Frukt
ܩܘܦܐ	Apekatter
ܒܪܓܝܢܝܐ	Virginia
ܝܡܬܐ ܕܝܘܪܘܢ	Huronsjøen
ܢܝܘ ܝܘܪܩ (ܐܘܚܕܢܐ ܡܚܝܕܐ)	New York (delstat)
ܪܘܕ ܐܝܠܐܢܕ	Rhode Island
ܪܚܫܐ	Insekter
ܡܐܪܝܠܐܢܕ	Maryland
ܕܝܠܐܘܝܪ	Delaware
ܐܘܗܐܝܘ	Ohio
ܦܢܣܝܠܒܐܢܝܐ	Pennsylvania
ܐܝܛܙܢ	Uetersen
ܐܓܘܣܛܘܣ ܩܣܪ	Augustus
ܢܝܘ ܓܝܪܣܝ	New Jersey
ܐܢܕܝܐܢܐ	Indiana
ܪܕܝܬܐ	Bil
ܓܘܪܓܝܐ (ܐܘܚܕܢܐ ܡܚܝܕܐ)	Georgia (USA)
ܣܩܠܝܐ	Sicilia
ܣܢ (ܢܗܪܐ)	Seine
ܛܘܩܝܘ	Tokyo
ܦܪܕܝܢܢܕ ܡܓܝܠܢ	Ferdinand Magellan
ܢܝܘ ܡܝܟܣܝܟܘ	New Mexico
ܐܬܢܘܣ	Athen
ܡܢܝܣܘܬܐ	Minnesota
ܒܓܕܐܕ (ܡܕܝܢܬܐ)	Bagdad
ܘܝܣܟܘܢܣܢ	Wisconsin
ܐܝܐܘܐ	Iowa
ܢܝܒܪܐܣܟܐ	Nebraska
ܟܐܢܣܐܣ	Kansas
ܡܝܙܘܪܝ	Missouri
ܐܪܟܢܣܐܣ	Arkansas
ܠܫܢܐ ܕܐܘܪܕܘ	Urdu
ܐܘܟܠܐܗܘܡܐ	Oklahoma
ܝܡܐ ܕܓܪܒܝܐ	Nordsjøen
ܒܝܝܢܐ	Wien
ܩܘܦܢܗܐܓܢ	København
ܣܛܘܩܗܘܠܡ	Stockholm
ܗܠܣܢܩܝ	Helsingfors
ܕܒܠܢ	Dublin
ܒܪܛܝܣܠܐܒܐ	Bratislava
ܟܬܒܐ ܩܕܝܫܐ	Bibelen
ܠܫܢܐ ܐܢܓܠܝܐ	Engelsk
ܩܘܢܣܦܣܝܘܢ (ܬܫܝܠܝ)	Concepción
ܐܘܢܛܐܪܝܘ	Ontario
ܡܐܢܝܛܘܒܐ	Manitoba
ܐܠܒܪܛܐ	Alberta
ܢܘܒܐ ܣܩܘܛܝܐ	Nova Scotia
ܩܘܢܣܩܘܒܘܠܐ	Końskowola
ܢܝܘ ܒܪܘܢܙܘܝܩ	New Brunswick
ܩܘܠܘܡܒܝܐ ܒܪܝܛܝܬܐ	Britisk Columbia
ܓܙܪܬܐ ܕܐܡܝܪܐ ܐܕܘܐܪܕ	Prince Edward Island
ܣܐܣܩܐܬܫܘܐܢ	Saskatchewan
2012	2012
2011	2011
2010	2010
2009	2009
ܢܝܘܦܐܘܢܕܠܢܕ ܘܠܐܒܪܐܕܘܪ	Newfoundland og Labrador
2008	2008
ܐܘܚܕܢܐ ܓܪܒܝܝܐ-ܡܥܪܒܝܐ	Nordvestterritoriene
ܝܘܩܘܢ	Yukon
2005	2005
2006	2006
ܢܘܢܐܒܘܛ	Nunavut
2007	2007
ܡܐܟܘܠܬܐ	Mat
ܚܘܝܐ	Slanger
ܩܘܪܘܦ	Kurów
ܟܝܡܝܐ	Kjemi
1968	1968
ܩܛܠܥܡܐ ܝܗܘܕܝܐ	Holocaust
ܡܕܪܝܕ (ܡܕܝܢܬܐ)	Madrid
ܗܘܦܪܟܝܣ ܘܐܘܚܕܢܐ ܕܩܢܕܐ	Canadas provinser og territorier
ܣܢܛܝܐܓܘ ܕܐ ܬܫܝܠܝ	Santiago de Chile
ܚܐܪܘܬܐ	Frihet
ܣܝܕܢܝ	Sydney
ܝܪܘܩܐ	Grønn
ܡܠܒܘܪܢ	Melbourne
ܣܘܡܩܐ	Rød
ܢܘܪܐ (ܕܠܩܐ)	Ild
ܢܝܠܘܣ	Nilen
ܓܙܐܐܪ (ܡܕܝܢܬܐ)	Alger
ܬܘܢܣ (ܡܕܝܢܬܐ)	Tunis
ܛܗܪܐܢ	Teheran
ܐܢܩܪܐ	Ankara
ܢܝܐܡܝ	Niamey
ܒܡܩܘ	Bamako
ܕܪܡܣܘܩ	Damaskus
ܥܡܐܢ	Amman
ܒܝܪܘܬ	Beirut
ܒܝܬ ܨܘܒܐ	Universitet
ܒܝܬܐ (ܒܢܝܢܐ)	Hus
ܐܘܣܛܪܠܝܐ (ܝܒܫܬܐ)	Australia (kontinent)
ܢܗܪܐ	Elv
ܪܝܫܐ ܕܣܒܪܐ ܛܒܐ	Kapp det gode håp
ܫܘܚܡܠܐ	Investering
ܩܘܪܝܛܝܒܐ	Curitiba
ܥܒܐ	Skog
ܩܘܢܦܘܫܝܘܣ	Konfucius
ܩܢܐ	Fuglerede
ܐܘܪܘ	Euro
ܝܡܐ ܚܘܪܐ ܡܨܥܝܐ	Middelhavet
ܓܘܪܓܝܐ	Georgia (andre betydninger)
ܡܫܝܚܝܘܬܐ	Kristendom
ܩܠܒܐ:ܐܘܝܐ	Mal:For
ܪܘܙܐ	Ris
ܝܒܫܬܐ	Kontinent
ܛܝܪܐ	Fugler
ܐܪܫܟܝܬܐ	Hovedstad
ܠܫܢܐ ܦܘܪܛܘܓܠܝܐ	Portugisisk
ܝܪܚܐ	Måned
ܡܘܨܛܦܐ ܟܡܐܠ ܐܛܐܛܘܪܩ	Mustafa Kemal Atatürk
ܐܠܡܐܙܢ	Almazán
ܠܫܢܐ ܝܦܢܝܐ	Japansk
ܦܐܬܐ ܪܝܫܝܬܐ	Portal:Forside
ܦܪܢܣܝܣܩܘ ܓܘܝܐ	Francisco Goya
ܝܡܐ ܐܚܪܝܐ	Det kaspiske hav
ܝܡܬܐ ܕܐܝܪܝ	Eriesjøen
ܣܠܒܐܕܘܪ ܕܐܠܝ	Salvador Dalí
ܒܢܣܢܬ ܦܢ ܟܘܟ	Vincent van Gogh
ܦܪܝܕܐ ܩܐܠܘ	Frida Kahlo
ܗܢܪܝ ܡܐܛܝܣ	Henri Matisse
ܡܝܟܠܐܢܓܠܘ	Michelangelo
ܦܒܠܘ ܦܝܩܐܣܘ	Pablo Picasso
ܪܡܒܪܢܛ	Rembrandt
ܐܢܕܝ ܘܘܪܗܘܠ	Andy Warhol
ܢܝܢܘܐ (ܡܕܝܢܬܐ)	Ninive
ܒܒܠ	Babylon
ܐܝܪܝܚܘ	Jeriko
ܩܛܠܘܢܝܐ	Catalonia
ܡܕܪܝܕ (ܗܘܦܪܟܝܐ)	Madrid (autonom region)
ܒܝܬ ܠܚܡ	Betlehem
ܣܕܪܐ:Candidates for speedy deletion	Kategori:Sider som er foreslått raskt slettet
ܪܫܡܠܘܬܐ	Kapitalisme
ܐܘܡܬܐ	Nasjon
ܩܪܬܐܓܘ	Karthago
ܣܕܪܐ:ܐܣܛܪܘܢܘܡܝܐ	Kategori:Astronomi
ܨܚܪܐܐ	Sahara
ܫܐܕܐ	Djevel
ܒܝܬ ܟܬܒܐ	Bibliotek
ܫܘܠܛܢܘܬܐ (ܫܘܬܐܣܐ)	Regjering
ܬܫܝܢ ܫܝ ܗܘܐܢܓ	Qin Shi Huangdi
ܡܕܢܚܐ ܡܨܥܝܬܐ	Midtøsten
ܡܠܟܘܬܐ	Monarki
ܩܘܛܢܝܘܬܐ	Republikk
ܐܬܪܐ	Stat
ܓܒܐ	Politisk parti
ܝܗܘܕܝܐ	Jøder
ܝܡܡܬܐ ܪܘܪܒܬܐ	De store sjøer
ܐܘܩܝܢܘܣ ܬܝܡܢܝܐ	Sørishavet
ܐܕܢܐ (ܝܘܠܦܢ ܨܪܘܝܘܬܐ)	Øre
ܢܚܝܪܐ	Nese
ܥܝܢܐ (ܝܘܠܦܢ ܨܪܘܝܘܬܐ)	Øye
ܥܘܩܒܪܬܐ	Muskel
ܙܡܝܪܬܐ	Sang
ܓܡܠܐ	Kameler
ܫܘܫܡܢܐ	Maur
ܕܒܫܬܐ	Bier
ܠܫܢܐ ܗܘܠܢܕܝܐ	Nederlandsk
ܐܡܐ (ܒܝܬܝܘܬܐ)	Mor
ܐܒܐ (ܒܝܬܝܘܬܐ)	Far
1847	1847
ܨܦܪܐ (ܙܒܢܐ)	Morgen
ܪܡܫܐ	Kveld
ܩܛܝܢܬܐ	Minutt
ܠܫܢܐ ܪܘܣܝܐ	Russisk
ܠܫܢܐ ܨܝܢܝܐ	Kinesisk
ܕܡܐ	Blod
ܬܓܪܘܡܬܐ	Skjelett
ܪܐܬܐ	Lunge
ܠܫܢܐ ܪܘܡܢܝܐ	Rumensk
ܡܛܪܐ	Regn
ܢܠܣܘܢ ܡܐܢܕܝܠܐ	Nelson Mandela
ܐܒܢܐ	Bergart
ܥܢܢܐ	Sky
ܩܢܘܢܐ ܕܠܥܙܐ	Grammatikk
ܠܫܢܐ ܓܘܪܓܝܐ	Georgisk
ܝܘܠܦܢ ܡܡܫܚܘܬܐ	Samfunnsøkonomi
ܙܘܙܐ	Valuta
ܡܕܐܬܐ	Skatt
ܐܠܦܒܝܬ ܥܪܒܝܐ	Det arabiske alfabetet
ܐܠܦܒܝܬ ܝܘܢܝܐ	Det greske alfabetet
ܐܠܦܒܝܬ ܠܐܛܝܢܝܐ	Det latinske alfabetet
ܣܕܪܐ:ܦܪܢܣܐ	Kategori:Frankrike
ܟܢܫܐ	Samfunn
ܓܒܪܐ	Mann
ܙܘܘܓܐ	Ekteskap
ܙܕܩܐ ܕܒܪܢܫܐ	Menneskerettigheter
ܩܪܒܐ ܓܘܝܐ	Borgerkrig
ܓܪܡܐ ܕܣܢܘܢܝܬܐ	Brystbein
ܬܪܝܢܐ	Jus (drikk)
ܚܠܒܐ (ܕܝܘܒܐ)	Melk
ܛܘܪܐ	Fjell
ܡܕܒܪܐ	Ørken
ܠܫܢܐ ܐܠܒܢܝܐ	Albansk
ܠܫܢܐ ܐܪܡܢܝܐ	Armensk
ܝܘܗܐܢ ܓܘܛܢܒܪܓ	Johann Gutenberg
ܠܫܢܐ ܣܘܝܕܝܐ	Svensk
ܢܝܩܘܠܐ ܛܣܠܐ	Nikola Tesla
ܡܘܫܐ	Moses
ܬܕܐ	Bryst
ܢܘܗܪܐ (ܚܙܝܬܐ)	Lys
ܠܫܢܐ ܝܘܢܝܐ	Gresk
ܠܫܢܐ ܦܪܣܝܐ	Persisk
ܬܘܕܝܬܐ	Religion
ܐܒܪܗܡ	Abraham (bibelsk person)
ܣܦܪܐ ܕܒܪܝܬܐ	Første Mosebok
ܠܫܢܐ ܩܢܛܘܢܝܐ	Standard kantonesisk
ܠܫܢܐ ܡܢܕܪܝܢܝܐ	Mandarin (språk)
ܦܘܠܘܣ ܫܠܝܚܐ	Apostelen Paulus
ܙܝܓܡܘܢܕ ܦܪܘܝܕ	Sigmund Freud
ܙܠܛܐ	Salat (mat)
ܝܗܘܕܝܘܬܐ	Jødedom
ܠܫܢܐ ܥܒܪܝܐ	Hebraisk
ܟܒܕܐ	Lever
ܛܚܠܐ	Milt
ܟܘܠܝܬܐ	Nyre
ܫܠܦܘܚܬܐ	Urinblære
ܐܫܟܐ	Testikkel
ܐܘܩܝܢܘܣ	Verdenshav
ܒܘܕܗܐ	Buddha
ܡܘܚܡܕ	Muhammed
ܟܪܣܐ	Abdomen
ܚܒܠܐ ܟܘܒܝܐ	Ryggmargen
ܘܪܝܕܐ	Vene
ܡܪܒܥܐ	Livmor
ܠܫܢܐ (ܗܕܡܐ)	Tunge
ܨܘܪܐ (ܝܘܠܦܢ ܨܪܘܝܘܬܐ)	Hals
ܦܘܡܐ	Munn
ܓܓܪܬܐ	Strupehode
ܫܪܝܬܐ	Ledd
ܬܝܪܬܐ	Kjertel
ܚܠܒܐ (ܝܘܠܦܢ ܨܪܘܝܘܬܐ)	Mellomgolv
ܫܪܝܢܐ	Arterie
A	A
B	B
ܢܘܛܦܬܐ	Sperma
G	G
U	U
Z	Z
F	F
J	J
ܐܠܦܒܝܬ	Alfabet
T	T
C	C
R	R
D	D
Α	Alfa
Ω	Omega
I	I
Μ	My
E	E
H	H
ܗܐܪܠܡ (ܗܘܠܢܕܐ)	Haarlem
K	K
L	L
M	M (bokstav)
N	N
O	O
Q	Q
S	S
V	V
W	W
X	X
Y	Y
ܐܢܫܟܕܐ	Enschede
ܗܢܓܠܘ	Hengelo (Overijssel)
Φ	Phi
ܝܘܢܐ	Duer
ܐܝܠܢܐ	Tre
Λ	Lambda
ܓܒܬܐ	Ost
ܥܢܒܬܐ	Druer
ܕܒܫܐ	Honning
ܒܣܪܐ	Kjøtt
ܫܟܪ	Sukker
ܣܦܪܙܒܢܐ	Avis
ܙܥܘܩܐ	Telefon
ܡܪܕܘܬܐ	Kultur
ܡܥܝܐ ܥܒܝܐ	Tykktarm
ܡܥܝܐ ܩܛܝܢܐ	Tynntarm
ܣܘܪܓܕܐ ܝܘܠܝܝܐ	Juliansk kalender
ܐܣܝܘܬܐ	Medisin
ܣܕܪܐ:ܒܪܐܙܝܠ	Kategori:Brasil
ܙܘܝܬܐ (ܡܚܪܘܬܐ)	Vinkel
ܬܘܩܦܐ	Energi
ܣܦܝܢܬܐ	Skip
ܩܠܐ (ܨܘܬܐ)	Lyd
ܙܓܘܓܝܬܐ	Glass (materiale)
ܫܛܝܚܘܬܐ	Areal
ܡܢܝܢܐ	Tall
ܪܦܦܐ	Sekund
ܣܥܪܬܐ	Bygg (korn)
ܘܘܗܐܢ	Wuhan
ܡܟܬܒܢܘܬܐ ܕܐܬܪܘܬܐ	Liste over stater
ܒܝܬ ܢܗܪܝܢ	Mesopotamia
ܕܒܐ	Bjørnefamilien
ܬܠܗܝܐ	Kreft
ܡܠܟܐ	Konge
ܚܛܬܐ	Hveteslekten
ܣܘܪܓܕܐ	Kalender
ܟܘܪܗܢܐ	Sykdom
ܣܘܪܓܕܐ ܓܪܝܓܘܪܝܐ	Gregoriansk kalender
ܟܦܣܐ	Menstruasjon
ܥܡܐ ܩܪܕܘܝܐ	Kurdere
ܓܫܪܐ	Bro
ܡܓܕܠܐ (ܒܢܝܢܐ)	Tårn
ܐܡܪܝܩܐ ܠܐܛܝܢܝܬܐ	Latin-Amerika
ܟܗܪܒܐ	Elektrisitet
ܡܙܝܥܢܐ ܕܩܝܕܐ ܓܘܝܐ	Forbrenningsmotor
ܣܝܦܐ (ܙܝܢܐ)	Sverd
ܫܡܥܘܢ ܩܢܢܝܐ	Apostelen Simon seloten
ܩܪܩܦܬܐ	Skalle
ܓܘܡܠܐ!	Joomla!
ܐܦܫܬܐ	Rosin
ܠܫܢܐ ܕܗܣܝܐܢܓ	Xiang
ܠܫܢܐ ܥܪܒܝܐ	Arabisk
ܠܫܢܐ ܐܦܪܝܩܐܢܝܐ	Afrikaans
Β	Beta
Γ	Gamma
Δ	Delta (bokstav)
Ε	Epsilon
Ζ	Zeta
Η	Eta (bokstav)
Θ	Theta
Ι	Iota
Κ	Kappa (bokstav)
Ν	Ny (bokstav)
Ξ	Ksi
Ο	Omikron
Ρ	Rho
Σ	Sigma
Τ	Tau (bokstav)
Υ	Ypsilon
Χ	Khi
Ψ	Psi
ܐܬܐ	Flagg
ܟܪܦܬܐ	Møbel
ܟܘܪܣܝܐ	Stol
ܣܦܬܐ	Lepper
ܦܣܡܐ	Bart
ܥܩܠܐ	Fot (kroppsdel)
1000000000 (ܡܢܝܢܐ)	Milliard
ܩܠܝܕܐ (ܓܪܡܐ)	Kragebein
ܟܬܦܐ	Skulder
ܘܝܩܝܦܕܝܐ:ܬܪܥܐ ܕܟܢܫܐ	Wikipedia:Tinget
ܒܝܪܡܘܢܬ	Vermont
ܩܘܣܛܢܛܝܢܘܦܘܠܝܣ	Konstantinopel
ܒܝܬ ܟܪܝܗܐ	Sykehus
ܥܕܬܐ	Kirke
ܕܝܬܝܩܝ ܚܕܬܐ	Det nye testamente
9 (ܡܢܝܢܐ)	9 (tall)
1002	1002
ܦܘܕܘܠܣܟ	Podolsk
ܦܐܦܐ	Pave
5	5
4	4
ܢܝܒܐ	Hjørnetann
3	3
2	2
ܒܝܬ ܥܬܩܐ ܕܠܘܒܪ	Louvre
ܓܒܐ ܕܚܐܪܘܬܐ ܕܦܘܐܪܛܘ ܪܝܩܘ	Partido Independentista Puertorriqueño
6	6
ܕܝܬܝܩܝ ܥܬܝܩܬܐ	Det gamle testamente
ܥܐܕܐ ܕܒܝܬ ܝܠܕܐ	Jul
ܠܫܢܐ ܪܘܡܐܢܣܝܐ	Romanske språk
ܡܬܠܬܐ	Trekant
ܫܢܬܐ ܟܒܝܫܬܐ	Skuddår
ܡܘܥܡܪ ܐܠܩܕܐܦܝ	Muammar al-Gaddafi
ܥܐܕܐ ܕܩܝܡܬܐ	Påske
ܢܝܘ ܝܘܪܩ	New York (andre betydninger)
ܢܦܛܐ	Petroleum
ܣܐܘܢܐ	Sko
ܒܝܬ ܥܘܪܦܢܐ	Bank
ܐܝܪܠܢܕ (ܓܙܪܬܐ)	Irland (øy)
1	1
ܠܘ ܫܘܢ	Lu Xun
10	10
20	20
9	9
7	7
8	8
7 (ܡܢܝܢܐ)	7 (tall)
8 (ܡܢܝܢܐ)	8 (tall)
12	12
ܡܠܐܐ ܘܬܘܒܐ	Tidevann
ܫܒܘܥܐ	Ukedager
ܓܠܝܕܐ	Is
ܨܠܘܬܐ ܡܪܢܝܬܐ	Fader vår
ܝܡܬܐ	Innsjø
ܝܡܐ ܣܘܡܩܐ	Rødehavet
13	13
ܩܛܘܬܐ (ܝܥܝܬܐ)	Agurk
ܓܙܪܬܐ	Øy
ܚܘܪܐ	Hvit
ܐܘܟܡܐ	Svart
6 (ܡܢܝܢܐ)	6 (tall)
ܠܫܢܐ ܪܘܫܡܝܐ	Offisielt språk
11	11
15	15
14	14
17	17
ܣܦܪ ܡܠܐ	Ordbok
18	18
19	19
16	16
21	21
ܦܠܣܛܝܢ	Palestina (område)
10 (ܡܢܝܢܐ)	10 (tall)
ܡܣܘܪܩܐ (ܡܐܢܐ)	Kam
ܠܝܠܐ ܕܘܢܤ	Lila Downs
ܝܡܐ ܕܡܠܚܐ	Dødehavet
ܫܘܚܠܦܐ ܕܫܢܬܐ	Årstid
ܠܝܒܪܦܘܠ	Liverpool
ܩܘܦܬܐ (ܛܝܪܐ)	Ugler
ܫܥܬܐ	Time (tidsenhet)
ܢܐܘܝ ܕܘܪ ܟܪܘܠܣܟܝ	Nowy Dwór Królewski
ܐܪܙܦܬܐ	Hammer (redskap)
ܝܘܢܫܘܦܝܢ	Jönköping
ܥܘܠܐ ܚܝܐ	Foster
ܐܠܦܒܝܬ ܣܘܪܝܝܐ	Det syriske alfabetet
ܐܠܦܒܝܬ ܐܪܡܝܐ	Det arameiske alfabetet
ܐܣܝܐ ܡܥܪܒܝܬܐ	Vest-Asia
ܙܡܪܐ	Vokalist
ܩܠܦܬܐ ܕܒܣܡܐ	Kanel
ܡܙܬܐ	Hår
ܠܫܢܐ ܐܪܡܝܐ	Arameisk
ܨܦܪܐ (ܛܝܪܐ)	Spurvefamilien
ܐܦܣܩܘܦܐ	Biskop
ܨܝܢ (ܐܪܥܐ)	Kina
ܓܒܐ ܕܝܡܘܩܪܛܝܐ (ܐܘܚܕܢܐ ܡܚܝܕܐ)	Det demokratiske parti
ܒܝܐܛܪܝܟܣ ܕܒܝܬ ܗܘܠܢܕܝܐ	Beatrix av Nederland
ܡܠܟܘܬܐ ܕܗܘܠܢܕܐ	Kongeriket Nederlandene
ܐܒܪܝܠ ܠܐܒܝܢ	Avril Lavigne
ܪܝܫ ܩܘܛܢܝܘܬܐ	President
ܐܚܐ (ܒܝܬܝܘܬܐ)	Søsken
ܐܪܒܝܐ	Den arabiske halvøy
ܡܪܩܘܣ ܐܘܢܓܠܣܛܐ	Evangelisten Markus
ܥܘܠܐ	Embryo
ܠܫܢܐ ܕܗܟܐ	Hakka (språk)
ܫܘܫܡܢܝܬܐ (ܝܥܝܬܐ)	Kardemomme
ܠܫܢܐ ܕܓܐܢ	Gan (språk)
ܒܝܬ ܥܬܩܐ	Museum
ܐܠܦܒܝܬ ܥܒܪܝܐ	Det hebraiske alfabetet
ܠܫܢܐ ܣܘܪܝܝܐ	Gammelsyrisk
ܒܪܩܐ	Lyn
ܐܝܕܐ	Hånd
ܫܡܥܘܢ ܟܐܦܐ	Apostelen Peter
ܬܠ ܐܒܝܒ	Tel Aviv
ܒܐܠܦܐܪܐܝܣܘ	Valparaíso
ܠܫܢܐ ܫܝܡܝܐ	Semittiske språk
ܚܘܣܢܝ ܡܘܒܐܪܟ	Hosni Mubarak
ܘܐܟܐܩܐ	Oaxaca
ܚܐܘܬܐ	Smør
ܐܘܢܓܠܝܘܢ	Evangelium
ܠܫܢܐ ܕܘܘ	Wu (språk)
ܪܘܛܪܕܐܡ	Rotterdam
ܩܪܛܐ	Kreta
ܐܘܪܚܐ	Vei
ܩܘܪܨܐ ܚܠܝܨܐ	CD
ܦܪܬ	Eufrat
ܩܝܘܛܘ	Kyoto
ܥܣܪܐ ܦܘܩܕܢܐ	De ti bud
ܒܪܩܩܐ ܦܪܣܝܐ	Persiabukten
ܚܠܐ (ܕܚܝܚܐ)	Sand (materiale)
ܘܪܕܐ	Roseslekta
ܓܙܪܬܐ ܝܒܫܢܝܬܐ	Halvøy
ܐܘܪܝܬܐ	Tora
ܟܘܘܝܬ (ܡܕܝܢܬܐ)	Kuwait (by)
ܡܚܙܝܬܐ	Speil
ܥܡܐ ܥܪܒܝܐ	Arabere
ܟܘܬܐ	Vindu
ܠܫܢܐ ܝܘܢܝܐ ܥܬܝܩܐ	Gammelgresk
ܠܫܢܐ ܐܟܕܝܐ	Akkadisk
ܕܩܠܬ	Tigris
ܐܬܪܘܬܐ ܕܐܬܪܘܬܐ ܡܚܝܕܐ ܕܐܡܪܝܩܐ	USAs delstater
ܡܥܡܘܕܝܬܐ	Dåp
ܩܘܢܓܘ	Kongo
ܐܝܢܛܪܠܝܢܓܘܐ	Interlingua
ܐܘܪܟܐ	Lengde
ܚܠܡܐ	Drøm
ܠܫܢܐ ܩܪܕܘܝܐ	Kurdisk
ܩܡܚܐ	Mel
ܕܢ ܗܐܟ	Haag
ܠܫܢܐ ܦܘܢܝܩܝܐ	Fønikisk
ܣܝܢܝ (ܓܙܪܬܐ ܝܒܫܢܝܬܐ)	Sinaihalvøya
ܟܪܘܙܘܬܐ ܕܝܘܚܢܢ	Evangeliet etter Johannes
ܬܪܥܐ (ܒܒܐ)	Dør
ܪܝܗܐܢܐ	Rihanna
ܛܦܪܐ	Negl
ܐܦܐ	Ansikt
ܨܨܐ (ܨܢܥܬܐ)	Spiker
ܙܝܬܐ	Oliven
ܬܠܝܬܝܘܬܐ	Den hellige treenighet
ܓܠܠܐ	Bølge
ܟܬܒܬܐ	Skriving
ܪܘܚܐ ܕܩܘܕܫܐ	Den Hellige Ånd
100 (ܡܢܝܢܐ)	100 (tall)
ܒܘܪܟܐ	Kne
ܫܘܩܐ (ܬܐܓܪܘܬܐ)	Marked
ܠܫܢܐ ܥܪܒܝܐ ܝܗܘܕܝܐ	Judæo-arabisk
ܒܠܛܝ	Bălți
1000000 (ܡܢܝܢܐ)	Million
ܛܐܒܐ	Nyhet
ܐܫܬܐ (ܐܣܝܘܬܐ)	Feber
ܩܫܬܐ ܓܪܒܝܝܬܐ ܕܐܪܥܐ	Nordlige halvkule
ܡܡܘܢܐ ܕܡܝܟܪܐ	Mikroøkonomi
ܠܝܕܣ	Leeds
ܥܘܩܒܪܐ	Mus (slekt)
ܦܘܪܬܩܠܐ	Oransje
ܒܪܩܩܐ	Bukt
ܒܝܬ ܩܒܘܪܐ	Gravlund
ܐܣܝܐ (ܫܕܬܐ)	Lege
ܦܢܛܝܩܘܣܛܝ	Pinse
ܫܓܕܬܐ	Mandel
ܟܪܘܙܘܬܐ ܕܠܘܩܐ	Evangeliet etter Lukas
ܩܘܢܣܦܣܝܘܢ (ܗܘܦܪܟܝܐ)	Provincia de Concepción
ܢܗܪܐ ܕܝܘܪܕܢܢ	Jordan (elv)
ܣܦܪ ܝܡܐ	Strand
ܐܢܛܐܠܝܐ (ܗܘܦܪܟܝܐ)	Antalya (provins)
ܦܪܟܣܝܣ ܕܫܠܝܚܐ	Apostlenes gjerninger
ܥܪܘܒܬܐ ܕܚܫܐ	Langfredag
ܚܒܘܫܝܐ	Fengsel
ܐܕܢܐ (ܗܘܦܪܟܝܐ)	Adana (provins)
ܝܘܚܢܢ ܡܥܡܕܢܐ	Johannes Døperen
ܨܠܝܒܐ	Kors
ܚܙܒܐܠܠܗ	Hizbollah
ܒܝܬ ܓܒܝܢܐ	Panne
ܡܙܡܘܪܐ	Salmenes bok
ܐܬܘܪ	Assyria
ܒܢܝܢܐ	Bygning
ܚܠܒ (ܡܕܝܢܬܐ)	Aleppo
ܩܫܬܐ ܬܝܡܢܝܬܐ ܕܐܪܥܐ	Sydlige halvkule
ܚܠܐ (ܚܡܪܐ)	Eddik
ܒܝܬ ܕܝܢܐ	Domstol
ܚܝܦܐ	Haifa
ܪܡܕܐܢ	Ramadan
ܫܛܪܐ ܬܐܒܝܠܝܐ ܕܓܝܢܝܣ	Guinness rekordbok
ܟܘܕܢܝܐ	Muldyr
ܒܪܩܩܐ ܕܥܕܢ	Adenbukta
ܓܠܝܢܐ ܕܝܘܚܢܢ	Johannes' åpenbaring
ܐܫܬܐ (ܝܘܠܦܢ ܨܪܘܝܘܬܐ)	Rumpeball
ܨܠܘܬܐ ܡܪܝܡܝܬܐ	Hill deg, Maria
ܝܩܕܐ	Drivstoff
ܝܨܝܠܐ	Albue
ܟܗܢܐ	Prest
ܕܩܢܐ	Skjegg
ܢܒܝܐ	Profet
ܐܘܪܟܝܣܛܪܐ	Orkester
1000 (ܡܢܝܢܐ)	1000 (tall)
ܣܘܦܝܐ ܪܘܛܐܪܘ	Sofia Rotaru
ܬܫܢܝܬܐ	Forsikring
ܛܘܟܣܐ	Organisasjon
ܣܦܪܓܠܐ	Kvede
ܐܢܕܪܐܘܣ ܫܠܝܚܐ	Apostelen Andreas
ܬܪܥܣܪ ܫܠܝܚܐ	Jesu apostler
ܢܩܒܬܐ	Hun
ܕܪܥܐ (ܗܕܡܐ)	Arm
ܡܬܝ ܡܟܣܐ	Evangelisten Matteus
ܬܐܘܡܐ ܫܠܝܚܐ	Apostelen Tomas
ܦܝܠܝܦܘܣ ܫܠܝܚܐ	Apostelen Filip
ܒܘܪܨܐ (ܗܘܦܪܟܝܐ)	Bursa (provins)
ܐܝܘܐܢܢܝܣ ܦܘܡܐ ܕܕܗܒܐ	Johannes Khrysostomos
ܒܢܝܡܝܢ ܢܬܢܝܗܘ	Benjamin Netanyahu
ܐܪܬܒܝܢ (ܗܘܦܪܟܝܐ)	Artvin (provins)
ܓܒܝܢܐ	Øyenbryn
ܫܘܪܬܐ	Navle
ܐܕܝܐܡܐܢ (ܗܘܦܪܟܝܐ)	Adıyaman (provins)
ܝܗܘܕܐ ܫܠܝܚܐ	Judas Taddeus
ܒܪܬܘܠܡܝ ܫܠܝܚܐ	Apostelen Bartolomeus
ܝܥܩܘܒ ܒܪ ܙܒܕܝ	Apostelen Jakob
ܡܬܝܐ ܫܠܝܚܐ	Apostelen Mattias
ܝܥܩܘܒ ܒܪ ܚܠܦܝ	Apostelen Jakob, sønn av Alfeus
ܕܟܪܐ	Han (kjønn)
ܐܝܓܢܐܛܝܘܣ ܢܘܪܢܐ	Ignatius av Antiokia
ܪܕܝܘܗܕ	Radiohead
ܒܫܐܪ ܐܠܐܣܕ	Bashar al-Assad
ܪܚܝܐ	Mølle
ܨܘܡܐ	Faste
ܕܝܪܐ	Kloster
ܠܡܐܢܐ	Havn
ܡܠܚܐ (ܢܘܛܐ)	Sjømann
ܐܦܝܘܢ (ܗܘܦܪܟܝܐ)	Afyonkarahisar (provins)
ܡܝܟܐܝܠ (ܡܠܐܟܐ)	Erkeengelen Mikael
ܒܝܠܓܝܟ (ܗܘܦܪܟܝܐ)	Bilecik (provins)
ܒܝܬ ܥܬܩܐ ܕܐܣܪܐܝܠ	Israel Museum
ܒܐܠܝܟܣܝܪ (ܗܘܦܪܟܝܐ)	Balıkesir (provins)
ܒܝܬ ܝܠܕܐ	Fødselsdag
ܬܘܠܥܐ	Makk
ܬܘܩܢ ܓܝܕܝܐ ܩܢܛܪܘܢܝܐ	Sentralnervesystemet
ܛܘܪܐ ܕܓܠܝܕܐ	Isfjell
ܢܢܥܐ	Mynteslekta
ܩܠܒܐ:Commonscat	Mal:Commonscat
ܒܨܪܐ (ܡܕܝܢܬܐ)	Basra
ܐܓܪܬܐ ܕܠܘܬ ܪܗܘܡܝܐ	Paulus' brev til romerne
ܬܡܪܐ ܕܥܝܢܐ	Øyelokk
ܗܘܦܪܟܝܣ ܕܛܘܪܩܝܐ	Tyrkias provinser
ܡܪܝ ܓܝܘܪܓܝܣ ܣܗܕܐ	Sankt Georg
ܐܣܘܬܐ ܕܠܐ ܬܚܘܡܐ	Leger Uten Grenser
ܐܪܙܐ (ܡܫܝܚܝܘܬܐ)	Sakrament
ܐܓܪܬܐ ܕܠܘܬ ܦܝܠܝܦܣܝܐ	Paulus' brev til filipperne
ܐܢܛܘܠܝܐ	Anatolia
ܡܫܝܚܐ	Messias
ܩܢܘܢܐ ܕܗܝܡܢܘܬܐ	Den apostoliske trosbekjennelse
ܒܢܝ ܐܝܣܪܐܝܠ	Israelitter
ܡܓܘܫܐ ܬܠܬܐ	De tre vise menn
ܝܘܚܢܢ ܕܪܡܣܘܩܝܐ	Johannes av Damaskus
ܣܕܪܐ:ܪܘܟܒ ܫܘܠܛܢܘܬܐ	Kategori:Styreformer
ܠܫܢܐ ܕܡܝܢ	Min (språk)
ܥܘܪܡܫܐ	Forurensning
ܒܒܠ (ܗܘܦܪܟܝܐ)	Babil
ܫܘܡܪܐ	Sot
ܐܫܩܠܘܢ	Ashkelon
ܕܘܢܒܐ	Hale
ܩܐܕܣܝܐ (ܗܘܦܪܟܝܐ)	Al-Qadisiyya
ܡܪܝܡ ܡܓܕܠܝܬܐ	Maria Magdalena
ܡܪܪܬܐ	Galleblære
ܥܕܬܐ ܟܠܕܝܬܐ ܩܬܘܠܝܩܝܬܐ	Den kaldeisk-katolske kirke
ܥܕܬܐ ܡܪܘܢܝܬܐ	Den maronittiske kirke
ܡܪܬܐ	Galle
ܩܘܪܒܢܐ	Nattverd
ܐܘܘܫܐ	Ørevoks
ܕܡܥܬܐ	Tårer
ܥܡܬܐ (ܒܝܬܝܘܬܐ)	Tante
ܥܡܐ (ܒܝܬܝܘܬܐ)	Onkel
ܟܘܬܝܢܐ	Skjorte
ܝܘܗܐܢ ܐܠܙܪ	Georg Elser
ܒܝܢܓܘܠ (ܗܘܦܪܟܝܐ)	Bingöl (provins)
ܥܡܐ ܐܪܡܢܝܐ	Armenere
ܐܝܕܝܢ (ܗܘܦܪܟܝܐ)	Aydın (provins)
ܩܛܠܥܡܐ ܐܪܡܢܝܐ	Folkemordet på armenerne
ܐܡܐܣܝܐ (ܗܘܦܪܟܝܐ)	Amasya (provins)
ܦܪܝܙܘܢ ܒܪܝܟ	Prison Break
ܐܓܪܝ (ܗܘܦܪܟܝܐ)	Ağrı (provins)
ܒܘܪܕܘܪ (ܗܘܦܪܟܝܐ)	Burdur (provins)
ܐܓܪܬܐ ܩܕܡܝܬܐ ܕܠܘܬ ܩܘܪܢܬܝܐ	Paulus' første brev til korinterne
ܝܗܘܕܐ ܣܟܪܝܘܛܐ	Judas Iskariot
ܐܒܪܐ	Fjær
ܡܚܪܐ	Ingeniør
ܚܪܛܘܡܢܐ	Kikert
ܐܬܪܘܬܐ ܕܫܐܡ	Levanten
ܬܪܘܕܐ	Skje
ܓܒܪܐܝܠ (ܡܠܐܟܐ)	Gabriel
ܓܪܡܦܝܠܐ	Elfenben
ܨܘܪ	Tyr
ܒܘܠܘ (ܗܘܦܪܟܝܐ)	Bolu (provins)
ܙܢܩܐ	Hake
ܨܘܡܐ ܕܐܪܒܥܝܢ	Fastetiden
ܐܓܪܐ ܕܒܢܝܢܐ	Tak (arkitektur)
ܒܝܛܠܝܣ (ܗܘܦܪܟܝܐ)	Bitlis (provins)
ܓܠܝܠܐ	Galilea
ܡܘܨܠ	Mosul
ܟܪܬܐ	Tommel
ܦܐܦܐ ܫܢܘܕܐ ܬܠܝܬܝܐ	Shenouda III
ܒܝܬ ܓܘܣܐ	Bunker (bygning)
ܒܝܥܬܐ	Egg (mat)
ܒܣܕܝܐ	Pute
ܫܒܬܐ (ܝܗܘܕܝܘܬܐ)	Sabbat (jødisk)
ܫܡܝܪܡ	Semiramis
ܫܝܓܪܐ	Tannkjøtt
ܝܗ	Tetragrammet
ܟܪܘܙܘܬܐ ܕܡܪܩܘܣ	Evangeliet etter Markus
ܟܟܪܝܬܐ ܕܕܒܫܐ	Bikake
ܐܓܪܬܐ ܕܠܘܬ ܩܘܪܢܬܝܐ ܕܬܪܬܝܢ	Paulus' andre brev til korinterne
ܫܥܘܬܐ (ܡܠܘܐܐ)	Voks
ܛܥܡܐ	Smak
ܓܢܬ ܫܒܪܐ	Barnehage
ܝܡܬܐ ܕܓܠܝܠܐ	Genesaretsjøen
ܕܝܘܬܐ	Blekk
ܡܪܝ ܝܘܣܦ	Josef, Jesu fosterfar
ܠܘܩܐ ܐܘܢܓܠܣܛܐ	Evangelisten Lukas
ܐܓܪܬܐ ܕܠܘܬ ܥܒܪܝܐ	Brevet til hebreerne
ܐܓܪܬܐ ܕܠܘܬ ܓܠܛܝܐ	Paulus' brev til galaterne
Ϝ	Digamma
Ϙ	Qoppa
ܥܛܡܐ	Lår
ܬܢܢܐ	Røyk
ܡܘܚܘܢܐ	Lillehjernen
ܐܓܪܬܐ ܕܠܘܬ ܩܘܠܣܝܐ	Paulus' brev til kolosserne
ܐܓܪܬܐ ܕܝܥܩܘܒ	Jakobs brev
ܐܓܪܬܐ ܩܕܡܝܬܐ ܕܝܘܚܢܢ	Johannes' første brev
ܐܓܪܬܐ ܕܠܘܬ ܦܝܠܡܘܢ	Paulus' brev til Filemon
ܐܓܪܬܐ ܕܠܘܬ ܬܣܠܘܢܝܩܝܐ ܕܬܪܬܝܢ	Paulus' andre brev til tessalonikerne
ܐܓܪܬܐ ܩܕܡܝܬܐ ܕܠܘܬ ܬܣܠܘܢܝܩܝܐ	Paulus' første brev til tessalonikerne
ܐܓܪܬܐ ܩܕܡܝܬܐ ܕܦܛܪܘܣ	Peters første brev
ܐܓܪܬܐ ܕܬܪܬܝܢ ܕܦܛܪܘܣ	Peters andre brev
ܐܓܪܬܐ ܩܕܡܝܬܐ ܕܠܘܬ ܛܝܡܬܐܘܣ	Paulus' første brev til Timoteus
Ϛ	Stigma (bokstav)
ܡܪܕܝܢ (ܗܘܦܪܟܝܐ)	Mardin (provins)
ܚܡܨ (ܡܕܝܢܬܐ)	Homs
Ͳ	Sampi
ܘܐܟܐܩܐ ܕܝ ܟܘܐܪܝܣ	Oaxaca by
ܐܓܪܬܐ ܕܬܪܬܝܢ ܕܝܘܚܢܢ	Johannes' andre brev
ܐܓܪܬܐ ܕܬܠܬ ܕܝܘܚܢܢ	Johannes' tredje brev
ܐܓܪܬܐ ܕܝܗܘܕܐ	Judas' brev
ܐܓܪܬܐ ܕܠܘܬ ܛܝܡܬܐܘܣ ܕܬܪܬܝܢ	Paulus' andre brev til Timoteus
ܐܓܪܬܐ ܕܠܘܬ ܛܛܘܣ	Paulus' brev til Titus
ܐܟܪܐ	Bonde
ܓܘܣܢܐ	Flyktning
Ϻ	San (bokstav)
ܩܠܝܕܐ (ܡܐܢܐ)	Nøkkel
ܥܕܥܐܕܐ	Festival
ܐܪܒܝܠ (ܡܕܝܢܬܐ)	Arbil
ܚܨܐ	Rygg (anatomi)
ܐܠܝܐ ܢܒܝܐ	Elia
ܙܚܘܪܝܬܐ (ܬܘܠܥܬܐ)	Silkeorm
ܚܘܦܝܐ	Formørkelse
ܡܚܛܐ	Synål
ܥܠܡܐ ܥܪܒܝܐ	Den arabiske verden
ܩܛܡܐ	Aske
ܢܘܗܕܪܐ (ܡܕܝܢܬܐ)	Dahuk
ܨܒܥܐ ܕܪܓܠܐ	Tå
ܢܓܪܘܬܐ	Tømrer
ܠܘܚܐ (ܚܫܘܒܬܐ)	Nettbrett
ܪܒܝܬܐ	Åger
ܡܟܝܪܘܬܐ	Forlovelse
ܫܘܪܡܐ	Endetarm
ܐܪܡܝܐ (ܢܒܝܐ)	Jeremia
ܬܐܡܐ	Tvilling
ܬܠܝܦܐ	Øyenvipp
ܫܥܬܐ ܕܐܪܥܐ	Earth Hour
ܦܪܡܝܬܐ	Knapp
ܟܘܟܒܐ ܕܕܘܝܕ	Davidsstjerne
ܡܪܝ ܐܣܛܦܢܘܣ	Stefanus
ܡܫܡܫܢܐ	Diakon
ܢܓܒ	Negevørkenen
ܟܢܥܢ	Kanaan
ܢܘܨܦܐ	Tussmørke
ܬܓܪܝܬ	Tikrit
ܚܠܐ (ܥܦܪܐ)	Støv
ܬܪܥܐ ܕܕܡܐ	Blødning
ܥܪܒܐ ܕܫܡܫܐ	Solnedgang
ܐܡܝܫܐ	Sump
ܡܨܥܝܬܐ (ܨܒܥܐ)	Langfinger
ܣܒܐ (ܒܝܬܝܘܬܐ)	Besteforeldre
ܩܘܪܨܠܐ	Ankelledd
ܒܪ ܐܝܕܐ	Hansker
ܢܫܒܐ ܕܥܝܢܐ	Netthinne
ܬܘܩܢ ܓܝܕܝܐ ܡܚܕܘܪܝܐ	Det perifere nervesystemet
ܓܓܘܠܬܐ	Golgata
ܗܢܝܢܐ (ܡܡܫܚܘܬܐ)	Rente
ܐܫܘܪ ܒܢܐܦܠ	Asurbanipal
ܓܕܫܐ	Ulykke
ܚܟܐ	Gane
ܟܪܟ ܣܠܘܟ (ܡܕܝܢܬܐ)	Kirkuk
ܒܒܬܐ	Pupill
ܩܒܪܐ	Grav
ܠܒܘܢܬܐ	Virak
ܚܡܬ (ܡܕܝܢܬܐ)	Hama
ܝܫܛܐ	Spiserør
ܟܝܣܐ ܕܐܫܟܐ	Pung
ܕܒܪܐ	Bygd
ܚܪܘܫܬܐ	Luftrør
ܓܪܡܐ ܕܥܛܡܐ	Lårben
ܫܚܘܪܐ	Trekull
ܐܘܟܡܐ ܕܥܝܢܐ	Regnbuehinne
ܫܦܠܘܗܝ ܕܢܝܠܘܣ	Nildeltaet
ܐܘܪܡܝܐ	Urmia
Ϸ	Sjo
ܓܙܪܬܐ ܐܝܘܠܝܬܐ	De eoliske øyer
ܓܒܐ ܕܒܥܬ	Ba'athpartiet
ܒܪ ܩܠܐ	Ekko
ܟܝܡܪܐ	Kimære (uhyre)
ܬܝܒܘܬܐ	Skriftemål
ܡܛܘܚܬܐ	Pekefinger
ܩܒܠܘܬܐ	Jordmor
ܣܦܪܐ (ܩܢܘܢܝܐ)	Jurist
Ͱ	Heta
ܥܡܐ ܐܪܡܝܐ	Arameere
ܐܒܐ (ܐܠܗܐ)	Gud Fader
ܐܢܒܐܪ (ܗܘܦܪܟܝܐ)	Anbar
ܡܪܕܝܢ (ܡܕܝܢܬܐ)	Mardin
ܡܘܪܘܢ	Konfirmasjon
ܚܠܡܬܐ	Patte
ܢܘܠܐ ܕܓܘܓܝ	Edderkoppnett
ܐܫܥܝܐ	Jesaja
ܒܪܬ ܙܘܓܐ (ܒܝܬܝܘܬܐ)	Hustru
ܒܝܬ ܟܬܒܐ ܐܬܪܝܐ ܕܐܣܪܐܝܠ	Israels nasjonalbibliotek
ܥܪܫܐ	Jeksel
ܢܝܢܘܐ (ܗܘܦܪܟܝܐ)	Ninawa
ܢܘܗܕܪܐ (ܗܘܦܪܟܝܐ)	Dahuk (provins)
ܘܐܣܛ (ܗܘܦܪܟܝܐ)	Wasit (provins)
ܨܠܐܚ ܐܠܕܝܢ (ܗܘܦܪܟܝܐ)	Salah ad Din
ܟܢܘܫܝܐ ܕܠܫܢܐ ܥܒܪܝܐ	Akademiet for hebraisk språk
ܥܘܕ	Oud
ܒܓܕܐܕ (ܗܘܦܪܟܝܐ)	Bagdad (guvernement)
ܣܪܓܐ	Sal (dyr)
ܒܨܪܐ (ܨܒܥܐ)	Ringfinger
ܩܛܝܣܦܘܢ	Ktesifon
ܟܒܘܫܐ	Mareritt
ܢܓܦ (ܗܘܦܪܟܝܐ)	Najaf (provins)
ܟܪܟ ܣܠܘܟ (ܗܘܦܪܟܝܐ)	Kirkuk (provins)
ܕܢܚܐ ܕܫܡܫܐ	Soloppgang
ܒܨܪܐ (ܗܘܦܪܟܝܐ)	Basra (provins)
ܡܫܚܐ ܕܟܪܝܗܐ	Sykesalving
ܦܠܫܬ	Filistere
ܐܠܥܐ (ܝܘܠܦܢ ܨܪܘܝܘܬܐ)	Ribbein
ܥܕܬܐ ܐܝܓܘܦܛܝܬܐ	Koptisk kristendom
ܐܢܛܝܘܟܝܐ	Antiokia ved Orontes
ܐܦܪܝܡ ܣܘܪܝܝܐ	Efrem Syrer
ܪܝܫܘܢ ܠܬܣܝܘܢ	Rishon LeZion
ܟܢܪܐ	Lyre
ܥܕܬܐ ܕܡܕܢܚܐ ܕܐܬܘܪܝܐ	Østens kirke
ܬܠܐ ܕܚܕ ܐܝܠܢ	One Tree Hill
ܡܘܪܐ	Myrra
ܦܕܪܠܝܐ	Føderalisme
ܐܠܝܫܥ	Elisja
ܣܢܚܪܝܒ	Sankerib
ܩܘܪܝܐܠܝܣܘܢ	Kyrie
ܣܘܟܢܐ	Ror
ܥܕܬܐ ܣܘܪܝܝܬܐ ܐܪܬܘܕܟܣܝܬܐ	Den syrisk-ortodokse kirke
ܟܣܬܐ	Grovfôr
ܩܡܫܠܝ	Qamishli
ܡܘܬܢܐ (ܗܘܦܪܟܝܐ)	Muthanna
ܒܪ ܙܘܓܐ (ܒܝܬܝܘܬܐ)	Ektemann
ܡܝܫܢ (ܗܘܦܪܟܝܐ)	Maysan
ܣܘܠܝܡܐܢܝܐ (ܗܘܦܪܟܝܐ)	Suleimania (provins)
ܐܪܒܝܠ (ܗܘܦܪܟܝܐ)	Arbil (provins)
ܚܠܒ (ܗܘܦܪܟܝܐ)	Aleppo (guvernement)
ܟܪܒܠܐܐ (ܗܘܦܪܟܝܐ)	Karbala (guvernement)
ܕܝ ܩܐܪ (ܗܘܦܪܟܝܐ)	Dhi Qar
ܐܢܕܪܢܝܩ ܡܐܪܓܐܪܝܐܢ	Andranik Margarjan
ܡܡܠܠܘܬ ܐܠܗܘܬܐ	Kristen teologi
ܓܘܙܐ	Valnøttfamilien
ܕܝܐܠܐ (ܗܘܦܪܟܝܐ)	Diyala (provins)
ܣܝܢܝ	Sinai
ܚܡܬ (ܗܘܦܪܟܝܐ)	Hama (guvernement)
ܐܝܣܪܐܝܠ (ܬܘܚܡܐ ܐܚܪܢܐ)	Israel (andre betydninger)
ܡܠܐܟܐ	Engel
ܫܢܬܐ ܦܫܝܛܬܐ	Normalår
ܡܠܟܘܬܐ ܕܒܝܬ ܥܣܪ ܥܝܢܐ	Osroene
ܕܪܥܐ (ܡܕܝܢܬܐ)	Darʿā
ܣܘܣܝܐ ܐܝܣܠܢܕܝܐ	Islandshest
ܩܠܐ	Note
ܛܘܘܝܐ	Grilling
ܠܒܠܒܬܐ	Drøvel
ܙܓܐ ܕܣܦܝܢܬܐ	Skipsklokke
ܗܪܗܪܐ	Luftspeiling
ܚܣܟܗ (ܡܕܝܢܬܐ)	Al-Hasakah
ܛܐܪܩ ܥܙܝܙ	Tariq Aziz
ܥܪܩ	Arak (brennevin)
ܫܠܦܐ	Knivblad
ܐܘܛܪܝܟܛ	Utrecht (andre betydninger)
ܡܪܝ ܐܕܝ ܬܪܝܢܐ	Addai II
ܥܡܐ ܐܬܘܪܝܐ/ܣܘܪܝܝܐ	Assyrere
ܛܘܪܐ ܕܣܝܢܝ	Sinai (fjell)
ܦܘܪܬܥܢܐ	Lopper
ܟܪܘܙܘܬܐ ܕܡܬܝ	Evangeliet etter Matteus
ܐܓܪܬܐ ܕܠܘܬ ܐܦܣܝܐ	Paulus' brev til efeserne
10000 (ܡܢܝܢܐ)	10 000
ܒܢܦܫܐ	Lilla
ܢܨܪܬ	Nasaret
ܟܬܒܐ ܕܡܘܪܡܘܢ	Mormons bok
ܐܝܓܢܐܛܝܘܣ ܡܘܫܐ ܩܕܡܝܐ ܕܐܘܕ	Ignatius Moses I
ܒܫܐܪܐ ܦܛܪܘܣ ܐܠܪܐܥܝ	Bechara Boutros al-Rahi
ܥܡܢܘܐܝܠ ܬܠܝܬܝܐ ܕܠܝ	Emmanuel III Delly
ܥܡܘܕܐ ܦܩܪܝܐ	Ryggsøyle
ܒܝܬ ܫܥܝܐ	Stadion
ܓܘܕ ܫܪܠܘܛ	Good Charlotte
ܚܣܚܘܣܐ	Brusk
ܐܝܣܛܢܒܘܠ (ܗܘܦܪܟܝܐ)	İstanbul (provins)
ܝܘܢܝܐ	Grekere
ܥܢܟܒܐ	Enkawa
ܓܗܢܐ	Gehenna (Dal utenfor Jerusalem)
ܐܓܢܛܝܘܣ ܝܘܣܦ ܬܠܝܬܝܐ ܝܘܢܢ	Ignatius Josef III
ܡܪܝ ܕܢܚܐ ܪܒܝܥܝܐ	Dinkha IV
ܬܐܓܘܪܬܐ	Handel
ܡܛܟܣܬܐ ܐܬܘܪܝܬܐ ܕܝܡܩܪܛܝܬܐ	Den assyriske demokratiske organisasjon
ܡܪܝ ܐܦܪܝܡ	Aprem Mooken
ܫܝܪܢܐܟ (ܗܘܦܪܟܝܐ)	Şırnak (provins)
ܥܘܩܣܐ	Stikkebrodd
ܟܗܢܘܬܐ	Ordinasjon
ܚܒܘܪ	Khabur
ܗܕܡܐ ܓܘܝܐ	Organ
ܐܘܪܘܦܐ	Europa (andre betydninger)
ܐܣܝܪܝܣܩܐ	Assyriska FF
ܥܕܬܐ ܣܘܪܝܝܬܐ ܩܬܘܠܝܩܝܬܐ	Den syrisk-katolske kirke
ܥܨܘܒܐ	Kirurg
ܐܘܣܛܪܠܝܐ	Australia (andre betydninger)
ܫܪܓܐ ܕܢܦܛܐ	Oljelampe
ܗܘܦܪܟܝܣ ܕܥܝܪܐܩ	Iraks provinser
ܚܬܢܐ (ܒܝܬܝܘܬܐ)	Brudgom
ܒܝܬ ܟܬܒܐ ܕܐܫܘܪ ܒܢܐܦܠ	Ashurbanipals bibliotek
ܒܕܘܩܐ	Speiderbevegelsen
ܥܘܕܪܢܐ:ܚܒܝܫܬ̈ܐ	Hjelp:Portal
ܓܦܬܐ	Klatreplante
ܙܒܐ	Lille Zab
ܐܝܓܢܐܛܝܘܣ ܙܟܝ ܩܕܡܝܐ ܥܝܘܐܨ	Ignatius Zakka I
ܐܣܛܘܡܟܐ	Magesekk
ܓܢܬܐ	Hage
ܕܪܓܘܫܬܐ	Vugge
ܚܝܠܐ ܠܒܢܝܐ	Al Qouwat al Lubnania
ܐܠܩܘܫ	Alqosh
ܐܘܪܗܝ	Edessa (Mesopotamia)
ܘܝܩܝܦܕܝܐ:ܐܝܙܓܕܘܬܐ	Wikipedia:Ambassade
ܫܠܝܬܐ	Morkake
ܒܝܬ ܛܘܣܐ	Flyplass
ܒܝܬ ܫܡܪܝܐ	Samaria (region)
ܐܓܢܣ ܡܘ	Agnes Monica
ܣܕܪܐ:ܓܪܡܢ	Kategori:Tyskland
ܣܕܪܐ:ܐܝܛܠܝܐ	Kategori:Italia
ܣܕܪܐ:ܐܬܪܘܬܐ ܡܚܝܕܐ ܕܐܡܪܝܩܐ	Kategori:USA
ܣܕܪܐ:ܪܘܣܝܐ	Kategori:Russland
ܣܕܪܐ:ܩܢܕܐ	Kategori:Canada
ܣܕܪܐ:ܐܝܣܪܐܝܠ	Kategori:Israel
ܣܕܪܐ:ܛܘܪܩܝܐ	Kategori:Tyrkia
ܣܕܪܐ:ܡܨܪܝܢ	Kategori:Egypt
ܣܕܪܐ:ܐܝܪܐܢ	Kategori:Iran
ܥܐܕܐ	Helligdag
ܣܕܪܐ:ܥܝܪܐܩ	Kategori:Irak
ܣܕܪܐ:ܗܘܠܢܕܐ	Kategori:Nederland
ܣܕܪܐ:ܦܘܠܢܕ	Kategori:Polen
ܣܕܪܐ:ܛܝܪܐ	Kategori:Fugler
ܣܕܪܐ:ܝܥܝܬܐ	Kategori:Planter
ܣܕܪܐ:ܬܘܕܝܬܐ	Kategori:Religion
ܣܕܪܐ:ܝܕܥܬܐ	Kategori:Vitenskap
ܦܪܡܬܐ ܕܣܡܠܐ	Semile-massakren
ܨܘܒܐ	Nusaybin
ܕܪܥܐ (ܗܘܦܪܟܝܐ)	Darʿā (guvernement)
ܣܕܪܐ ܕܦܛܪܝܪܟܐ ܕܥܕܬܐ ܕܡܕܢܚܐ	Liste over Østens katolikos-patriarker
ܢܩܘܕ	Niqqud
ܚܝܠܐ	Muskelkraft
ܡܪܝܡ (ܚܬܗ ܕܡܘܫܐ)	Mirjam
ܡܪܝ ܬܐܘܡܐ ܕܪܡܘ	Thoma Darmo
ܣܕܪܐ:ܬܘܚܡܐ ܐܚܪܢܐ	Kategori:Pekere
ܣܕܪܐ:ܡܫܝܚܝܘܬܐ	Kategori:Kristendom
ܣܕܪܐ:ܐܣܠܐܡ	Kategori:Islam
ܣܕܪܐ:ܝܗܘܕܝܘܬܐ	Kategori:Jødedom
ܦܩܥܬܐ ܕܢܝܢܘܐ	Ninevesletten
ܠܩܐ ܕܣܦܝܢܬܐ	Åre (redskap)
ܫܩܠܒܕ	Shaqlawa
ܙܚܘܪܝܬܐ (ܓܘܢܐ)	Skarlagen
ܐܢܩܪܐ (ܗܘܦܪܟܝܐ)	Ankara (provins)
ܬܠ ܟܐܦܐ	Tel Keppe
ܝܘܢܢ	Jona
ܫܡܐ ܕܝܠܝܕܘܬܐ	Døpenavn
ܒܪܛܠܐ	Bartella
ܫܘܫܡܬܐ	Sesam
ܣܕܪܐ:ܘܝܩܝܦܕܝܐ	Kategori:Kategoriinnhold
ܣܕܪܐ:ܝܒܫܬܐ	Kategori:Kontinenter
ܒܓܕܝܕܐ	Bakhdida
ܝܙܦܬܐ	Gjeld
ܦܨܝܕܐ	Pytt
ܢܘܪܢܝܐ	Pyramide
ܘܝܩܝܦܕܝܐ:HotCat	Wikipedia:HotCat
ܒܛܐ	Ender
ܗܝܟܠܐ ܕܫܠܝܡܘܢ	Tempelet i Jerusalem
ܩܠܒܐ:ܓܕܫܐ ܗܫܝܐ	Mal:Aktuelt
ܣܕܪܐ:ܡܟܬܒܢܘܬܐ ܕܐܬܪܘܬܐ	Kategori:Land
ܘܝܩܝܦܕܝܐ:ܡܕܒܪܢܐ	Wikipedia:Administratorer
ܣܕܪܐ:ܫܕܬܐ	Kategori:Beskjeftigelser
ܘܝܩܝܦܕܝܐ:ܒܘܬ̈ܐ	Wikipedia:Roboter
ܣܕܪܐ:ܙܒܢܐ	Kategori:Tid
ܣܕܪܐ:ܙܘܙܐ	Kategori:Penger
ܣܕܪܐ:ܝܘܠܦܢ ܨܪܘܝܘܬܐ	Kategori:Anatomi
ܣܕܪܐ:ܐܣܝܘܬܐ	Kategori:Medisin
ܬܠܐ ܙܩܝܦܐ	Tel Skuf
ܟܪܡܠܫ	Karamles
ܫܡܥܘܢ (ܫܡܐ)	Simon
ܡܪܝ ܥܒܕܝܝܫܘܥ ܕܨܘܒܐ	Abdisho bar Berika
ܡܨܪܝܢ	Egypt
ܩܠܒܐ:Bot	Mal:Bot
ܩܢܕܐ	Canada
ܣܕܪܐ:ܝܘܢ	Kategori:Hellas
ܣܕܪܐ:ܣܘܝܕ	Kategori:Sverige
ܩܠܒܐ:ܐܫܛܪܘܬܐ	Mal:Dokumentasjon
ܣܕܪܐ:User languages	Kategori:Wikipedia-brukere etter språk
ܦܘܠܚܢܐ	Næringsliv
ܩܠܒܐ:Softredirect	Mal:Softredirect
ܩܠܒܐ:Delete	Mal:Hurtigsletting
ܣܕܪܐ:ܛܟܢܘܠܘܓܝܐ	Kategori:Teknologi
ܓܒܪܐܝܠ (ܫܡܐ)	Gabriel (navn)
ܡܝܟܐܝܠ (ܫܡܐ)	Michael
ܣܕܪܐ:ܠܫܢܐ	Kategori:Språk
ܣܕܪܐ:ܩܢܘܢܐ ܕܠܥܙܐ	Kategori:Grammatikk
ܘܝܩܝܦܕܝܐ:General disclaimer	Wikipedia:Generelle forbehold
ܘܝܩܝܦܕܝܐ:ܕܘܒܪܐ	Wikipedia:Stilmanual
ܩܠܒܐ:Navbox	Mal:Navboks
ܩܠܒܐ:!	Mal:!
ܣܕܪܐ:ܩܠܒܐ ܐܬܘܬܐ ܕܐܝܣܘ	Kategori:Flaggmaler
ܩܠܒܐ:ܡܦܐܬܐ ܩܠܒܐ	Mal:Tnavbar
ܩܠܒܐ:Clear	Mal:Clear
ܘܝܩܝܦܕܝܐ:ܡܟܬܒܘܬܐ ܕܡܓܠܐ ܠܟܠ ܘܝܩܝܦܕܝܐ	Wikipedia:Liste over artikler vi bør ha
ܣܕܪܐ:ܐܠܝܩܛܪܘܢܝܘܬܐ	Kategori:Elektronikk
ܣܕܪܐ:ܝܪܚܐ ܕܫܢܬܐ	Kategori:Måneder
ܩܠܒܐ:Babel	Mal:Babel
ܩܠܒܐ:Commons	Mal:Commons
ܩܠܒܐ:Reflist	Mal:Referanser
ܩܠܒܐ:User ar-1	Mal:Bruker ar-1
ܩܠܒܐ:User az	Mal:Bruker az
ܩܠܒܐ:See also	Mal:Se også
ܩܠܒܐ:User de	Mal:Bruker de
ܩܠܒܐ:User es	Mal:Bruker es
ܩܠܒܐ:User en-3	Mal:Bruker en-3
ܩܠܒܐ:User en-1	Mal:Bruker en-1
ܩܠܒܐ:User en-2	Mal:Bruker en-2
ܩܠܒܐ:User en-4	Mal:Bruker en-4
ܩܠܒܐ:User en-0	Mal:Bruker en-0
ܩܠܒܐ:User en	Mal:Bruker en
ܩܠܒܐ:User fa	Mal:Bruker fa
ܩܠܒܐ:User fr-1	Mal:Bruker fr-1
ܩܠܒܐ:User he-2	Mal:Bruker he-2
ܩܠܒܐ:User he-1	Mal:Bruker he-1
ܩܠܒܐ:User sk	Mal:Bruker sk
ܩܠܒܐ:User tr	Mal:Bruker tr
ܩܠܒܐ:User ja	Mal:Bruker ja
ܩܠܒܐ:User fr	Mal:Bruker fr
ܩܠܒܐ:User he	Mal:Bruker he
ܣܕܪܐ:ܐܣܝܐ	Kategori:Asia
ܣܕܪܐ:ܕܪܐ ܕܥܣܪܝܢ ܘܚܕ	Kategori:2000-tallet
ܩܠܒܐ:Mod	Mal:Mod
ܩܠܒܐ:User sv	Mal:Bruker sv
ܩܠܒܐ:User it	Mal:Bruker it
ܣܕܪܐ:ܝܘܡܐ ܕܫܒܘܥܐ	Kategori:Dager i uken
ܩܠܒܐ:Edit	Mal:Rediger
ܩܠܒܐ:ܡܟܬܒܢܘܬܐ ܕܝܦܬܐ	Mal:Sammenleggbar liste
ܩܠܒܐ:Ambox	Mal:Amboks
ܩܠܒܐ:Navigation templates	Mal:Navigational templates
ܩܠܒܐ:ܐܬܪܐ	Mal:Infoboks land2
ܩܠܒܐ:ܝܬܝܪ	Mal:Hovedartikkel2
ܣܕܪܐ:User en	Kategori:Bruker en
ܣܕܪܐ:User zh	Kategori:Bruker zh
ܣܕܪܐ:User zh-N	Kategori:Bruker zh-N
ܩܠܒܐ:ܨܢܕܘܩ ܪܡܙܐ2	Mal:Infoboks
ܩܠܒܐ:User zh	Mal:Bruker zh
ܩܠܒܐ:ܐܫܛܪܘܬܐ/ܨܢܕܘܩ ܫܪܝܬܐ	Mal:Dokumentasjon/start boks
ܩܠܒܐ:Documentation/end box2	Mal:Dokumentasjon/end boks 2
ܩܠܒܐ:Documentation/start box2	Mal:Dokumentasjon/start boks 2
ܣܕܪܐ:ܦܐܦܐ	Kategori:Paver
ܩܠܒܐ:Pp-template	Mal:Beskyttet side
ܩܠܒܐ:User nl-1	Mal:Bruker nl-1
ܩܠܒܐ:User nl-2	Mal:Bruker nl-2
ܣܕܪܐ:ܪܝܫܝ ܩܘܛܢܝܘܬܐ	Kategori:Presidenter
ܩܠܒܐ:User ru	Mal:Bruker ru
ܩܠܒܐ:IPA	Mal:IPA
ܣܕܪܐ:ܗܪܘܡܐ	Kategori:Krydder
ܣܕܪܐ:ܦܠܫܬ	Kategori:Palestina
ܣܕܪܐ:ܡܠܐܟܐ	Kategori:Engler
ܩܠܒܐ:Category redirect	Mal:Kategoriomdirigering
ܩܠܒܐ:ܨܢܕܘܩ ܡܕܒܪܢܐ	Mal:Infoboks person med verv
ܩܠܒܐ:Sortname	Mal:Sorterbart navn
ܩܠܒܐ:Border	Mal:Border
ܩܠܒܐ:ܪܕ	Mal:Fmbox
ܩܠܒܐ:User nl	Mal:Bruker nl
ܩܠܒܐ:ܡܣܦܩ ܩܐܫ	Mal:Oppdater
ܩܠܒܐ:ܨܢܕܘܩ ܐܡܢܐ	Mal:Infoboks kunstner
ܩܠܒܐ:ܡܦܠܚܢܐ	Mal:Bruker
ܣܕܪܐ:ܬܘܢܣ	Kategori:Tunisia
ܩܠܒܐ:Cmbox	Mal:Kmboks
ܩܠܒܐ:Mbox	Mal:Mbox
ܩܠܒܐ:Oppose	Mal:Imot
ܩܠܒܐ:User ar-2	Mal:Bruker ar-2
ܩܠܒܐ:User ar-3	Mal:Bruker ar-3
ܩܠܒܐ:User ar	Mal:Bruker ar
ܩܠܒܐ:ܝܘܡܐ ܕܫܒܘܥܐ	Mal:Ukedager
ܣܕܪܐ:ܡܕܝܢܬܐ ܒܐܘܚܕܢܐ ܡܚܝܕܐ	Kategori:Byer i USA
ܩܠܒܐ:ܬ.ܐ.	Mal:Peker
ܣܕܪܐ:ܩܠܒܐ ܨܢܕܘܩܐ	Kategori:Infobokser
ܩܠܒܐ:ܩܘܕܝܟܘܣ ܕܣܕܪܐ	Mal:KategoriTOC
ܣܕܪܐ:User yue	Kategori:Bruker yue
ܣܕܪܐ:User az	Kategori:Bruker az
ܣܕܪܐ:User sk	Kategori:Bruker sk
ܣܕܪܐ:User fr	Kategori:Bruker fr
ܣܕܪܐ:User ja	Kategori:Bruker ja
ܣܕܪܐ:User la	Kategori:Bruker la
ܣܕܪܐ:User pt	Kategori:Bruker pt
ܣܕܪܐ:User ro	Kategori:Bruker ro
ܣܕܪܐ:User sv	Kategori:Bruker sv
ܣܕܪܐ:User ko-N	Kategori:Bruker ko-N
ܣܕܪܐ:ܗܘܦܪܟܝܣ ܕܥܝܪܐܩ	Kategori:Iraks guvernementer
ܩܠܒܐ:Cat main	Mal:Hovedartikkel
ܣܕܪܐ:User ar	Kategori:Bruker ar
ܣܕܪܐ:User da	Kategori:Bruker da
ܣܕܪܐ:User sk-N	Kategori:Bruker sk-N
ܣܕܪܐ:User de	Kategori:Bruker de
ܣܕܪܐ:User el	Kategori:Bruker el
ܣܕܪܐ:User en-N	Kategori:Bruker en-N
ܣܕܪܐ:User es	Kategori:Bruker es
ܣܕܪܐ:User fa	Kategori:Bruker fa
ܣܕܪܐ:User fi	Kategori:Bruker fi
ܣܕܪܐ:User he	Kategori:Bruker he
ܩܠܒܐ:N/a	Mal:N/a
ܣܕܪܐ:User hy	Kategori:Bruker hy
ܣܕܪܐ:ܠܫܢܐ ܥܒܪܝܐ	Kategori:Hebraisk
ܣܕܪܐ:ܡܕܝܢܬܐ ܒܐܝܣܪܐܝܠ	Kategori:Byer i Israel
ܣܕܪܐ:User it	Kategori:Bruker it
ܣܕܪܐ:User ko	Kategori:Bruker ko
ܣܕܪܐ:ܒܬܫܪܝܢ ܐܚܪܝ	Kategori:Dager i november
ܣܕܪܐ:ܝܡܡܐ	Kategori:Hav
ܩܠܒܐ:ܐܠܦܒܝܬ ܝܘܢܝܐ	Mal:Greske bokstaver
ܣܕܪܐ:ܦܛܪܝܪܟܘ ܕܥܕܬܐ ܣܘܪܝܝܬܐ ܩܬܘܠܝܩܝܬܐ	Kategori:Syrisk-katolske patriarker av Antiokia
ܩܠܒܐ:ܣܡܘܩܐ	Mal:Rød
ܣܕܪܐ:User ru	Kategori:Bruker ru
ܣܕܪܐ:User ru-3	Kategori:Bruker ru-3
ܣܕܪܐ:User tl	Kategori:Bruker tl
ܣܕܪܐ:User tr	Kategori:Bruker tr
ܣܕܪܐ:ܙܡܪܐ	Kategori:Musikere
ܩܠܒܐ:Lang	Mal:Språk
ܣܕܪܐ:ܪܫܘܡܐ	Kategori:Malere
ܣܕܪܐ:ܡܕܝܢܬܐ ܒܐܢܓܠܢܕ	Kategori:Byer i England
ܩܠܒܐ:Cat handler/numbered	Mal:Category handler/numbered
ܣܕܪܐ:ܢܝܓܪ	Kategori:Niger
ܣܕܪܐ:ܣܥܪܐ	Kategori:Hårfrisyrer
ܩܠܒܐ:User ar-4	Mal:Bruker ar-4
ܣܕܪܐ:ܢܗܪܘܬܐ	Kategori:Elver
ܩܠܒܐ:User he-3	Mal:Bruker he-3
ܩܠܒܐ:User ko	Mal:Bruker ko
ܩܠܒܐ:User pt	Mal:Bruker pt
ܣܕܪܐ:User nl	Kategori:Bruker nl
ܣܕܪܐ:User no	Kategori:Bruker no
ܣܕܪܐ:ܣܘܪܝܐ	Kategori:Syria
ܣܕܪܐ:ܕܪܐ ܩܕܡܝܐ	Kategori:0-tallet
ܣܕܪܐ:ܓܙܪܬܐ ܝܒܫܢܝܬܐ	Kategori:Halvøyer
ܣܕܪܐ:ܗܘܦܪܟܝܣ ܕܗܘܠܢܕܐ	Kategori:Nederlands provinser
ܣܕܪܐ:ܡܕܝܢܬܐ ܕܥܝܪܐܩ	Kategori:Byer i Irak
ܣܕܪܐ:ܥܝܢܐ (ܨܪܘܝܘܬܐ)	Kategori:Øyet
ܣܕܪܐ:ܓܘܪܓܝܐ	Kategori:Georgia
ܣܕܪܐ:ܟܘܘܝܬ	Kategori:Kuwait
ܣܕܪܐ:ܠܒܢܢ	Kategori:Libanon
ܣܕܪܐ:ܪܝܫܝ ܩܘܛܢܝܘܬܐ ܕܐܬܪܘܬܐ ܡܚܝܕܐ ܕܐܡܪܝܩܐ	Kategori:USAs presidenter
ܣܕܪܐ:ܝܘܪܕܢܢ	Kategori:Jordan
ܣܕܪܐ:ܦܐܪܐ	Kategori:Frukt
ܣܕܪܐ:ܝܘܠܦܢ ܟܘܪܗܢܐ	Kategori:Patologi
ܣܕܪܐ:ܓܒܐ	Kategori:Politiske partier
ܣܕܪܐ:ܕܝܬܝܩܝ ܚܕܬܐ	Kategori:Det nye testamente
ܣܕܪܐ:ܕܝܬܝܩܝ ܥܬܝܩܬܐ	Kategori:Det gamle testamente
ܣܕܪܐ:ܓܪܡܐ	Kategori:Skjelettet
ܣܕܪܐ:ܗܘܦܪܟܝܣ ܘܐܘܚܕܢܐ ܕܩܢܕܐ	Kategori:Canadas provinser og territorier
ܣܕܪܐ:ܚܝܘܬܐ	Kategori:Dyr
ܣܕܪܐ:ܛܘܪܐ	Kategori:Fjellkjeder
ܣܕܪܐ:ܣܘܥܪܢܐ	Kategori:Historiske hendelser
ܣܕܪܐ:ܟܘܪܗܢܐ	Kategori:Sykdommer
ܣܕܪܐ:User pl	Kategori:Bruker pl
ܣܕܪܐ:ܩܣܪ	Kategori:Keisere
ܣܕܪܐ:ܡܕܒܪܐ	Kategori:Ørkener
ܣܕܪܐ:ܝܡܡܬܐ	Kategori:Innsjøer
ܩܠܒܐ:ܨܢܕܘܩ ܪܡܙܐ ܕܠܫܢܐ	Mal:Infoboks språk
ܣܕܪܐ:ܩܛܠܥܡܐ	Kategori:Massakrer
ܛܪܘܝܐܢܝ	Trojany
ܩܠܒܐ:Sister	Mal:Søster
ܫܩܐ	Legg
ܣܕܪܐ:ܦܛܪܝܪܟܘ ܕܥܕܬܐ ܕܡܕܢܚܐ ܕܐܬܘܪܝܐ	Kategori:Katolikos-patriarker av Østens kirke
ܣܕܪܐ:ܦܛܪܝܪܟܘ	Kategori:Patriarker
ܣܕܪܐ:ܒܝܬ ܟܬܒܐ	Kategori:Biblioteker
ܣܕܪܐ:ܫܢܬܐ ܥܕܬܢܝܬܐ	Kategori:Kirkeåret
ܣܕܪܐ:ܒܝܬ ܢܗܪܝܢ	Kategori:Mesopotamia
ܣܕܪܐ:ܓܘܢܐ	Kategori:Farge
ܣܕܪܐ:ܦܛܪܝܪܟܘ ܕܥܕܬܐ ܣܘܪܝܝܬܐ ܐܪܬܘܕܟܣܝܬܐ	Kategori:Syrisk-ortodokse patriarker av Antiokia
ܩܠܒܐ:ܣܘܪܓܕܐ ܚܘܫܒܢܐ	Mal:Årstall i andre kalendere
ܣܕܪܐ:ܩܕܝܫܐ	Kategori:Helgener
ܩܪܕܐ (ܪܚܫܐ)	Flåtter
ܩܠܒܐ:ܣܝܩܘܡ ܫܘܪܝܐ	Mal:Startdato
ܩܠܒܐ:User nl-4	Mal:Bruker nl-4
ܩܠܒܐ:User nl-3	Mal:Bruker nl-3
ܩܠܒܐ:Tim	Mal:Tim
ܬܪܥܐ:ܐܘܩܝܢܘܣܝܐ	Portal:Oseania
ܢܘܓܗܐ	Demring
ܕܝܠܢܝܐ:ܫܘܚܠܦ̈ܐ ܚܕ̈ܬܐ	Spesial:Siste endringer
