Hĭ-ciŭ	Afrika
Nĭk-buōng	Japan
Nàng Mī-ciŭ	Sør-Amerika
Nò̤-ŭi	Norge
Ĭng-gáik-làng	England
Sŭ-gáik-làng	Skottland
Ŭi-ī-sê̤ṳ	Wales
Báe̤k Ái-ī-làng	Nord-Irland
Ái-ī-làng	Irland
Hungary	Ungarn
Să̤-băng-ngà	Spania
Mī-guók	USA
Bī-lé-sì	Belgia
Luxembourg	Luxembourg
Ṳ̄-dêu	Universet
Dê-giù	Jorden
Sĕng-mêng	Liv
Sī	Død
Nè̤ng	Menneske
Huăng-hī	Lykke
George Washington	George Washington
Wikidata	Wikidata
Hŭng-làng	Finland
Sôi-diēng	Sverige
Dăng-măk	Danmark
Pŏ̤-làng	Polen
Lithuania	Litauen
É-dâi-lé	Italia
Sô̤i-sê̤ṳ	Sveits
Ó̤-dê-lé	Østerrike
Hĭ-lé-nà̤	Hellas
Tū-ī-gì	Tyrkia
Bì-ciū	Øl
Può-dò̤-ngà	Portugal
Ĕu-ciŭ	Europa
Ā-ciŭ	Asia
Báe̤k Mī-ciŭ	Nord-Amerika
Nàng-gĭk-ciŭ	Antarktika
Wikipedia	Wikipedia
Hò̤-làng	Nederland
Ĭng-gĕng	Penis
PHP	PHP
Niū-iók-chê	New York
Washington, D.C.	Washington, D.C.
Gô-gĭng-săng	San Francisco
Báik-lìng	Berlin
Los Angeles	Los Angeles
Diêng-nō̤	Datamaskin
Sŭ-là̤-sié	Zürich
Barack Obama	Barack Obama
Uruguay	Uruguay
MediaWiki	MediaWiki
Lùng-dŭng	London
Bìng-guō	Epleslekten
Bă-là̤	Paris
Mĕ̤k-să̤-gŏ̤	Mexico
Dâi-să̤-iòng	Atlanterhavet
Tái-bìng-iòng	Stillehavet
California	California
Boston	Boston
Lā̤-bái-ék	Mandag
Huōi-sĭng	Mars (planet)
Kenya	Kenya
Ethiopia	Etiopia
Gŭng-ciō (nguòng-siū)	Monark
Ghana	Ghana
Lā̤-bái-nê	Tirsdag
Lā̤-bái-săng	Onsdag
Lā̤-bái-sé	Torsdag
Lā̤-bái-ngô	Fredag
Lā̤-bái-lĕ̤k	Lørdag
Lā̤-bái-nĭk	Søndag
Săi (mà-kuŏ dông-ŭk)	Løve
Huák-guók	Frankrike
Kēng	Tamhund
Ĭng-guók	Storbritannia
Mà	Tamkatt
Dṳ̆ng-huà Ìng-mìng Gê̤ṳng-huò-guók	Folkerepublikken Kina
Huák-ngṳ̄	Fransk
Wiktionary	Wiktionary
Ngṳ̀	Fisk
Ciū	Alkoholholdig drikke
Bă-să̤	Brasil
Ngò̤-lò̤-sṳ̆	Russland
Hāi	Hav
Alabama	Alabama
Wikimedia	Wikimedia Foundation
Jimmy Wales	Jimmy Wales
Dáik-guók	Tyskland
Belarus	Hviterussland
Dáik-ngṳ̄	Tysk
Bĭng-dō̤	Island
Estonia	Estland
Tū-sĭng	Saturn
Hĭ-gĭ	Fly
Ciéng-cĕng	Krig
1	1 (tall)
2	2 (tall)
3	3 (tall)
4	4 (tall)
5	5 (tall)
0	Null
George W. Bush	George W. Bush
Latvia	Latvia
Ukraine	Ukraina
Ciék-káik	Tsjekkia
Slovakia	Slovakia
Slovenia	Slovenia
Moldova	Moldova
Romania	Romania
Bulgaria	Bulgaria
Lò̤-mā	Roma
Macedonia Gê̤ṳng-huò-guók	Republikken Makedonia
Albania	Albania
Croatia	Kroatia
Bosnia gâe̤ng Herzegovina	Bosnia-Hercegovina
Azerbaijan	Aserbajdsjan
Andorra	Andorra
Cyprus	Republikken Kypros
Georgia (guók-gă)	Georgia
Kazakhstan	Kasakhstan
Malta	Malta
Monaco	Monaco
Montenegro	Montenegro
Vaticano	Vatikanstaten
San Marino	San Marino
Gū-bă	Cuba
Belize	Belize
Barbados	Barbados
Java	Java (programmeringsspråk)
Éng-dô-nà̤-să̤-ā	Indonesia
Tū-ī-gì-ngṳ̄	Tyrkisk
Nàng-hĭ	Sør-Afrika
Algeria	Algerie
Wiki Dù-cṳ̆-guāng	Wikikilden
Uzbekistan	Usbekistan
Huà-să	Warszawa
Può-dò̤-ciū	Vin
Cūi	Vann
Chà	Treverk
Diêng-sê	Fjernsyn
Chile	Chile
Ià-sŭ	Jesus Kristus
Galileo Galilei	Galileo Galilei
Cūi-sĭng	Merkur
Lĭk-sṳ̄	Historie
Gĭng-sĭng	Venus
Ngṳ̄-ngiòng	Språk
Ái	Kjærlighet
Mŭk-sĭng	Jupiter
Ngṳ̀ng-ò̤	Melkeveien
Tiĕng-uòng-sĭng	Uranus
Hāi-uòng-sĭng	Neptun (planet)
Tiĕng-ùng	Astronomi
Sĭng-gă-pŏ̤	Singapore
Kuŏ-hŏk	Vitenskap
Mìng-uòng-sĭng	Pluto
Ciŏng-lài	Fremtid
Séng-mū Mā-lé-ā	Jomfru Maria
Liechtenstein	Liechtenstein
Adolf Hitler	Adolf Hitler
Dâ̤-nê-ché̤ṳ Sié-gái Dâi-ciéng	Andre verdenskrig
Wiki Gáu-kuŏ-cṳ̆	Wikibøker
Wiki Ngṳ̄-liŏh	Wikiquote
Wiki Dâi-hŏk	Wikiversity
Cṳ̆ng	Klokke (ur)
Ubuntu	Ubuntu (operativsystem)
Só-hŏk	Matematikk
Lá-dĭng-ngṳ̄	Latin
Bahrain	Bahrain
Armenia	Armenia
Serbia	Serbia
Nguŏk-giù	Månen
Istanbul	Istanbul
Ó̤-ciŭ	Australia
Ŭk-lī	Fysikk
Argentina	Argentina
Peru	Peru
Dièu-siēng Mìng-ciō-ciō-ngiê Ìng-mìng Gê̤ṳng-huò-guók	Nord-Korea
Gāng-puŏ-câi	Kambodsja
Gū-làng-gĭng	Koranen
Kṳ̄ng-lṳ̀ng	Dinosaurer
Ĭ-sṳ̆-làng-gáu	Islam
Lùng-lùng	Hjul
Huò-bìng	Fred
Nṳ̄-gái	Kvinne
Gū-chiŏng-kĕ̤ng	Anus
Nìng-mùng	Sitron
Bă-ciĕu	Bananer
Huă	Blomst
Napoléon Bonaparte	Napoléon Bonaparte
Sĕng-lī	Fysiologi
Hèng-sĭng	Stjerne
Nĭk-tàu	Solen
Victor Hugo	Victor Hugo
Dâi-iòng-ciŭ	Oseania
Tái-iòng-hiê	Solsystemet
Ngāi	Tann
Kĭng	Hydrogen
Wiki Gê̤ṳng-hiōng	Wikimedia Commons
Cṳ̆	Bok
Nĭk	Dag
Dĕ̤ng Timor	Øst-Timor
Màng-buŏ	Natt
Nièng	År
Ó̤-sṳ̆-lṳ̆k	Oslo
Lī-sṳ̆-buōng	Lisboa
Táng	Karbon
Dâng	Nitrogen
Iōng	Oksygen
Giàng-sĭng	Planet
Kleopatra 7-sié	Kleopatra VII av Egypt
Ĭng-ngŏk	Musikk
É-dâi-lé-ngṳ̄	Italiensk
Séng Peterburg	St. Petersburg
Chad	Tsjad
Lé̤ṳ	Aluminium
Sĭng-să̤-làng	New Zealand
Éng-dô	India
Tuvalu	Tuvalu
Tiék	Jern
Tonga	Tonga
Samoa	Samoa
Solomon Gùng-dō̤	Salomonøyene
Vanuatu	Vanuatu
Papua New Guinea	Papua Ny-Guinea
William Shakespeare	William Shakespeare
Palau	Palau
Nauru	Nauru
Micronesia Lièng-băng	Mikronesiaføderasjonen
Iòng (gĭng-sṳ̆k)	Bly
Marshall Gùng-dō̤	Marshalløyene
Kiribati	Kiribati
Mūng-gū	Mongolia
Fiji	Fiji
Venezuela	Venezuela
Guók-cié chiông-gì	Sjakk
Genghis Khan	Djengis Khan
Maine	Maine
Mā	Hest
Ū-ké	Våpen
Dông-ŭk	Dyr
Suriname	Surinam
Paraguay	Paraguay
Guyana	Guyana
Ecuador	Ecuador
Colombia	Colombia
Hŭk-gáu	Buddhisme
Bolivia	Bolivia
Dè̤ng	Kobber
Trinidad gâe̤ng Tobago	Trinidad og Tobago
Sĭk-ŭk	Planter
Séng Vincent gâe̤ng Grenadines	Saint Vincent og Grenadinene
New Hampshire	New Hampshire
Séng Lucia	Saint Lucia
Séng Kitts gâe̤ng Nevis	Saint Kitts og Nevis
Cĭng-kṳ̄ng	Sopper
Jamaica	Jamaica
Grenada	Grenada
Massachusetts	Massachusetts
Guatemala	Guatemala
Bahamas	Bahamas
Connecticut	Connecticut
Giĕ	Tamhøns
Antigua gâe̤ng Barbuda	Antigua og Barbuda
Hawaii	Hawaii
Honduras	Honduras
Dominica	Dominica
Dominica Gê̤ṳng-huò-guók	Den dominikanske republikk
Dṳ̆	Gris
Báe̤k-bĭng-iòng	Nordishavet
Haiti	Haiti
El Salvador	El Salvador
Ĭ-lāng	Iran
Iraq	Irak
Alaska	Alaska
Costa Rica	Costa Rica
Ī-sáik-liĕk	Israel
Panama	Panama
Yemen	Jemen
Bâng-dŭk	Virus
Pŏ̤-làng-ngṳ̄	Polsk
Jordan	Jordan
Nicaragua	Nicaragua
Florida	Florida
Kyrgyzstan	Kirgisistan
Arizona	Arizona
Kuwait	Kuwait
Lō̤-kuŏ	Laos
Lebanon	Libanon
Oregon	Oregon
Maldives	Maldivene
Mī-ciŭ	Amerika
Utah	Utah
Ngù	Storfe
Mā-lài-să̤-ā	Malaysia
Miēng-diêng	Myanmar
Nepal	Nepal
Oman	Oman
Pakistan	Pakistan
Qatar	Qatar
Saudi Ā-lá-báik	Saudi-Arabia
Sri Lanka	Sri Lanka
Joseph Stalin	Josef Stalin
Syria	Syria
Platon	Platon
Tajikistan	Tadsjikistan
Dṳ̆ng-huà Mìng-guók	Republikken Kina
Aristoteles	Aristoteles
Tái-guók	Thailand
Huōi-chiă	Jernbanetog
Turkmenistan	Turkmenistan
Ā-lá-báik Lièng-hăk Dâi-gŭng-guók	De forente arabiske emirater
Băh-gĭng	Platina
Uŏk-nàng	Vietnam
Dâi-hàng Mìng-guók	Sør-Korea
Afghanistan	Afghanistan
Gĭng	Gull
Suez Ông-ò̤	Suezkanalen
Bangladesh	Bangladesh
Mali	Mali
Sokrates	Sokrates
Angola	Angola
Bhutan	Bhutan
Ùng-lài	Brunei
Tanzania	Tanzania
Cūi-ngṳ̀ng	Kvikksølv
Hĭ-lĭ-pĭng	Filippinene
Dṳ̆ng-hĭ Gê̤ṳng-huò-guók	Den sentralafrikanske republikk
Isaac Newton	Isaac Newton
Albert Einstein	Albert Einstein
Uòng-sáik	Gul
Togo	Togo
Tunisia	Tunisia
Zambia	Zambia
Zimbabwe	Zimbabwe
Báe̤k-gĭng	Beijing
Nàng Sudan	Sør-Sudan
Benin	Benin
Botswana	Botswana
Wiki Sĭng-ùng	Wikinytt
Burkina Faso	Burkina Faso
Burundi	Burundi
Comoros	Komorene
Congo Gê̤ṳng-huò-guók	Republikken Kongo
Congo Mìng-ciō Gê̤ṳng-huò-guók	Den demokratiske republikken Kongo
Djibouti	Djibouti
Chiáh-dô̤ Guinea	Ekvatorial-Guinea
Eritrea	Eritrea
Gabon	Gabon
Gambia	Gambia
Guinea	Guinea
Guinea-Bissau	Guinea-Bissau
Côte d'Ivoire	Elfenbenskysten
Cameroon	Kamerun
Cabo Verde	Kapp Verde
Lesotho	Lesotho
Liberia	Liberia
Libya	Libya
Madagascar	Madagaskar
Malawi	Malawi
Mauritania	Mauritania
Mauritius	Mauritius
Morocco	Marokko
Mozambique	Mosambik
Namibia	Namibia
Niger	Niger
Nigeria	Nigeria
Charles Darwin	Charles Darwin
Uganda	Uganda
Rwanda	Rwanda
Séng Tomé gâe̤ng Príncipe	São Tomé og Príncipe
Senegal	Senegal
Seychelles	Seychellene
Carl Linnaeus	Carl von Linné
Sierra Leone	Sierra Leone
Somalia	Somalia
Julius Caesar	Julius Cæsar
Sudan	Sudan
Swaziland	Swaziland
Kê̤ṳng	Regnbue
Lièng-hăk-guók	De forente nasjoner
Dê-cék	Geologi
Dê-lī	Geografi
Sĭng-câung	Hjerte
Puòi-hŭ	Hud
Ngàng-sáik	Farge
Làng-sáik	Blå
Ngṳ̀ng	Sølv
Sék	Tinn (grunnstoff)
Michigan	Michigan
Illinois	Illinois
North Dakota	Nord-Dakota
South Dakota	Sør-Dakota
Montana	Montana
Wyoming	Wyoming
Idaho	Idaho
Washington	Washington
Nevada	Nevada
Éng-dô-iòng	Indiahavet
Kosovo	Kosovo
Colorado	Colorado
分類:Hŭng-lôi	Kategori:Kategorier
Chicago	Chicago
Dĕ̤ng-tiĕng	Vinter
Chŭng-tiĕng	Vår
Hâ-tiĕng	Sommer
Chiŭ-tiĕng	Høst
Saddam Hussein	Saddam Hussein
Osama bin Laden	Osama bin Laden
Să̤-băng-ngà-ngṳ̄	Spansk
Philadelphia	Philadelphia
Tĭ-tṳ̆	Edderkopper
Guō-sĭk	Frukt
Gàu	Apekatter
Cièng	Penger
Virginia	Virginia
West Virginia	Vest-Virginia
Huăng-ciĕu	Paprika
Niū-iók-ciŭ	New York (delstat)
Rhode Island	Rhode Island
Kŏng-tṳ̀ng	Insekter
Maryland	Maryland
Delaware	Delaware
Vladimir Lenin	Vladimir Lenin
Ohio	Ohio
Pennsylvania	Pennsylvania
Augustus	Augustus
Microsoft Windows	Microsoft Windows
New Jersey	New Jersey
Hŭng-làng-ngṳ̄	Finsk
Indiana	Indiana
Ké-chiă	Bil
Georgia	Georgia (USA)
Texas	Texas
North Carolina	Nord-Carolina
South Carolina	Sør-Carolina
Manila	Manila
Dĕ̤ng-gĭng	Tokyo
Mississippi	Mississippi
Tennessee	Tennessee
New Mexico	New Mexico
Ngà-diēng	Athen
Minnesota	Minnesota
Baghdad	Bagdad
Wisconsin	Wisconsin
Iowa	Iowa
Nebraska	Nebraska
Kansas	Kansas
Hŏng-giāng	Sigarett
Missouri	Missouri
Louisiana	Louisiana
Kentucky	Kentucky
Arkansas	Arkansas
Oklahoma	Oklahoma
Madonna	Madonna (artist)
Aceh	Aceh
Séng-gĭng	Bibelen
Phnom Penh	Phnom Penh
Hù Cé-mìng Chê	Ho Chi Minh-byen
Ò̤-nô̤i	Hanoi
Ĭng-ngṳ̄	Engelsk
Màng-gók	Bangkok
Kuala Lumpur	Kuala Lumpur
Bangka Belitung Gùng-dō̤	Bangka-Belitung
Dài-báe̤k	Taipei
Concepción	Concepción
Bengkulu	Bengkulu
Końskowola	Końskowola
Nê-iōng-huá-táng	Karbondioksid
Jambi	Jambi
Siè	Slanger
Lampung	Lampung
Guŏng-sók	Lysets hastighet
Riau	Riau
Riau Gùng-dō̤	Kepulauan Riau
Nàng Sumatra	Sumatera Selatan
Lò̤-mā Dá̤-guók	Det romerske keiserriket
Mì-niōng	Microsoft
Kó-lū-hŭ	Kurów
Huá-hŏk	Kjemi
Sièng-sŏng	Saltsyre
Ôi-sĭng	Naturlig satellitt
Kă-giù	Fotball
Să̤ Sumatra	Sumatera Barat
Mā-dáik-lī	Madrid
Michael Jackson	Michael Jackson
Cê̤ṳ-iù	Frihet
Cṳ̆-niòng-giāng	Jente
Sék-nà̤	Sydney
Liŏh-sáik	Grønn
È̤ng-sáik	Rød
Huōi	Ild
Sĭng Nàng Wales	New South Wales
Nile Ò̤	Nilen
Banten	Banten
Dṳ̆ng Jawa	Jawa Tengah
Chēng-chiū-sĭng	Komet
Dĕ̤ng Jawa	Jawa Timur
Jakarta	Jakarta
Ăng-kā-lá	Ankara
Să̤ Jawa	Jawa Barat
Nàng Kalimantan	Kalimantan Selatan
Hŏk-hâu	Skole
Dâi-hŏk	Universitet
Wikipedia:Să-buàng	Wikipedia:Sandkasse
Chió	Hus
Dê-dù	Kart
Ò̤	Elv
Osasco	Osasco
Chiĕng-lī-giáng	Teleskop
分類:Dài-uăng lĭk-sṳ̄	Kategori:Taiwans historie
Curitiba	Curitiba
Sĕng-lìng	Skog
分類:Uŏk-nàng lĭk-sṳ̄	Kategori:Vietnams historie
Iók-báik-cṳ̆	Jobs bok
Cĭng-ngiòng	Salomos ordspråk
Kūng-cṳ̄	Konfucius
Hà	Tifotkreps
分類:Só-hŏk	Kategori:Matematikk
Bali	Bali
Ĕu-nguòng	Euro
Mī-gĭng	Amerikansk dollar
Dâi-lièu	Liao-dynastiet
Hòng-ciŭ	Hangzhou
Gĭ-dók-gáu	Kristendom
Gĭng-guók	Jin-dynastiet (1115–1234)
Seattle	Seattle
Dêu	Ris
Să̤ Papua	Papua Barat
Cēu	Fugler
Siū-dŭ	Hovedstad
Può-dò̤-ngà-ngṳ̄	Portugisisk
Nguŏk	Måned
Uòng Hiêng-huàng	Huang Xian-fan
Cōng	Diamant
Nĭk-buōng-ngṳ̄	Japansk
Báik-kuŏ-ciòng-cṳ̆	Encyklopedi
Tàu Hiĕk	Portal:Forside
模板:Ô-lī-kó̤	Mal:Anbefalt
Saratov	Saratov
Làng-giù	Basketball
Olympic Ông-dông-huôi	Olympiske leker
Diòng-gĕ̤ng	Chang Jiang
Che Guevara	Che Guevara
Mò̤ Dĕk-dŭng	Mao Zedong
Să̤-ăng	Xi'an
Lá-sák	Lhasa
Séng-gău	Samleie
Ĭng-dô̤	Vagina
Diék-hŏk	Filosofi
分類:Ché̤ṳk-káik chēng-dṳ̀	Kategori:Sider som er foreslått raskt slettet
Gáung-kìng	Piano
Dà	Te
Marco Polo	Marco Polo
Hebe Camargo	Hebe Camargo
Gê̤ṳng-sāng-ciō-ngiê	Kommunisme
Cṳ̆-buōng-ciō-ngiê	Kapitalisme
Mìng-cŭk	Nasjon
Carthago	Karthago
Uōng-hiĕk liù-lāng-ké	Nettleser
Siù-cūi	Svømming
分類:Tiĕng-ùng	Kategori:Astronomi
Lī Bĕk	Li Bai
Dù-cṳ̆-guāng	Bibliotek
Sĕng-tái	Økologi
Céng-dê	Politikk
Mìng-ciō	Demokrati
Cìng-dièu	Qin-dynastiet
Nobel Ciōng	Nobelprisen
Cìng Sṳ̄-huòng	Qin Shi Huangdi
Dṳ̆ng-dĕ̤ng	Midtøsten
Háng-dièu	Han-dynastiet
Làu Băng	Han Gaozu
Háng Ùng-dá̤	Han Wendi
Háng Gīng-dá̤	Han Jingdi
Háng Ū-dá̤	Keiser Wu av Han
Sĕng-ŭk	Organisme
Rabindranath Tagore	Rabindranath Tagore
Háng Guŏng-ū-dá̤	Han Guangwudi
Gŭng-ciō-cié-dô	Monarki
Siâ-huôi-ciō-ngiê	Sosialisme
Cṳ̆ng-chói	Kyss
Nguòng-dièu	Yuan-dynastiet
Háng Hióng-dá̤	Han Xiandi
Nazi Dáik-guók	Tysklands historie (1933–1945)
Christopher Columbus	Christofer Columbus
Dâng Huò	Zheng He
Panama Ông-ò̤	Panamakanalen
Céng-dièu	Jin-dynastiet (265–420)
Nàng-bĭng-iòng	Sørishavet
Uòng-ò̤	Den gule flod
Sṳ̆-mā Ièng	Sima Yan
Ngê	Øre
Pé	Nese
Mĕ̤k-ciŭ	Øye
Hŭng-muòng	Stikkemygg
Săi-ngṳ̀	Haier
Lŏk-dò̤	Kameler
Chiông	Elefanter
Mā-ngiê	Maur
Sùi-dièu	Sui-dynastiet
Hò̤-làng-ngṳ̄	Nederlandsk
Sùi Ùng-dá̤	Keiser Wen av Sui
Sùi Iòng-dá̤	Keiser Yang av Sui
Să̤-hâ	Xixia-riket
Sóng-dièu	Song-dynastiet
Diêu Kuŏng-êng	Keiser Taizu av Song
Sóng Tái-cŭng	Keiser Taizong av Song
Sóng Cĭng-cŭng	Keiser Zhenzong av Song
Sóng Ìng-cŭng	Keiser Renzong av Song
Sóng Sìng-cŭng	Keiser Shenzong av Song
Sóng Hŭi-cŭng	Keiser Huizong av Song
Sóng Gŏ̤-cŭng	Keiser Gaozong av Song
Sóng Lī-cŭng	Keiser Lizong av Song
Sóng Duăng-cŭng	Keiser Duanzong av Song
Ögedei	Ögedei Khan
Güyük	Güyük Khan
Möngke	Möngke Khan
Kublai	Kublai-khan
Huă-chái	Blomkål
Giò (sĭk-ŭk)	Aubergine
Siók	Snø
Niè-giāng	Barn
Cā-tàu	Morgen
Hŭng-cṳ̆ng	Minutt
Ngò̤-lò̤-sṳ̆-ngṳ̄	Russisk
Hièng-huák	Konstitusjon
Háng-ngṳ̄	Kinesisk
Sá̤-bàu	Celle
Háik	Blod
Hié (ké-guăng)	Lunge
Romania-ngṳ̄	Rumensk
Bulgaria-ngṳ̄	Bulgarsk
Ṳ̄	Regn
Dê-cīng	Jordskjelv
Cūi-căi	Flom
Hāi-lâung	Tsunami
Hùng	Sky
Hŭng-tăi	Tropisk syklon
Hŭng	Vind
Georgia-ngṳ̄	Georgisk
Háng-cê	Kinesiske tegn
Dièu-siēng-cê	Hangul
Lá-dĭng cê-mō̤	Det latinske alfabetet
Ùng-hŏk	Litteratur
分類:Ĭng-ngŏk	Kategori:Musikk
分類:Ùng-hŏk	Kategori:Litteratur
È̤ng-làu-máe̤ng	Drømmen om det røde kammeret
Harry Potter	Harry Potter
Chiū-ìng	Onani
Siâ-huôi	Samfunn
Gáu-ṳ̆k	Utdannelse
Nàng-gái	Mann
Ìng-guòng	Menneskerettigheter
Temür	Chengzong-keiseren
Gŭng-sê̤ṳ	Militærvesen
Gă-pĭ	Kaffe
Săng	Fjell
Khayisan	Külüg Khan
Ayurbarwada	Buyantu Khan
Sŏng Dṳ̆ng-săng	Sun Yat-sen
Hiŏng-gē̤ng	Hongkong
Miami	Miami
Hàng Ciéng	Koreakrigen
Toghon Temür	Ukhaantu Khan, keiser Huizong av Yuan
Siū-ék	Seoul
Siông-hāi	Shanghai
Ùng-huá Dâi-gáik-mêng	Kulturrevolusjonen
Chĭng-dièu	Qing-dynastiet
Uŏk-nàng Ciéng-cĕng	Vietnamkrigen
Thomas Edison	Thomas Edison
Armenia-ngṳ̄	Armensk
Ukraine-ngṳ̄	Ukrainsk
HTML	HTML
Steven Spielberg	Steven Spielberg
Mŏ̤h-ngiòng	Mo Yan
Sôi-diēng-ngṳ̄	Svensk
Dăng-măk-ngṳ̄	Dansk
Nò̤-ŭi-ngṳ̄	Norsk
Luxembourg-ngṳ̄	Luxembourgsk
Ciék-káik-ngṳ̄	Tsjekkisk
Karl Marx	Karl Marx
Nĕng-nĕng	Bryst
Guŏng	Lys
Hĭ-lé-nà̤-ngṳ̄	Gresk
Ái-ī-làng-ngṳ̄	Irsk
Kié-ngò̤	Pingviner
Pŏ̤-sṳ̆-ngṳ̄	Persisk
Cŭng-gáu	Religion
Hàng-guók-ngṳ̄	Koreansk
Cháung-sié-gé	Første Mosebok
Chók-Ăi-gĭk-gé	Andre Mosebok
Háng-ngṳ̄ Guăng-uâ	Mandarin (språk)
Uŏk-nàng-ngṳ̄	Vietnamesisk
Sigmund Freud	Sigmund Freud
Tái-guók-ngṳ̄	Thai
Mā-lài-ngṳ̄	Malayisk
Mūng-gū-ngṳ̄	Mongolsk
Bandar Seri Begawan	Bandar Seri Begawan
Hĭ-báik-lài-ngṳ̄	Hebraisk
Ŭi-ī-sê̤ṳ-ngṳ̄	Walisisk
Sŭ-gáik-làng-ngṳ̄	Skotsk-gælisk
Vientiane	Vientiane
Lō̤-cṳ̄	Laozi
Găng-câung	Lever
Sṳ̆-mā Chiĕng	Sima Qian
Ciŏ Hĭ	Zhu Xi
Cìng-gāng	Følelser
Dâi-iòng	Verdenshav
Victoria Nṳ̄-uòng	Victoria av Storbritannia
Sék-giă-mèu-nà̤	Buddha
Mŭk-hâng-mĕk-dáik	Muhammed
Hŭ-ngék	Respirasjon
Ṳ̀-gă	Konfucianisme
Bók-lō̤	Abdomen
Dô̤-gáu	Taoisme
Chói-siĕk	Tunge
Dâiu-gáuk	Hals
Chói	Munn
Elizabeth 2-sié	Elisabeth II av Storbritannia
Dòng-dièu	Tang-dynastiet
Dòng Gŏ̤-cū	Keiser Gaozu av Tang
Dòng Tái-cŭng	Keiser Taizong av Tang
Dòng Gŏ̤-cŭng	Keiser Gaozong av Tang
Dòng Dṳ̆ng-cŭng	Keiser Zhongzong av Tang
Dòng Iô-cŭng	Keiser Ruizong av Tang
Ū Cáik-tiĕng	Keiserinne Wu Zetian
Dòng Hièng-cŭng	Keiser Xuanzong av Tang
Dòng Sé̤ṳk-cŭng	Keiser Suzong av Tang
Dòng Dâi-cŭng	Keiser Daizong av Tang
Dòng Dáik-cŭng	Keiser Dezong av Tang
Cê-mō̤	Bokstav
Siēu-hŏk	Grunnskole
Mìng-dièu	Ming-dynastiet
Ciŏ Nguòng-ciŏng	Hongwu-keiseren
Ronald Reagan	Ronald Reagan
Gióng-ùng Huòng-dá̤	Jianwen-keiseren
Īng-lŏk Huòng-dá̤	Yongle-keiseren
Hùng-hĭ Huòng-dá̤	Hongxi-keiseren
Sŏng-dáik Huòng-dá̤	Xuande-keiseren
Mìng Ĭng-cŭng	Zhengtong-keiseren
Gīng-tái Huòng-dá̤	Jingtai-keiseren
Sìng-huá Huòng-dá̤	Chenghua-keiseren
Hùng-dé Huòng-dá̤	Hongzhi-keiseren
Céng-dáik Huòng-dá̤	Zhengde-keiseren
Gă-cêng Huòng-dá̤	Jiajing-keiseren
Lè̤ng-kéng Huòng-dá̤	Longqing-keiseren
Uâng-lĭk Huòng-dá̤	Wanli-keiseren
Tái-chiŏng Huòng-dá̤	Taichang-keiseren
Tiĕng-kiē Huòng-dá̤	Tianqi-keiseren
Sùng-dĭng Huòng-dá̤	Chongzhen-keiseren
Gĭng Céng-nĭk	Kim Jong-il
Nguòng-só ciŭ-gĭ-biēu	Periodesystemet
Chăng-màng	Blindhet
Sá̤-kṳ̄ng	Bakterier
Chéu	Tre
Può-dò̤	Druer
Huăng-giāng-sṳ̀	Potet
Tòng	Sukker
Uòng-dâu	Soyabønne
Séng-sék	Informasjon
Bó̤-cāi	Avis
Diêng-uâ	Telefon
Ùng-huá	Kultur
Huáng-ngṳ̄	Sanskrit
Dâi-diòng	Tykktarm
Siēu-diòng	Tynntarm
Ĭ-hŏk	Medisin
Huá-hŏk nguòng-só	Grunnstoff
Unix	Unix
Ùi-gì	Go
Káh-dièu-nó̤h	Leketøy
Diêng-īng	Film
Gĭng-sṳ̆k	Metall
Kă-dăk-chiă	Sykkel
Mièng-huă	Bomull
Sók-dô	Hastighet
Sì-găng	Tid
Cāi	Papir
Só-lâiu	Plast
Miêng-cék	Areal
Gŭng-chióh	Meter
Iù-diĕng-bău	Mais
Duâi-măk	Bygg (korn)
Dĕ̤ng-nàng-ā	Sørøst-Asia
Sīng-iòng	Shenyang
Tṳ̀ng-kéng	Chongqing
Tiĕng-cĭng	Tianjin
Ū-háng	Wuhan
Gū Ăi-gĭk	Oldtidens Egypt
Gū Hĭ-lé-nà̤	Antikkens Hellas
Hṳ̀ng	Bjørnefamilien
Britney Spears	Britney Spears
Ngàng	Kreft
Măk	Hveteslekten
Cié-sē̤	Durra
Pó̤-sióng	Funksjonshemning
Lĭk-huák	Kalender
Sìng-gĭng-bâng	Psykisk lidelse
Gregorius Lĭk-huák	Gregoriansk kalender
Tutankhamun	Tutankhamon
Nguŏk-gĭng	Menstruasjon
Mà-chiók	Mahjong
Ông-ò̤	Kanal (farvann)
Detroit	Detroit
Diòng-siàng	Den kinesiske mur
Gĭng-cê-ták	Pyramide (byggverk)
Osman Dá̤-guók	Det osmanske rike
Guók-nô̤i sĕng-sāng cūng-dĭk	Bruttonasjonalprodukt
Diêng	Elektrisitet
Ché̤ṳng	Skytevåpen
Lòng-gĭ-ché̤ṳng	Maskingevær
Sáung-buàng	Abakus (kuleramme)
Tāng-káik	Stridsvogn
Chāu-muòi	Hagejordbær
Liĕk-chiĕ	Litchi
Ià-cī	Kokospalme
Tò̤	Fersken
Cáung-ngṳ̄	Zhuang (språk)
Siŏng-ngṳ̄	Xiang
Mì-ngù-ī-ngṳ̄	Uigurisk
Lâung-gŏ̤	Kake
Wiki Ŭk-cṳ̄ng	Wikispecies
Nĕng-dáe̤k	Brystholder
Ā-lá-báik-ngṳ̄	Arabisk
Cūng-lī	Premierminister
Dièu-siēng Tái-cŭng	Taejong av Joseon
Lù Ū-hièng	Roh Moo-hyun
Páuk Céng-hĭ	Park Chung-hee
Siĕng-ìng-ciōng	Kaktusfamilien
Siŏh-tàu-lâung	Rullestein
Iòng-bék	Blyant
Gă-sĭ	Møbel
Dó̤h	Bord (møbel)
Ó̤-muòng	Macao
Iē-giāng	Stol
Hù Gīng-dò̤	Hu Jintao
Sĭk Gê̤ṳng-bìng	Xi Jinping
Dòng-gêng-lĕ̤k	Sjiraff
Chĭng-dáung	Shenzhen
Guōng-dĕ̤ng	Guangdong
Guōng-să̤	Guangxi
Sŭ-lièng	Sovjetunionen
Kiák-sióng-gĭ	Kamera
Kagoshima-gâing	Kagoshima (prefektur)
C ngṳ̄-ngiòng	C (programmeringsspråk)
Kă	Fot (kroppsdel)
Ciēng	Egentlige gekkoer
Dô-dâing	Øgle
Giĕng-tàu	Skulder
Wikipedia:Bō̤-ciéng hō̤ ùng	Wikipedia:Utmerkede artikler
Wikipedia:Duâi chéu â	Wikipedia:Tinget
Busan	Busan
Lèng-huă	Lotusrot
Vermont	Vermont
Denver	Denver
Guōng-ciŭ	Guangzhou
Ciōng Gái-sĭk	Chiang Kai-shek
Gŏng Dĕk-mìng	Jiang Zemin
Ŭng Gă-bō̤	Wen Jiabao
Nàng-gĭng	Nanjing
Làu Dáik-huà	Andy Lau
Diŏng Hŏk-iū	Jacky Cheung
Báe̤k-gĭng Dâi-hŏk	Pekinguniversitetet
Chĭng-huà Dâi-hŏk	Tsinghuauniversitetet
Ŭ-lū-mŭk-cà̤	Ürümqi
Gŏng-sŭ	Jiangsu
Ciék-gŏng	Zhejiang
Dâing Siēu-bìng	Deng Xiaoping
Lò̤-mā Gê̤ṳng-huò-guók	Den romerske republikk
Câung-kṳ̆	Tibet
Să̤-câung	Den autonome region Tibet
Ciŭ Ŏng-lài	Zhou Enlai
Dṳ̆ng-guók Gê̤ṳng-sāng-dōng	Det kinesiske kommunistiske parti
Chiū-gĭ	Mobiltelefon
Dò̤-nēu	Struts
Kŏng-hĭ Huòng-dá̤	Kangxi-keiseren
Dièu-siēng	Korea
Lī Káik-giòng	Li Keqiang
Gŏ̤ Hèng-giông	Gao Xingjian
Ciŏ Ṳ̀ng-gĭ	Zhu Rongji
Lī Bèng	Li Peng
Lòng	Ulv
Bìng-iōng	Pyongyang
Sĭng-iók Séng-gĭng	Det nye testamente
9	9 (tall)
Kiék	Skorpioner
Gièng-lè̤ng Huòng-dá̤	Qianlong-keiseren
Dṳ̆ng-guók Dâi-lṳ̆k	Fastlandskina
Háik-lṳ̀ng-gĕ̤ng-sēng	Heilongjiang
Mā Ĭng-gāu	Ma Ying-jeou
Lè̤	Afrikansk villesel
Wikipedia:Cék-liông ô-lī-kó̤ gì ùng-ciŏng	Wikipedia:Anbefalte artikler
Sé-chiŏng	Sichuan
Gô-iók Séng-gĭng	Det gamle testamente
Séng-dáng-cáik	Jul
Săng-gáe̤k-hìng	Trekant
Muammar Gaddafi	Muammar al-Gaddafi
Lâu-hū	Tiger
Daejeon	Daejeon
Daegu	Daegu
Sié-cŭng Dĕk-biék Cê̤ṳ-dé-chê	Sejong by
Incheon	Incheon
Gyeonggi Dô̤	Gyeonggi
Bô-uăk-cáik	Påske
Ò̤-báe̤k	Hebei
Bŏk Hĭ-lài	Bo Xilai
GNU Cê̤ṳ-iù Ùng-dáung Hṳ̄-kō̤-céng	GNU fri dokumentasjonslisens
Uŏng Cĭng-ôi	Wang Jingwei
Dìng Cūi-biēng	Chen Shui-bian
Dài-uăng	Taiwan
À̤	Sko
Ngṳ̀ng-hòng	Bank
Lū Séng	Lu Xun
7	7 (tall)
8	8 (tall)
Lĕ̤k	Hjortedyr
Hù	Innsjø
Sáung-tàu	Hvitløk
Chái-guă	Agurk
Dō̤	Øy
Băh-sáik	Hvit
Ŭ-sáik	Svart
6	6 (tall)
Moshchena	Mosjtsjena
Huăng-kê	Tomat
George H. W. Bush	George H.W. Bush
Quảng Bình	Quang Binh (provins)
Atlanta	Atlanta
Benito Mussolini	Benito Mussolini
Sṳ̀-diēng	Ordbok
Tàu	Hode
Hiê-lìng-dóng	Wellington
Dâi Bók-liĕk-diĕng Dō̤	Storbritannia (øy)
Las Vegas	Las Vegas
10	10 (tall)
Alfred Nobel	Alfred Nobel
Tàu-sĕ̤	Kam
Guòng-lĭk	Makt
Mà-hùng-cēu	Ugler
Dēng-cṳ̆ng	Time (tidsenhet)
Ké-chiông	Meteorologi
Đà Nẵng	Da Nang
Káh-chiók	Skjære
Làng-huă	Orkidéfamilien
Gă-săk	Kakerlakker
Ngáuk-ngṳ̀	Krokodiller
Lā-lì	Skjelldyr
Nàng-muōi-sĭng	Lysbiller
Holocene	Holocen
Hāi-báu	Selfamilien
Bà̤-bá-cēu	Gjerdesmett
Ciáh-giāng	Pilfink
Niccolò Cusano Dâi-hŏk	Università degli Studi Niccolò Cusano
Herodotus	Herodot
Othello	Othello
Nĭk-buōng-hāi	Japanhavet
Dĕ̤ng-ā	Øst-Asia
Dĕ̤ng-ĕu	Øst-Europa
Liù-giù-guók	Kongedømmet Ryukyu
Dièu-siēng uòng-dièu	Joseon
Gŏ̤-là̤	Goryeo
Dâi-hàng Dá̤-guók	Keiserdømmet Korea
Buŏk-hāi-guók	Balhae
Gŏ̤-gău-là̤	Goguryeo
Bì-bà-dâu-giék	Flaggermus
Báik-cá̤	Baekje
Sĭng-lò̤	Silla
Tàu-huók	Hår
Hàng Hĭ	Han Feizi
Uòng-dá̤	Den gule keiser
Diéu-ngṳ̀-dài Liĕk-dō̤	Senkakuøyene
Gê̤ṳng-huò-dōng (Mī-guók)	Det republikanske parti (USA)
Dṳ̆ng-guók	Kina
Mìng-ciō-dōng (Mī-guók)	Det demokratiske parti
Cūi-tiák	Oter
Sìng-dŭ	Chengdu
Buò-gŭng-ĭng	Løvetannslekta
Tá	Manet
Dâng-ciŭ	Zhengzhou
Cūng-tūng	President
Muāng-ciŭ-guók	Mandsjukuo
Gù-cŭi	Streptopelia
Só̤h	Tau
Dṳ̆ng-guók Guók-mìng-dōng	Kuomintang
Hiăng-diê ciā-muói	Søsken
Ĕng-gŏ̤	Papegøyefugler
Gă-huák	Addisjon
Dài-uăng-sēng	Taiwan (provins)
Dŏ̤	Kniv
Băng-mā	Sebra
Guók-cié biĕu-cūng cṳ̆-hô̤	ISBN
Cà Mau	Ca Mau (provins)
Káh-gă-ngṳ̄	Hakka (språk)
Huŏng-ngiòng	Dialekt
Lev Trotsky	Lev Trotskij
Gáng-ngṳ̄	Gan (språk)
Sṳ̆-mā Guŏng	Sima Guang
Mà-hṳ̀ng	Panda
Muāng-ngṳ̄	Mandsjuisk
Chiū	Hånd
Dô Hū	Du Fu
Gùng-dō̤	Arkipel
Niŏh-niŏh	Blad
Bŭk-buó	Foss
Yasser Arafat	Yasir Arafat
Chṳ̆ng-sìng-ngṳ̄	Okinawa (språk)
Câung-ngṳ̄	Tibetansk
Ngù-ngṳ̄	Wu (språk)
Tasmania	Tasmania
Ì-cô̤	Såpe
Hŭk-săng	Foshan
Ciĕu-huò Tiĕng-huòng	Hirohito av Japan
Al-Qaeda	Al-Qaida
Mò̤-táuk-chiă	Motorsykkel
Ò̤-mā	Vanlig flodhest
Anastacia	Anastacia
Sĕk Gái	De ti bud
Huă-báu	Leopard
Să̤-ngiù	Neshorn
Lò̤-buàng	Kompass
Buáng-dō̤	Halvøy
Sĭng-giŏng	Xinjiang
Mŭk-guă	Papaya
Mì-sĕng-só	Vitamin
Giáng	Speil
Ciŭ-dièu	Zhou-dynastiet
Kāng-muòng-giāng	Vindu
Băh Gṳ̆ng	Det hvite hus
Gīng-chák	Politi
Hók-ciŭ-uâ	Fuzhouhua
Báe̤k-hāi-dô̤	Hokkaido
Giŏng	Ingefær
Nobel Huò-bìng Ciōng	Nobels fredspris
Sáu	Hoste
Hák-chê	Nys
Káung-mìng	Søvn
Gèng-hāi	Aralsjøen
Dé̤ṳk	Bambus
Hù Cé-mìng	Hồ Chí Minh
Hòa Bình	Hoa Binh
Sŭ Sék	Su Shi
Queensland	Queensland
Tù	Jord
Dòng-dô	Lengde
Kon Tum	Kon Tum (provins)
Máe̤ng	Drøm
Thừa Thiên-Huế	Thua Thien-Hue (provins)
Mìng-dĕ̤ng-ngṳ̄	Mindong
Hannibal	Hannibal
Mìng-báe̤k-ngṳ̄	Minbei
Mìng-nàng-ngṳ̄	Minnan
Thanh Hóa	Thanh Hoa (provins)
Quảng Trị	Quang Tri (provins)
Tây Ninh	Tay Ninh (provins)
Duâi-sĭng-sĭng	Gorilla
Bạc Liêu	Bac Lieu (provins)
Cáung-cŭk	Zhuang (folk)
Dièu-ciŭ-uâ	Teochew
Iók-hâng Hók Ĭng	Evangeliet etter Johannes
Dài-uăng-uâ	Taiwansk
Muòng	Dør
Chiēng-gák	Negl
Bình Dương	Binh Duong (provins)
Nam Định	Nam Dinh (provins)
Sìng-lṳ̀ng	Jackie Chan
Méng	Ansikt
Ùng-ngiòng-ùng	Wenyan
Gāng-lāng	Oliven
Săng-ôi-ék-tā̤	Den hellige treenighet
Sŏng-cṳ̄	Sunzi
Sĭng-săng	Lærer
Cleveland	Cleveland
Dăk-lâi Lā-mà	Dalai Lama
Huă-sĕng	Peanøtt
100	100 (tall)
Kă-kók-tàu	Kne
Hâing	Aprikos
Ngāng-giáng	Briller
Cê̤ṳ-lài-huōi	Fyrstikk
Chê-diòng	Marked
Nàng Dṳ̆ng-guók Hāi	Sørkinahavet
Dièu-siēng Sié-cŭng	Sejong den store
Hăk-gĭng	Legering
Bĭng-siŏng	Kjøleskap
Nobel Ùng-hŏk Ciōng	Nobelprisen i litteratur
Huăng-sṳ̀	Søtpotet
Uòng-hāi	Gulehavet
Akihito	Akihito av Japan
Newton ông-dông-hŏk dêng-lŭk	Newtons bevegelseslover
Să̤-guă	Vannmelon
Biobío Dâi-hŏk	Universitetet i Bio-Bio
Huòng-dá̤	Keiser
Ìng-mìng-bê	Kinesisk renminbi
Tā̤-cék	Volum
Cèng-sáik	Oransje
Gă-sĭ-huă	Verktøy
Ĭ-sĕng	Lege
Iéng (cēu)	Svaler
Kó	Bukse
Lô-gă Hók Ĭng	Evangeliet etter Lukas
Mìng-ciō-dōng	Demokratiske parti
Ciŏng-tàu	Murstein
Tiō-uòng	Ellipse
Sìng-huák	Multiplikasjon
Sé̤ṳ-dù Hèng-diông	Apostlenes gjerninger
Uòng-dô̤ Sĕk-nê Sĭng-cô̤	Dyrekretsen
Huá-siŏh	Fossil
Gēng-huák	Subtraksjon
Cī-cī	Frø
Chiĕk	Krabber
Gă-dŏ̤	Saks
Niêu	Urin
Ăng-hŭi	Anhui
Ngiăh	Panne
Sĭ-piĕng	Salmenes bok
Chungcheong Báe̤k-dô̤	Nord-Chungcheong
Chungcheong Nàng-dô̤	Sør-Chungcheong
Gangwon Dô̤ (Dâi-hàng Mìng-guók)	Gangwon
Nô̤i Mūng-gū	Indre Mongolia
Gĭng Nĭk-sìng	Kim Il-sung
Gyeongsang Nàng-dô̤	Sør-Gyeongsang
Gyeongsang Báe̤k-dô̤	Nord-Gyeongsang
Jeolla Báe̤k-dô̤	Nord-Jeolla
Jeolla Nàng-dô̤	Sør-Jeolla
Jeju Dĕk-biék Cê̤ṳ-dé-dô̤	Jeju
Huăng-cièng-giāng	Mynt
Bă-biĕk-ták	Babels tårn
Ulsan	Ulsan
Gwangju	Gwangju
Chó	Eddik
Kangwŏn Dô̤ (Dièu-siēng Mìng-ciō-ciō-ngiê Ìng-mìng Gê̤ṳng-huò-guók)	Kangwon
Michael Jordan	Michael Jordan
Lé-ê-gé	Tredje Mosebok
Gṳ̆ng-gṳ̆ng	Rot (plantedel)
Bì-bà (cūi-guō)	Japansk mispel
Hamlet	Hamlet
Huà Guók-hŭng	Hua Guofeng
Sāng	Paraply
Làu Hiēu-pŏ̤	Liu Xiaobo
Hók-gióng	Fujian
Mūng-gū-cŭk	Mongolene
Mĕk-sê Liŏh	Johannes' åpenbaring
Hièng-câung	Xuanzang
Gū-chiŏng	Rumpeball
Mìng-chòng	Seng
Hāi-nàng	Hainan
Háng-ngṳ̄ Pĭng-ĭng	Pinyin
Uōng-dĕ̤ng	Det fjerne østen
Băh-gák	Klippedue
Găng-sé̤ṳk	Gansu
Taliban	Taliban
Huŏi-sáik	Grå
Sĭng-mêng-gé	Femte Mosebok
Sŭ-ciŭ	Suzhou
Ŭng-ciŭ	Wenzhou
Háng-cŭk	Han-kinesere
Nìng-pŏ̤	Ningbo
Chói-chiŭ	Skjegg
Cāi-iêu	Drage (leketøy)
Hăk-ī-bĭng	Harbin
Mā-kì	Igler
1000	1000 (tall)
Mìng-só-gé	Fjerde Mosebok
Cáu-sèng	Kjøkken
Hùng-nàng	Yunnan
Săng-dĕ̤ng	Shandong
È̤ng-ĕ̤ng	Skolopendere
Ò̤-nàng	Henan
Mì-mò̤	Øyenbryn
Bók-sài	Navle
Lièu-nìng	Liaoning
Hióng-liông	Vektor (matematikk)
Cretaceous	Kritt (geologi)
Tochigi-gâing	Tochigi (prefektur)
Chói-mò̤-cēu	Isfugler
Dàu	Spillterning
Cūi-nà̤	Sement
Gék-lìng	Jilin (provins)
Dĕ̤ng Dṳ̆ng-guók Hāi	Østkinahavet
Hāi-chĕk	Sjørøveri
Gūi	Spøkelse
Lè̤ng-ū Huòng-dá̤	Longwu-keiseren
Bóng-dó̤	Avfall
Hù-nàng	Hunan
Jurassic	Jura (geologi)
Chĭng-hāi	Qinghai
Mì-ngù-ī-cŭk	Uighurer
Ă-piéng	Opium
Chiū-cī	Fingerring
Hù-báe̤k	Hubei
Săng-să̤	Shanxi
Cĕ̤ng-sáik	Brun
Giòng-găng	Voldtekt
Gói-ciŭ	Guizhou
Triassic	Trias
Sék-sáuk	Ekte sirisser
Cāi-piéu	Pengeseddel
SQL	Structured Query Language
Hù Sék	Hu Shi
Iók-cṳ̆-ā-gé	Josvas bok
Cŏng-cṳ̄	Zhuangzi
Cṳ̀-hĭ Tái-hâiu	Cixi
Kan Naoto	Naoto Kan
Miyagi-gâing	Miyagi (prefektur)
模板:Commons category	Mal:Commonscat
Lò̤-mā Cṳ̆	Paulus' brev til romerne
Pău-ŭk-siáng	Parabel
Iwate-gâing	Iwate (prefektur)
Ĭ-siòng-chiă	Symaskin
Dièu-siēng Lò̤-dông-dōng	Koreas arbeiderparti
Nàng-báe̤k-dièu	Nord- og Sør-dynastienes tid
Pì-lĭk-bī Cṳ̆	Paulus' brev til filipperne
Ngā-gŏ-cṳ̆	Høysangen
Mā-lăk-gĭ-cṳ̆	Malakis bok
模板:Taxobox	Mal:Taksoboks
分類:Gŭng-ciō	Kategori:Monarker
Diŏng Ngiê-mèu	Zhang Yimou
模板:Dṳ̆ng-guók lĭk-sṳ̄	Mal:Kinas historie
Gĭng Céng-ŏng	Kim Jong-un
Liù-giù-ngṳ̄	Ryukyuspråk
Mìng-dṳ̆ng-ngṳ̄	Minzhong
Céng-ngṳ̄	Jin (språk)
Mìng-ngṳ̄	Min (språk)
Buò-siĕng-ngṳ̄	Puxian
Gŏng-să̤	Jiangxi
Nìng-hâ	Ningxia
Lùng-sùng	Dragebåt
Noda Yoshihiko	Yoshihiko Noda
Yingluck Shinawatra	Yingluck Shinawatra
Siŏh-gă-cŏng	Shijiazhuang
Kuóh-dà̤	Fuzhoutankaer
Ciŏ-hāi	Zhuhai
Sáng-tàu	Shantou
Dâng-gŏng	Zhanjiang
Mùi-ciŭ	Meizhou (Guangdong)
Chĭng-uōng	Qingyuan (Guangdong)
Dĕ̤ng-uāng	Dongguan
Dṳ̆ng-săng-chê	Zhongshan (Guangdong)
Dièu-ciŭ	Chaozhou
Tàng-táik	Maller
Gé̤ṳk-huă	Krysantemumslekta
Sofie gì Sié-gái	Sofies verden
Ordovician	Ordovicium
Silurian	Silur
Dāng-nòng	Galleblære
Devonian	Devon (geologi)
Hók-ciŭ	Fuzhou
Nàng-bìng	Nanping
Buò-dièng	Putian
Săng-mìng	Sanming
Ciòng-ciŭ	Quanzhou
Â-muòng	Xiamen
Ciŏng-ciŭ	Zhangzhou
Lṳ̀ng-ngàng	Longyan
Nìng-dáik	Ningde
Să̤-nìng	Xining
Să̤-iù-gé	Reisen mot Vest
Săng-guók Iēng-ngiê	Beretningen om de tre kongedømmer
Cūi-hū	Fortellinger fra myrlandet
Aomori-gâing	Aomori (prefektur)
Fukushima-gâing	Fukushima (prefektur)
Tái-nguòng	Taiyuan
Hải Phòng	Haiphong
Dâi-lièng	Dalian
Hĭ-Pŏ̤ Ciéng-cĕng	Perserkrigene
Permian	Perm (geologi)
Biēu-chĭng	Søskenbarn
Cambrian	Kambrium
Iòng-ciók	Levende lys
Chiba-gâing	Chiba (prefektur)
Pău	Pomelo
Lô-dáik-gé	Ruts bok
Mà-hù	Øyenstikkere og libeller
Dáng-ī-lī	Daniels bok
Páuk-káik	Poker
Mô̤	Hatt
Gŏ̤-lìng-dŏ̤ Cièng Cṳ̆	Paulus' første brev til korinterne
Aichi-gâing	Aichi (prefektur)
Lī-ngṳ̀	Karpe
Muāng-ciŭ	Mandsjuria
Sê̤ṳ-sṳ-gé	Dommernes bok
Pŏ̤-lìng-chái	Spinat
Akita-gâing	Akita (prefektur)
Pièu-gĕng	Skje
Dê̤ṳ	Spisepinner
Mĕ̤k-lê	Jasmin
Gié-tiàng-chiă	Drosje
Â-hài	Hake
Gŭ	Fruktlegeme
Ibaraki-gâing	Ibaraki (prefektur)
Siĕu-sŏng	Salpetersyre
Ngù-giāng-kó	Dongeribukse
Bō̤-siŏh	Edelsten
Lièu-că̤ Cé-ê	Liaozhai zhiyi
Gáu-kuŏ-cṳ̆	Skolebøker
Chāu-māng	Gresshopper
Dâng Gĭng	Zheng Jing
Diòng-chŭng	Changchun
Milan Kundera	Milan Kundera
Lâung	Egg (mat)
Ū-ì-săng-chê	Wuyishan (Nanping)
Lĕ̤k-sé Sê̤ṳ-giông	Demonstrasjonene på Den himmelske freds plass
Diêu Ciē-iòng	Zhao Ziyang
Hù Iêu-băng	Hu Yaobang
Fukuda Yasuo	Yasuo Fukuda
Sṳ̀ng-chéu (Sṳ̀ng-báh)	Furufamilien
Gī-hò̤-chiă	Passer
Táng-sŏng	Karbonsyre
Liòng-chióh	Linjal
Chăng-màng-chṳ̄	Muldvarper
Dṳ̆ng-hâ Iâ cĭ Máe̤ng	En midtsommernattsdrøm
Mā-kō̤ Hók Ĭng	Evangeliet etter Markus
Diê (dông-ŭk)	Østers
Kaesŏng	Kaesong
Hwanghae Báe̤k-dô̤	Nord-Hwanghae
P'yŏng'an Báe̤k-dô̤	Nord-Pyongan
Hamgyŏng Báe̤k-dô̤	Nord-Hamgyong
Hamgyŏng Nàng-dô̤	Sør-Hamgyong
P'yŏng'an Nàng-dô̤	Sør-Pyongan
Namp'o	Nampo
Ryanggang Dô̤	Ryanggang
Nguòng-siĕu-uòng	Tangyuan (matrett)
Gĭng-dŭ	Kyoto (prefektur)
Ōsaka-hū	Osaka (prefektur)
Cék-ngṳ̀	Gullfisk
Fukuoka-gâing	Fukuoka (prefektur)
Ehime-gâing	Ehime (prefektur)
Gŏ̤-lìng-dŏ̤, Hâiu Cṳ̆	Paulus' andre brev til korinterne
Sā̤-ĭ-gĭ	Vaskemaskin
Gék	Mandarin (frukt)
Gé̤ṳ	Sag
Yamagata-gâing	Yamagata (prefektur)
Éu-dê-huòng	Barnehage
Dài-uăng Hāi-hiĕk	Taiwanstredet
Lù-guói	Aloe
Yamaguchi-gâing	Yamaguchi (prefektur)
Kanagawa-gâing	Kanagawa (prefektur)
Nagano-gâing	Nagano (prefektur)
Iĕng-huă	Fyrverkeri
Mì-pŏ̤-lù	Mikrobølgeovn
Saitama-gâing	Saitama (prefektur)
Mie-gâing	Mie (prefektur)
Hĭ-báik-lài Cṳ̆	Brevet til hebreerne
Gă-lăk-tái Cṳ̆	Paulus' brev til galaterne
Muàng-ngṳ̀	Ålefisker
Céng-gŏng	Jinjiang (Quanzhou)
Siŏng-dièu	Shang-dynastiet
Gunma-gâing	Gunma (prefektur)
Hyōgo-gâing	Hyōgo (prefektur)
Miyazaki-gâing	Miyazaki (prefektur)
Kumamoto-gâing	Kumamoto (prefektur)
Ă-cì	Sangsikader
Koizumi Jun'ichirō	Junichiro Koizumi
Ī-sê̤ṳ-táik-cṳ̆	Esters bok
Diòng-dô-cṳ̆	Forkynneren
Hatoyama Yukio	Yukio Hatoyama
Gŏ̤-lò̤-să̤ Cṳ̆	Paulus' brev til kolosserne
Ngā-gáuk Cṳ̆	Jakobs brev
Iók-hâng Ék Cṳ̆	Johannes' første brev
Pì-lé-muòng Cṳ̆	Paulus' brev til Filemon
Táik-sák-lò̤-nà̤-giă, Hâiu Cṳ̆	Paulus' andre brev til tessalonikerne
Táik-sák-lò̤-nà̤-giă Cièng Cṳ̆	Paulus' første brev til tessalonikerne
Bī-dáik Cièng Cṳ̆	Peters første brev
Bī-dáik Hâiu Cṳ̆	Peters andre brev
Tì-mò̤-tái Cièng Cṳ̆	Paulus' første brev til Timoteus
Dòng-lòng	Knelere
Gifu-gâing	Gifu (prefektur)
Ishikawa-gâing	Ishikawa (prefektur)
Nara-gâing	Nara (prefektur)
Wakayama-gâing	Wakayama (prefektur)
Shizuoka-gâing	Shizuoka (prefektur)
Shiga-gâing	Shiga (prefektur)
Iók-hâng Nê Cṳ̆	Johannes' andre brev
Ī-suói-ā-cṳ̆	Jesajaboken
Iók-hâng Săng Cṳ̆	Johannes' tredje brev
Iù-dâi Cṳ̆	Judas' brev
Tì-mò̤-tái Hâiu Cṳ̆	Paulus' andre brev til Timoteus
Tì-dŏ̤ Cṳ̆	Paulus' brev til Titus
Nùng-mìng	Bonde
Ià-lé-mī-cṳ̆	Jeremias bok
Ī-sê̤ṳ-lá-cṳ̆	Esras bok
Nà̤-hĭ-mī-cṳ̆	Nehemjas bok
Iók-ngī-cṳ̆	Joels bok
Băh-lô	Silkehegre
Chŭng-cáik	Kinesisk nyttår
Sō-siè	Nøkkel
Abe Shinzō	Shinzō Abe
Asō Tarō	Taro Aso
Niigata-gâing	Niigata (prefektur)
Yamanashi-gâing	Yamanashi (prefektur)
Shimane-gâing	Shimane (prefektur)
Toyama-gâing	Toyama (prefektur)
Okayama-gâing	Okayama (prefektur)
Piăng	Rygg (anatomi)
Piĕ	Brev
Sáik-màng	Fargeblindhet
Carboniferous	Karbon (geologi)
Fukui-gâing	Fukui (prefektur)
Ōita-gâing	Ōita (prefektur)
Tottori-gâing	Tottori (prefektur)
Nùng-lĭk	Den kinesiske kalender
Kōchi-gâing	Kōchi (prefektur)
Uâng-iū īng-lĭk dêng-lŭk	Newtons gravitasjonslov
Chèng-gēng	Silkeorm
Páuk Gê̤ṳng-hiê	Park Geun-hye
Dài-nàng	Tainan
Cĕng	Synål
Muāng-cŭk	Mandsjuer
Kìng-giāng	Tang (redskap)
Anna Karenina	Anna Karenina
Gáung-gṳ̆ng	Armering
Tiè-mà	Gråt
Dŭng-nìng-guók	Tungning
Kă-cāi	Tå
Lāng	Spytt
Diò-să-hô	Kokk
Dâi-céng Tiĕng-huòng	Yoshihito av Japan
Băng-sièng Lā-mà	Panchen Lama
Cĕ̤ng-chéu	Vindmøllepalme
Muòi-kṳ̄ng	Muggsopp
Gĭng-cá̤	Økonomi
Sĕ̤ng-săng-giāng	Tvilling
Mĕ̤k-tiák	Øyenvipp
Nguòng-cṳ̄-bék	Kulepenn
Norodom Sihanouk	Norodom Sihanouk
Saga-gâing	Saga (prefektur)
Tokushima-gâing	Tokushima (prefektur)
Lòng-dâung	Bulmeurt
Lòi-sĭ-gā	Skrutrekker
Sĭk-sĭk	Vinge
Kagawa-gâing	Kagawa (prefektur)
Thaksin Shinawatra	Thaksin Shinawatra
Săng-guók (Dièu-siēng)	Koreas tre kongedømmer
Bék	Penn
Ŭng-dìng	Støv
Huăng-siŏh-liù	Guava
Duâi-tàu-giáng	Lupe
Ĭ-gŭng	Besteforeldre
Puái-dáu	Middag (tidspunkt)
Huōi-căi	Ildebrann
Chiū-ló̤h	Hansker
Nagasaki-gâing	Nagasaki (prefektur)
Hâ-dièu	Xia-dynastiet
Cá̤-nàng	Jinan (Shandong)
Dṳ̆ng-guók Káung-nĭk Ciéng-cĕng	Andre kinesisk-japanske krig
Sarawak	Sarawak
Hŭng-cūi	Feng Shui
Chiéu	Latter
Ngô̤-mâng gâe̤ng Piĕng-giéng	Stolthet og fordom
Oda Nobunaga	Oda Nobunaga
Lī Sìng-uāng	Syngman Rhee
Iòng-bék-chó̤	Viskelær
Nàng-chiŏng	Nanchang
Tokugawa Ieyasu	Tokugawa Ieyasu
Bók-séu-gáung	Rustfritt stål
Sáu-chiū	Sopelime
Dŭk-cài	Autokrati
Kŭng-dièu	Klimaanlegg
Diòng-să	Changsha
Pèng	Maling
Mìng-dê Tiĕng-huòng	Mutsuhito
Kă-âu-dăng	Hæl
Ā-mò̤-sê̤ṳ-cṳ̆	Amos (bok)
Ŏ̤-bă-dī-ā-cṳ̆	Obadja (bok)
Itō Hirobumi	Hirobumi Ito
Nguŏh	Jade
Só-gé̤ṳ-kó guāng-lī hiê-tūng	Databasehåndteringssystem
Dâu-hô	Tofu
Mì-hèu	Makaker
Mī-giă-cṳ̆	Mikas bok
Bù-sák	Bodhisattva
Hăk-gĭ-cṳ̆	Haggai (bok)
Ī-să̤-giék	Esekiels bok
Chiū-biēu	Armbåndsur
ASP.NET	ASP.NET
Sabah	Sabah
Ià-lé-mī-ăi-gŏ̤	Klagesangene
Tái-gáng	Evnukk
Nàng-nìng	Nanning
Ê-só	Natriumglutamat
Nā-ŭng-cṳ̆	Nahums bok
Hăk-bă-gók-cṳ̆	Habakkuk (bok)
Sák-gā-lé-ă-cṳ̆	Sakarjas bok
Guók-gê̤ṳng Nô̤i-ciéng	Den kinesiske borgerkrig
Uŏk-nàng Gê̤ṳng-huò-guók	Sør-Vietnam
Chiĕu-chê	Supermarked
Ciŏng Cṳ̄-ì	Zhang Ziyi
Lák-tàu	Skallethet
Gulliver Lṳ̄-hèng-gé	Gullivers reiser
Gŏ̤-hṳ̀ng	Kaohsiung
Buŏk-hāi	Bo Hai
Báh-chói	Gjesping
Hâung Ṳ̄	Xiang Yu
Putrajaya	Putrajaya
Kŏng-mìng	Kunming
Nĭk-guŏng-dĕng	Lysrør
Jane Eyre	Jane Eyre
Johor	Johor
Ngâung	Psykisk utviklingshemming
Huòi-cŭk	Huikinesere
Làng-ciŭ	Lanzhou
Hŏ̤-să̤-cṳ̆	Hoseas bok
Tiék-cĭng	Rust
Dĕ̤ng-kiĕ	Sepiida
Lìng Cáik-sṳ̀	Lin Zexu
Săng-guók	De tre rikers tid
Chŭng-chiŭ Sì-dâi	Vår- og høstannalenes tid
Ciéng-guók Sì-dâi	De stridende staters tid
Puō-ngì	Puyi
Mā-lăk-gă	Malakka
Oracle	Oracle Database
Hăk-bùi	Hefei
Huák-lùng-gŭng	Falun Gong
Kelantan	Kelantan
Lŏk-iòng	Luoyang
Toyotomi Hideyoshi	Toyotomi Hideyoshi
Câung-cŭk	Tibetanere
Pulau Pinang	Penang
Hamasaki Ayumi	Ayumi Hamasaki
Să̤-huăng-ngā-cṳ̆	Sefanja (bok)
Hṳ̆ng-nù	Xiongnu
Mâing-cṳ̄	Mencius
Kedah	Kedah
Perak	Perak
Hŏk-ôi	Akademisk grad
Gié-lìng	Guilin
Terengganu	Terengganu
Selangor	Selangor
Iòng (dông-ŭk)	Sauer og geiter
Hāi-kāu	Haikou
Pahang	Pahang
Bă-là̤ Séng-mū-iêng (Siēu-siók)	Ringeren i Notre Dame
Chiông-gì	Xiangqi
Yun Chi-ho	Yun Chi-ho
Gói-iòng	Guiyang
Gáung-bék	Fyllepenn
Ngù Dìng-iēng	Ngô Đình Diệm
Gô-dā̤	Fortid
Dĭng-hiŏng-kó̤	Ansjosfamilien
Miêng	Nudler
Hiêng-câi	Nåtid
Lèng-gēng	Longan
Mì-lĕk-hŭk	Maitreya
Guăng-ĭng	Avalokitesvara
Gēu-gī	Bukketorn
Lĕ̤k-dèu-gáuk	Ribbein
Ciŏng-bìng	Zhangping
Ciŏng-puō	Zhangpu
Ciéu-ăng	Zhao'an
Dâng Sìng-gŭng	Koxinga
Céng-huò	Zhenghe (Nanping)
Ciá-ìng	Zherong
Nguŏk-biāng	Månekake
Ciŭ Īng-kŏng	Zhou Yongkang
Ciŭ-nìng	Zhouning
Cṳ̆-gák Liông	Zhuge Liang
Ció-ĭng Hù-hô̤	Zhuyin
Tù-kēng	Jordsirisser
Dṳ̆ng-guók Ìng-mìng Gāi-huóng-gŭng	Folkets Frigjøringshær
Sìng-ū Tiĕng-huòng	Jimmu
Kūng-chiók	Påfugler
È̤ng-dà	Svart te
Cò̤ Chó̤	Cao Cao
Lièng-gŏng	Lianjiang (Fuzhou)
Tài-tàu	Halshogging
Cūi-ngù	Trebukker
Hiŏng-siàng	Xiangcheng (Zhangzhou)
Buŏi	Flyging
Ŭi-nà̤-sṳ̆ Sĕng-lī-nè̤ng	Kjøpmannen i Venedig
Ū-ì-săng	Wuyishan
Ŭ-sŭ-lī-gĕ̤ng	Ussuri
Dĕ̤ng-cé	Vintersolverv
Tiĕng-huòng	Keiser av Japan
Kăi-hŭng	Kaifeng
Sĭng-dài-bê	Taiwansk dollar
Lăk-dâi-cé-liŏk Hâ	Andre Krønikebok
Mièu-cŭk	Miao
Nguòng Sié-kāi	Yuan Shikai
Gă-lṳ̀ng Huòng-dá̤	Gia Long
John Wesley	John Wesley
Perlis	Perlis
Negeri Sembilan	Negeri Sembilan
Labuan	Labuan
Lṳ̀ng	Kinesisk drage
Iòng-iù-gàu	Parafinlampe
Cần Thơ	Can Tho
Ciĕng-bò̤	Champa
Diòng-gáu-sê̤ṳ	Misjonær
Uōng-dâi Cièng-tiàng	Store forventninger
Rasŏn	Rason
Guăng Ṳ̄	Guan Yu
Ŭ-gŭi	Skilpadder
Gê̤ṳng-huò-dōng	Republikanske partier
Bō̤-dâi Huòng-dá̤	Bao Dai av Vietnam
Siê-iù	Soyasaus
Ŭ-lṳ̀ng-dà	Oolong
Huōi-lṳ̀ng-guō	Pitahaya
Chái Ĭng-ùng	Tsai Ing-wen
Ŏ̤-mì-tò̤-hŭk	Amitabha
Orhan Pamuk	Orhan Pamuk
Hà-puō	Xiapu
Ngū-dâi Sĕk-guók	De fem dynastiers og ti kongedømmers tid
Cō̤	Kinajujube
Tā̤-ṳ̆k	Kroppsøving
Dài-dṳ̆ng	Taichung
Làu Bê	Liu Bei
Gĭng-muòng	Kinmen
Sĭng-dé̤ṳk (chê)	Hsinchu
Gă-ngiê (chê)	Chiayi
Giĕ-lè̤ng	Chilung
Ngiè	Tamgås
Dièu-siēng Gŏ̤-cŭng	Gojong av Korea
Hók-chiăng	Fuqing
Amuro Namie	Namie Amuro
Diêng-tù	Elektrisk batteri
Gŏ̤-ák-guŏ	Trykkoking
Chagang Dô̤	Chagang
Ké̤ṳk-siăh	Tigging
Sŏng-ngù	Østre Wu
Băh-cŭk	Bai (folk)
Mùi-liĕk	Meilie
Â-dáu	Ettermiddag
Huòng Tái-gĭk	Huang Taiji
Guŏng-sê̤ṳ Huòng-dá̤	Guangxu-keiseren
Sông-dê Huòng-dá̤	Shunzhi-keiseren
Nū-ī-hăk-cà̤	Nurhaci
Sŏng Guòng	Sun Quan
Cò̤ Pī	Cao Pi
Ciōng Gĭng-guók	Chiang Ching-kuo
Uòng Mì	Wang Wei (dikter 699–759)
Lī Dĕng-hŭi	Lee Teng-hui
Ṳ̆ng-céng Huòng-dá̤	Yongzheng-keiseren
Dùng-dê Huòng-dá̤	Tongzhi-keiseren
Dŭng-huòng	Dunhuang
Hiŏng-iòng-guă	Chayote
Uòng Ăng-sĭk	Wang Anshi
Săng-ā	Sanya
Dài-uăng Mìng-ciō-guók	Republikken Formosa
Sṳ̆k-háng	Shu Han
Cò̤-ngôi	Wei-dynastiet
Hiŏng-gŭ	Shiitake
Gă-kéng Huòng-dá̤	Jiaqing-keiseren
Páuk Hièng-īng	Park Hon-young
Dièu-siēng Sié-cū	Sejo av Joseon
Dô̤-guŏng Huòng-dá̤	Daoguang-keiseren
Hièng-hŭng Huòng-dá̤	Xianfeng-keiseren
Hùng Séu-ciòng	Hong Xiuquan
Gĭng-kiŏk	Pekingopera
Bău Cīng	Bao Zheng
Sṳ̆-mā Hé	Sima Yi
Ièu-cŭk	Yao (folk)
Bĭng-sĭng	Bing Xin
Dièu-siēng Tái-cū	Taejo av Joseon
Báik-nguŏk-cáik	Månefesten
Guŏng-Dṳ̆ng Huòng-dá̤	Nguyễn Huệ
Ngà̤ Táuk-sĭng	Watchman Nee
Gā-cō̤	Lopper
Mā-tái Hók Ĭng	Evangeliet etter Matteus
Tè̤ng-chō̤	Larvesopp
Ī-hók-sū Cṳ̆	Paulus' brev til efeserne
Mā-cū (Sìng)	Mazu
Mìng	Ming
Uŏk-nàng Gê̤ṳng-sāng-dōng	Det vietnamesiske kommunistparti
10000	10 000
Mìng-miâng Huòng-dá̤	Minh Mạng
Chék Gié-guŏng	Qi Jiguang
Dĭk Ìng-giĕk	Di Renjie
Ì-cŭk	Yi (folk)
Mìng-sìng Huòng-hâiu	Keiserinne Myeongseong
Lṳ̄ Séu-lièng	Annette Lu
Sṳ̀ng-chéu (Hók-ciŭ chê-chéu)	Banyan
Sê̤ṳ-dáik Huòng-dá̤	Tự Đức
Lìng Hŭi-ĭng	Lin Huiyin
Cṳ̀-ciŏng	Tegl
Ngù Săng-gié	Wu Sangui
Hĭng-sŏng Dâi-iêng-gŭng	Heungseon Daewongun
Gŏ̤ Dé-sêng	Gao Zhisheng
Dêu-uòng	Di Xin
Hàng Hàng	Han Han
Hók-ciŭ Dâi-hŏk	Fuzhouuniversitetet
Tiăng-dŏng	Stue
Ók-dāu	Strykejern
Liŏh-dà	Grønn te
Liŏh-dâu	Mungbønne
Dièu-siēng-cŭk	Koreanere
Mò̤-bék	Skrivepensel
Hŭk-dáng Dâi-hŏk	Fudanuniversitetet
Kŭmgang-săng Guăng-guŏng Dê-kṳ̆	Kumgangfjellet turistregion
Lêng Gié-hĕk	Ling Jihua
Hòng-ciŭ Să̤-hù	Xihu
Gă-săk-giāng	Bybil
Siông-hāi Gău-tŭng Dâi-hŏk	Jiaotonguniversitetet i Shanghai
Bù-sìng	Møkkfluer
Ciū-ciòng	Jiuquan
Hŭ-huò-hô̤-dĕk	Hohhot
Hà-iù	Fiskesaus
Băh-ngiê	Termitter
Băh-uâ-cê	Pe̍h-oē-jī
Páu-diông	Kinaputt
Hṳ̆ng-dòng	Thorax
Mā-cū (Dō̤)	Matsuøyene
Ăng-kă̤	Anxi
Să̤-cŏng	Dress
Ìng-cṳ̄	Menneskesønnen
Hiroshima-gâing	Hiroshima (prefektur)
Chiēng-cāi	Finger
Hwanghae Nàng-dô̤	Sør-Hwanghae
Hók-tīng	Fuding
Siĕu-ciū	Baijiu
Dùng-cé	Kamerat
Gióng-iòng	Jianyang (Nanping)
Dáng-mìng	Tanka
Mìng-kă̤	Mingxi
Hùng-siĕu	Yunxiao
Káh-gă	Hakkaer
Bâng-ā	Mutisme
Nàng-gĭng Dâi-hŏk	Nanjinguniversitetet
Chék-nguŏk-buáng	Spøkelsesfesten
Hù-siŭ	Kinesisk værål
Cò̤ Sĭk	Cao Zhi
Ciŭ Ùng-uòng	Kong Wen av Zhou
Huò-sĭng	Heshen
Siĕ Lòng	Shi Lang
Giŏng Tái-gŭng	Jiang Ziya
Dìng Bō̤-tĭng	Chen Baochen
Tái-sông	Taishun
Chŏng-nàng	Cangnan
Mìng-nàng-nè̤ng	Hoklo
Ngṳ̀-uòng	Fiskeboller
Uòng Sīng-dĭ	Wang Shenzhi
Lī Lièng-ĭng	Li Lianying
Dièu-siēng Buáng-dō̤ lĭk-sṳ̄	Koreas historie
Cáe̤ng	Zongzi
Sinŭiju Dĕk-biék Hèng-céng-kṳ̆	Sinuiju spesiell administrativ region
Tūng-ék Sĭng-lò̤	Det forente Silla
Dìng Gīng-ê̤ṳng	Chen Jingrun
Háng-cê Ùng-huá-kuŏng	Sinosfæren
Hók-gióng tū-làu	Fujian Tulou
Dṳ̆ng-huà Dâi-hŏk	Chung Hua-universitetet
Chĭng-mìng	Qingmingfesten
Nê-hù	Erhu
Pū-tŭng-uâ	Standard kinesisk
Siă-cŭk	She (folk)
Mē̤ng-giāng	Sommerfuglmygg
Mĭk-pŭng	Langtungebier
Okinawa-gâing	Okinawa (prefektur)
Diòng-lŏ̤h	Changle (Fuzhou)
Nàng-ā	Sør-Asia
Guòng-lé	Rettighet
Gióng-nìng	Jianning
Gŭng-sĭ	Selskap (jus)
Tì-kŭ	Stillehavsmakrell
Ŭ-cṳ̄ng-nè̤ng	Svart (hudfarge)
Nàng-uŏk-guók	Nanyue
Kiŏng-cŭk	Qiang
Chèng	Dyrket mark
Bĭng-dê̤ṳ	Vannis
Wikipedia:Sū-iū ngṳ̄-ngiòng bēng-buōng gì Wikipedia	Liste over Wikipediaer
Ngṳ̆k-huòng-dâi-dá̤	Jadekeiseren
Chiók	Drikking
À̤-liák	Tøffel
Lī-dièu	Lý-dynastiet
Cé̤ṳk	Congee
Mìng-ciō Céng-buô-dōng	Demokratisk framskrittsparti
Tĕng	Knivskjell
Pàng-hù Gùng-dō̤	Pescadores
Hāi-chŏng	Haicang
Hāi-nàng-ngṳ̄	Hainanesisk
Dĕ̤ng-săng	Dongshan (Zhangzhou)
Cĭk-mī	Jimei
Mìng-gĕ̤ng	Min (Fujian)
Dùng-ăng	Tong'an
Dài-gĕ̤ng	Taijiang (Fuzhou)
Lṳ̀ng-hāi	Longhai
Siŏh-săi	Shishi (Quanzhou)
Siòng-ăng	Xiang'an
Mìng-âu	Minhou
Siêu-ū	Shaowu
Ôi	Magesekk
Chŏng-săng	Cangshan (Fuzhou)
Sibu	Sibu
Lù Gŭng-mìng	Justus Doolittle
Ciŭ Ū-uòng	Kong Wu av Zhou
Diòng-tái	Changtai
Diòng-tĭng	Changting
Cṳ̆-dó̤h	Skrivebord
Siàng-siŏng	Chengxiang (Putian)
Chèng-lòi	Elvegjellesnegler
Lī-siàng	Licheng (Quanzhou)
Ciòng-gē̤ng	Quangang
Siĕu	Dizi
Sêu-nìng	Shouning
Káh-dièu	Lek
Lŏk-gŏng	Luojiang (Quanzhou)
Â-muòng Dâi-hŏk	Xiamenuniversitetet
Kŭ-chèng	Gutian
Dâi-dièng	Datian
Dáik-huá	Dehua
Là̤ Lé	Lê Thái Tổ
Huà-ăng	Hua'an
Nìng-huá	Ninghua
Iù-kă̤	Youxi
Chĭng-liù	Qingliu
Să-gâing	Sha
Gāi-gáik Kăi-huóng	Reform og åpning
Lièng-siàng	Liancheng
Sông-chiŏng-gâing	Shunchang
Lò̤-nguòng	Luoyuan
Bìng-nàng	Pingnan (Ningde)
Bìng-tàng	Pingtan
Nàng-ăng	Nan'an (Quanzhou)
Mìng-dáng	I morgen
Dṳ̀-huák	Divisjon (matematikk)
Ciŏng-lŏk	Jiangle
Īng-lĭk Huòng-dá̤	Zhu Youlang
Hù-lī	Huli
Īng-dêng	Yongding (Longyan)
Sṳ̀ Cài-hâiu	Xu Caihou
Céng-ăng	Jin'an (Fuzhou)
Gū-làu	Gulou (Fuzhou)
Séu-sê̤ṳ	Xiuyu
Īng-chŭng	Yongchun
Ciĕu-siàng	Jiaocheng (Ningde)
Siĕng-iù	Xianyou
Iòng-bìng-kṳ̆	Yanping
Sĭng-lò̤-kṳ̆	Xinluo
Puō-siàng	Pucheng (Nanping)
Săng-nguòng	Sanyuan (Sanming)
Hàng-gŏng	Hanjiang (Putian)
Hŭng-dĕk	Fengze
Lié-siàng	Licheng (Putian)
Siông-hòng-gâing	Shanghang
Sṳ̀ng-kă̤-gâing	Songxi
Ū-bìng	Wuping
Nàng-cêng	Nanjing (Zhangzhou)
Lè̤ng-ê̤ṳ Tái-hâiu	Longyu
Hók-ăng	Fu'an
Mìng-chiăng	Minqing
Gióng-ĕu	Jian'ou
Mā-muōi	Mawei
Īng-tái	Yongtai
Lṳ̀ng-ùng	Longwen
Sṳ̆-mìng	Siming
Hiê-ăng	Hui'an
Bìng-huò	Pinghe
Tái-nìng	Taining
Guŏng-dĕk	Guangze
Īng-ăng	Yong'an
分類:Dáik-guók	Kategori:Tyskland
分類:É-dâi-lé	Kategori:Italia
分類:Mī-guók	Kategori:USA
分類:Ngò̤-lò̤-sṳ̆	Kategori:Russland
分類:Dṳ̆ng-guók	Kategori:Kina
分類:Nĭk-buōng	Kategori:Japan
分類:Ó̤-ciŭ	Kategori:Australia
Iĕk-cūi-ké	Varmtvannsbereder
分類:Éng-nà̤	Kategori:Indonesia
分類:Hàng-guók	Kategori:Sør-Korea
分類:Tái-guók	Kategori:Thailand
分類:Uŏk-nàng	Kategori:Vietnam
分類:Buô-ṳ̄ dông-ŭk	Kategori:Pattedyr
分類:Bà-hèng dông-ŭk	Kategori:Krypdyr
分類:Cēu	Kategori:Fugler
分類:Cĭng-kṳ̄ng	Kategori:Sopp
分類:Sĭk-ŭk	Kategori:Planter
分類:Ŭk-lī	Kategori:Fysikk
分類:Huá-hŏk	Kategori:Kjemi
分類:Lĭk-sṳ̄	Kategori:Historie
分類:Dê-lī	Kategori:Geografi
分類:Siâ-huôi	Kategori:Samfunn
分類:Mī-sŭk	Kategori:Billedkunst
分類:Cŭng-gáu	Kategori:Religion
分類:Tā̤-ṳ̆k	Kategori:Sport
分類:Kuŏ-hŏk	Kategori:Vitenskap
分類:Gióng-dé̤ṳk-ŭk	Kategori:Byggverk
Gū Lò̤-mā	Romerriket
Mìng-uŏk	Minyue
分類:Sĕng-tái	Kategori:Økologi
分類:Disambig	Kategori:Pekere
分類:Diék-hŏk	Kategori:Filosofi
分類:Sĭng-lī	Kategori:Psykologi
分類:Hŭk-gáu	Kategori:Buddhisme
分類:Gĭ-dók-gáu	Kategori:Kristendom
分類:Ĭ-sṳ̆-làng-gáu	Kategori:Islam
分類:Iù-tái-gáu	Kategori:Jødedom
Tiĕng-cĭng Dâi-hŏk	Tianjinuniversitetet
Mā-cū	Matsu
Dĭ-dă	Suona
Gùng	Kjole og skjørt
Iraq gâe̤ng Levant Ĭ-sṳ̆-làng-guók	Den islamske staten Irak og Levanten
Â-muòng-uâ	Amoydialekt
Tău-dò̤-nó̤h	Tyveri
Ciĕ-muài	Sesam
Abu Bakr al-Baghdadi	Abu Bakr al-Baghdadi
分類:Ùng-huá	Kategori:Kultur
分類:Dê-cék	Kategori:Geologi
Dìng-dièu	Trần-dynastiet
Wikipedia:Dŏng-nièng gĭng-dáng	Wikipedia:Hendelser
模板:Tái-iòng-hiê	Mal:Solsystem
Gŏ̤-gák-hié	Gaojiaopera
Kī-mā-sŭ	Sachima
Bàng-uâ-cê	Foochow Romanized
Màng-gōng	Mango (dialekt)
Gâng	Svette
Sók-lŭk	Fart
Ák	Ender
Duâi-tàu-chái	Vanlig nepe
Huăng-siông	Mango (frukt)
分類:Dáik-guók ìng-ŭk	Kategori:Tyskere
分類:Mī-guók ìng-ŭk	Kategori:Personer fra USA
分類:Iēng-uòng	Kategori:Skuespillere
分類:Ĭng-guók ìng-ŭk	Kategori:Briter
分類:Huák-guók ìng-ŭk	Kategori:Franskmenn
模板:Chess diagram	Mal:Sjakkstilling
模板:Tl	Mal:Mal
分類:Guók-gă	Kategori:Land
Wikipedia:Hèng-céng Ìng-uòng	Wikipedia:Administratorer
分類:Dṳ̆ng-guók mìng-cŭk	Kategori:Folkegrupper i Kina
分類:Ìng-ŭk	Kategori:Personer
分類:Cék-ngiĕk	Kategori:Beskjeftigelser
Wikipedia:Gĭ-ké-nè̤ng	Wikipedia:Roboter
分類:Sì-găng	Kategori:Tid
分類:Gĕ̤ng-tiàng	Kategori:Ingeniørvitenskap
分類:Cài-lâiu	Kategori:Materialer
分類:Ĭ-hŏk	Kategori:Medisin
分類:Céng-dê	Kategori:Politikk
分類:Gáu-ṳ̆k	Kategori:Utdanning
Ăi-gĭk	Egypt
模板:Bot	Mal:Bot
Gă-nā-dâi	Canada
分類:Iù-hié	Kategori:Spill
Hók-gióng Sṳ̆-huâng Dâi-hŏk	Fujian pedagogiske universitet
分類:Ĕu-ciŭ guók-gă	Kategori:Land i Europa
分類:Ĕu-ciŭ	Kategori:Europa
模板:Documentation	Mal:Dokumentasjon
分類:Ê̤ṳng-hô	Kategori:Wikipedia-brukere etter språk
模板:Softredirect	Mal:Softredirect
Wikipedia:維基數據	Wikipedia:Wikidata
模板:Chēng	Mal:Hurtigsletting
分類:Ngṳ̄-ngiòng	Kategori:Språk
分類:Lĭk-huák	Kategori:Kalendere
分類:Wikipedia	Kategori:Wikipedia
Wikipedia:Mò̤ hô-cáik sĭng-mìng	Wikipedia:Generelle forbehold
Dâi-chṳ̄	Kenguruer
模板:!	Mal:!
模板:Nowrap	Mal:Nowrap
Wikipedia:Ék-chiék Wikipedia dŭ găi-dŏng ô gì ùng	Wikipedia:Liste over artikler vi bør ha
分類:Hĭ-ciŭ	Kategori:Afrika
模板:Wikisource	Mal:Wikisource
模板:Babel	Mal:Babel
模板:Commons	Mal:Commons
模板:Reflist	Mal:Referanser
Wikipedia:列明來源	Wikipedia:Bruk av kilder
模板:Stub	Mal:Stubb
模板:User eo-1	Mal:Bruker eo-1
模板:User eo-3	Mal:Bruker eo-3
模板:User de	Mal:Bruker de
模板:User de-1	Mal:Bruker de-1
模板:User es	Mal:Bruker es
模板:User de-3	Mal:Bruker de-3
模板:User en-3	Mal:Bruker en-3
模板:User en-1	Mal:Bruker en-1
模板:User en-2	Mal:Bruker en-2
模板:User eo-2	Mal:Bruker eo-2
模板:User en-4	Mal:Bruker en-4
模板:User en	Mal:Bruker en
模板:User de-2	Mal:Bruker de-2
模板:User es-1	Mal:Bruker es-1
模板:User fr-1	Mal:Bruker fr-1
模板:User it-3	Mal:Bruker it-3
模板:User fr-2	Mal:Bruker fr-2
模板:User ja	Mal:Bruker ja
模板:User ja-1	Mal:Bruker ja-1
模板:User it-1	Mal:Bruker it-1
模板:User fr	Mal:Bruker fr
分類:Ā-ciŭ	Kategori:Asia
分類:Nàng Mī-ciŭ	Kategori:Sør-Amerika
分類:Mā-lài-să̤-ā	Kategori:Malaysia
模板:Mod	Mal:Mod
模板:User it	Mal:Bruker it
模板:User es-2	Mal:Bruker es-2
模板:Huăng-ngìng	Mal:Reg-velkommen
分類:User fr-1	Kategori:Bruker fr-1
模板:Image label	Mal:Image label
模板:Category handler	Mal:Category handler
模板:Wiki gĕ̤ng-tiàng	Mal:Wikimedia-navigasjon
模板:Steady	Mal:Stabil
模板:Guók-gă	Mal:Infoboks land2
模板:Infobox 公司	Mal:Infoboks firma
模板:Wikibooks	Mal:Wikibøker
模板:Dablink	Mal:Dablink
模板:Hō̤ gì ùng-ciŏng	Mal:Utmerket
分類:User en-4	Kategori:Bruker en-4
分類:User en	Kategori:Bruker en
分類:User zh	Kategori:Bruker zh
分類:User zh-M	Kategori:Bruker zh-N
分類:User en-2	Kategori:Bruker en-2
模板:Infobox	Mal:Infoboks
模板:User eo	Mal:Bruker eo
模板:User zh	Mal:Bruker zh
分類:Gáuk-guók gì lĭk-sṳ̄	Kategori:Historie etter land
Wikipedia:Dŏng-nièng gĭng-dáng/09 nguŏk 23 hô̤	Mal:September 23
Wikipedia:Dŏng-nièng gĭng-dáng/09 nguŏk 22 hô̤	Mal:September 22
模板:Legend	Mal:Legend
Wikipedia:Dŏng-nièng gĭng-dáng/09 nguŏk 17 hô̤	Mal:September 17
Wikipedia:Dŏng-nièng gĭng-dáng/10 nguŏk 15 hô̤	Mal:Oktober 15
模板:Cite web	Mal:Kilde www
Wikipedia:Dŏng-nièng gĭng-dáng/09 nguŏk 28 hô̤	Mal:September 28
模板:Ombox	Mal:Pmboks
Wikipedia:Dŏng-nièng gĭng-dáng/10 nguŏk 22 hô̤	Mal:Oktober 22
Wikipedia:Dŏng-nièng gĭng-dáng/11 nguŏk 2 hô̤	Mal:November 2
Wikipedia:Dŏng-nièng gĭng-dáng/11 nguŏk 9 hô̤	Mal:November 9
Wikipedia:Dŏng-nièng gĭng-dáng/10 nguŏk 1 hô̤	Mal:Oktober 1
Wikipedia:Dŏng-nièng gĭng-dáng/10 nguŏk 5 hô̤	Mal:Oktober 5
Wikipedia:Dŏng-nièng gĭng-dáng/10 nguŏk 8 hô̤	Mal:Oktober 8
分類:Īng-sĭk	Kategori:Mat og drikke
模板:MongolUnicode	Mal:MongolUnicode
Wikipedia:Dŏng-nièng gĭng-dáng/10 nguŏk 6 hô̤	Mal:Oktober 6
Wikipedia:Dŏng-nièng gĭng-dáng/10 nguŏk 17 hô̤	Mal:Oktober 17
Wikipedia:Dŏng-nièng gĭng-dáng/10 nguŏk 2 hô̤	Mal:Oktober 2
Wikipedia:Dŏng-nièng gĭng-dáng/09 nguŏk 16 hô̤	Mal:September 16
Wikipedia:Dŏng-nièng gĭng-dáng/09 nguŏk 19 hô̤	Mal:September 19
Wikipedia:Dŏng-nièng gĭng-dáng/10 nguŏk 25 hô̤	Mal:Oktober 25
Wikipedia:Dŏng-nièng gĭng-dáng/11 nguŏk 10 hô̤	Mal:November 10
Wikipedia:Dŏng-nièng gĭng-dáng/10 nguŏk 21 hô̤	Mal:Oktober 21
Wikipedia:Dŏng-nièng gĭng-dáng/09 nguŏk 15 hô̤	Mal:September 15
Wikipedia:Dŏng-nièng gĭng-dáng/09 nguŏk 4 hô̤	Mal:September 4
Wikipedia:Dŏng-nièng gĭng-dáng/09 nguŏk 8 hô̤	Mal:September 8
Wikipedia:Dŏng-nièng gĭng-dáng/10 nguŏk 4 hô̤	Mal:Oktober 4
Wikipedia:Dŏng-nièng gĭng-dáng/09 nguŏk 1 hô̤	Mal:September 1
Wikipedia:Dŏng-nièng gĭng-dáng/09 nguŏk 6 hô̤	Mal:September 6
Wikipedia:Dŏng-nièng gĭng-dáng/09 nguŏk 25 hô̤	Mal:September 25
Wikipedia:Dŏng-nièng gĭng-dáng/09 nguŏk 10 hô̤	Mal:September 10
Wikipedia:Dŏng-nièng gĭng-dáng/09 nguŏk 26 hô̤	Mal:September 26
Wikipedia:Dŏng-nièng gĭng-dáng/09 nguŏk 20 hô̤	Mal:September 20
Wikipedia:Dŏng-nièng gĭng-dáng/11 nguŏk 4 hô̤	Mal:November 4
Wikipedia:Dŏng-nièng gĭng-dáng/09 nguŏk 30 hô̤	Mal:September 30
Wikipedia:Dŏng-nièng gĭng-dáng/10 nguŏk 7 hô̤	Mal:Oktober 7
Wikipedia:Dŏng-nièng gĭng-dáng/10 nguŏk 19 hô̤	Mal:Oktober 19
Wikipedia:Dŏng-nièng gĭng-dáng/09 nguŏk 27 hô̤	Mal:September 27
Wikipedia:Dŏng-nièng gĭng-dáng/09 nguŏk 11 hô̤	Mal:September 11
Wikipedia:Dŏng-nièng gĭng-dáng/11 nguŏk 8 hô̤	Mal:November 8
Wikipedia:Dŏng-nièng gĭng-dáng/11 nguŏk 1 hô̤	Mal:November 1
Wikipedia:Dŏng-nièng gĭng-dáng/11 nguŏk 7 hô̤	Mal:November 7
Wikipedia:Dŏng-nièng gĭng-dáng/10 nguŏk 11 hô̤	Mal:Oktober 11
Wikipedia:Dŏng-nièng gĭng-dáng/11 nguŏk 3 hô̤	Mal:November 3
Wikipedia:Dŏng-nièng gĭng-dáng/10 nguŏk 20 hô̤	Mal:Oktober 20
Wikipedia:Dŏng-nièng gĭng-dáng/10 nguŏk 16 hô̤	Mal:Oktober 16
Wikipedia:Dŏng-nièng gĭng-dáng/10 nguŏk 14 hô̤	Mal:Oktober 14
Wikipedia:Dŏng-nièng gĭng-dáng/10 nguŏk 18 hô̤	Mal:Oktober 18
Wikipedia:Dŏng-nièng gĭng-dáng/10 nguŏk 24 hô̤	Mal:Oktober 24
Wikipedia:Dŏng-nièng gĭng-dáng/10 nguŏk 3 hô̤	Mal:Oktober 3
Wikipedia:Dŏng-nièng gĭng-dáng/09 nguŏk 7 hô̤	Mal:September 7
分類:Săng	Kategori:Fjell
模板:IPA	Mal:IPA
分類:Céng-dê-gă	Kategori:Politikere
分類:Mī-ciŭ	Kategori:Amerika
分類:Gáuk-guók gì ìng-ŭk	Kategori:Personer etter nasjonalitet
模板:Wiki-huá	Mal:Wikifisering
分類:Gŭng-sê̤ṳ	Kategori:Militærvesen
模板:Increase	Mal:Økning
模板:Ciŭ-gĭ-biēu	Mal:Periodesystemet
模板:User nl	Mal:Bruker nl
模板:Infobox 網站	Mal:Infoboks nettsted
Wikipedia:Dŏng-nièng gĭng-dáng/10 nguŏk 12 hô̤	Mal:Oktober 12
模板:Decrease	Mal:Nedgang
模板:User no-2	Mal:Bruker no-2
模板:Documentation subpage	Mal:Dokumentasjonsunderside
Wikipedia:Dŏng-nièng gĭng-dáng/11 nguŏk 5 hô̤	Mal:November 5
Wikipedia:Dŏng-nièng gĭng-dáng/10 nguŏk 13 hô̤	Mal:Oktober 13
Wikipedia:Dŏng-nièng gĭng-dáng/09 nguŏk 3 hô̤	Mal:September 3
Wikipedia:Dŏng-nièng gĭng-dáng/09 nguŏk 24 hô̤	Mal:September 24
模板:Purge	Mal:Oppdater
分類:Cìng-gāng	Kategori:Følelser
模板:Dṳ̆ng-huà Ìng-mìng Gê̤ṳng-huò-guók Hèng-céng-kṳ̆	Mal:Kinas provinser
模板:Userpage	Mal:Brukerside
模板:User	Mal:Bruker
Wikipedia:Dŏng-nièng gĭng-dáng/09 nguŏk 12 hô̤	Mal:September 12
Wikipedia:Dŏng-nièng gĭng-dáng/09 nguŏk 2 hô̤	Mal:September 2
Wikipedia:Dŏng-nièng gĭng-dáng/11 nguŏk 6 hô̤	Mal:November 6
Wikipedia:Dŏng-nièng gĭng-dáng/09 nguŏk 18 hô̤	Mal:September 18
Wikipedia:Dŏng-nièng gĭng-dáng/10 nguŏk 10 hô̤	Mal:Oktober 10
Wikipedia:Dŏng-nièng gĭng-dáng/10 nguŏk 9 hô̤	Mal:Oktober 9
Wikipedia:Dŏng-nièng gĭng-dáng/10 nguŏk 23 hô̤	Mal:Oktober 23
模板:Image label small	Mal:Image label small
模板:User fr-3	Mal:Bruker fr-3
模板:Gô-dā̤ gì guók-gă	Mal:Infoboks tidligere land2
分類:User ja-M	Kategori:Bruker ja-N
模板:Gì-ngiê	Mal:Peker
分類:Dièu-siēng lĭk-sṳ̄	Kategori:Koreas historie
模板:User no-3	Mal:Bruker no-3
模板:Lifetime	Mal:FD
模板:Lang-en	Mal:Lang-en
分類:Sĕng-ŭk	Kategori:Organismer
Wikipedia:Dŏng-nièng gĭng-dáng/9 nguŏk	Wikipedia:Hendelser/September
Wikipedia:Dŏng-nièng gĭng-dáng/09 nguŏk 14 hô̤	Mal:September 14
Wikipedia:Dŏng-nièng gĭng-dáng/09 nguŏk 9 hô̤	Mal:September 9
Wikipedia:Dŏng-nièng gĭng-dáng/09 nguŏk 13 hô̤	Mal:September 13
Wikipedia:Dŏng-nièng gĭng-dáng/10 nguŏk	Wikipedia:Hendelser/Oktober
分類:User vi-3	Kategori:Bruker vi-3
模板:User la-1	Mal:Bruker la-1
分類:User wuu	Kategori:Bruker wuu
分類:User fr	Kategori:Bruker fr
分類:User ja	Kategori:Bruker ja
分類:User la	Kategori:Bruker la
分類:User fr-3	Kategori:Bruker fr-3
分類:User it-3	Kategori:Bruker it-3
分類:User ja-3	Kategori:Bruker ja-3
分類:User fr-2	Kategori:Bruker fr-2
分類:User it-2	Kategori:Bruker it-2
分類:User ja-2	Kategori:Bruker ja-2
分類:User la-2	Kategori:Bruker la-2
分類:User wuu-M	Kategori:Bruker wuu-N
分類:User ko-M	Kategori:Bruker ko-N
分類:User fr-M	Kategori:Bruker fr-N
分類:User it-M	Kategori:Bruker it-N
分類:User nl-M	Kategori:Bruker nl-N
分類:Ùng-cê	Kategori:Skriftsystem
分類:Dô̤-gáu	Kategori:Taoismen
分類:Dō̤	Kategori:Øyer
分類:User de	Kategori:Bruker de
分類:User de-2	Kategori:Bruker de-2
分類:User de-3	Kategori:Bruker de-3
分類:User de-M	Kategori:Bruker de-N
分類:User en-3	Kategori:Bruker en-3
分類:User en-M	Kategori:Bruker en-N
分類:User es	Kategori:Bruker es
分類:User es-1	Kategori:Bruker es-1
分類:User es-2	Kategori:Bruker es-2
分類:User es-3	Kategori:Bruker es-3
分類:User es-M	Kategori:Bruker es-N
分類:User it	Kategori:Bruker it
分類:User it-1	Kategori:Bruker it-1
分類:User ja-1	Kategori:Bruker ja-1
分類:User ko	Kategori:Bruker ko
分類:Mī-guók gì ciŭ	Kategori:USAs delstater
分類:User ko-1	Kategori:Bruker ko-1
分類:User ko-2	Kategori:Bruker ko-2
分類:User ko-3	Kategori:Bruker ko-3
分類:User ksh	Kategori:Bruker ksh
分類:User ksh-M	Kategori:Bruker ksh-N
分類:User la-1	Kategori:Bruker la-1
Wikipedia:Dŏng-nièng gĭng-dáng/09 nguŏk 29 hô̤	Mal:September 29
分類:User la-3	Kategori:Bruker la-3
Wikipedia:Dŏng-nièng gĭng-dáng/09 nguŏk 5 hô̤	Mal:September 5
模板:Distinguish	Mal:Forveksles
分類:Huâng-cô̤i	Kategori:Kriminalitet
Sáik-mō̤	Pels- og fjærlus
分類:Hāi	Kategori:Hav
Hŭng-siéng	Ventilator
分類:Guōng-dĕ̤ng	Kategori:Guangdong
分類:Hók-gióng	Kategori:Fujian
分類:Gĭng-cá̤	Kategori:Økonomi
分類:Ciék-ciĕ dông-ŭk	Kategori:Leddyr
分類:User nan	Kategori:Bruker zh-min-nan
分類:User nan-M	Kategori:Bruker zh-min-nan-N
分類:Hĭ-ciŭ guók-gă	Kategori:Land i Afrika
分類:Gáuk-guók gì gáu-ṳ̆k	Kategori:Utdanning etter område
Wikipedia:Dŏng-nièng gĭng-dáng/11 nguŏk	Wikipedia:Hendelser/November
模板:User ja-2	Mal:Bruker ja-2
分類:User vi	Kategori:Bruker vi
分類:User vi-1	Kategori:Bruker vi-1
分類:User vi-2	Kategori:Bruker vi-2
分類:User vi-M	Kategori:Bruker vi-N
分類:Ciék-gŏng	Kategori:Zhejiang
分類:Ĭng-ngŏk-gă	Kategori:Musikere
模板:Lang	Mal:Språk
Wikipedia:Dŏng-nièng gĭng-dáng/09 nguŏk 21 hô̤	Mal:September 21
Bì-bà (ngŏk-ké)	Pipa
分類:Wikimedia gĕ̤ng-tiàng	Kategori:Wikimedia-prosjekter
分類:Ò̤	Kategori:Elver
模板:User la-2	Mal:Bruker la-2
模板:User no-1	Mal:Bruker no-1
模板:User zh-1	Mal:Bruker zh-1
模板:User zh-2	Mal:Bruker zh-2
分類:Dâi-hàng Mìng-guók ìng-ŭk	Kategori:Sørkoreanere
分類:Sôi-diēng ìng-ŭk	Kategori:Svensker
分類:Nĭk-buōng ìng-ŭk	Kategori:Japanere
分類:Dài-uăng ìng-ŭk	Kategori:Taiwanere
分類:User nl	Kategori:Bruker nl
分類:User zh-1	Kategori:Bruker zh-1
分類:User zh-3	Kategori:Bruker zh-3
分類:User zh-2	Kategori:Bruker zh-2
分類:Cāi	Kategori:Papir
分類:Ông-ò̤	Kategori:Kanaler
分類:Uŏk-nàng ìng-ŭk	Kategori:Vietnamesere
分類:Sùi-dièu huòng-dá̤	Kategori:Kinesiske Sui-keisere
分類:Sóng-dièu huòng-dá̤	Kategori:Kinesiske Song-keisere
分類:Dòng-dièu huòng-dá̤	Kategori:Kinesiske Tang-keisere
分類:Mìng-dièu huòng-dá̤	Kategori:Kinesiske Ming-keisere
分類:Ngò̤-lò̤-sṳ̆ ìng-ŭk	Kategori:Russere
分類:Hiŏng-gē̤ng ìng-ŭk	Kategori:Hongkongkinesere
分類:Ciĕk-káik ìng-ŭk	Kategori:Tsjekkere
分類:Tái-guók ìng-ŭk	Kategori:Thailendere
Uŏk-ngṳ̄	Kantonesisk
分類:Sáng	Kategori:Etternavn
分類:Dièu-siēng Mìng-ciō-ciō-ngiê Ìng-mìng Gê̤ṳng-huò-guók	Kategori:Nord-Korea
分類:Dṳ̆ng-guók ìng-ŭk	Kategori:Kinesere
分類:Dièu-siēng	Kategori:Korea
分類:Dài-uăng	Kategori:Taiwan
分類:Dièu-siēng Mìng-ciō-ciō-ngiê Ìng-mìng Gê̤ṳng-huò-guók ìng-ŭk	Kategori:Nordkoreanere
分類:Hók-gióng-nè̤ng	Kategori:Personer fra Fujian
分類:Dâi-iòng-ciŭ guók-gă	Kategori:Land i Oseania
分類:Báe̤k Mī-ciŭ guók-gă	Kategori:Land i Nord-Amerika
分類:Ngṳ̀	Kategori:Fisk
分類:Cūi-guō	Kategori:Frukt
分類:Niōng-tā̤ dông-ŭk	Kategori:Bløtdyr
分類:Só-cê	Kategori:Tallsystemer
分類:Gióng-dé̤ṳk cài-lâiu	Kategori:Bygningsmaterialer
分類:Dông-ŭk	Kategori:Dyr
分類:Ciáh-tùi dông-ŭk	Kategori:Virveldyr
分類:Guòng-lé	Kategori:Rettighet
分類:Ìng-guòng	Kategori:Menneskerettigheter
分類:Ū-ké	Kategori:Våpen
分類:Nàng Mī-ciŭ guók-gă	Kategori:Land i Sør-Amerika
分類:Gă-sĭ	Kategori:Møbler
分類:Ké-chiông	Kategori:Meteorologi
分類:Dṳ̆ng Mī-ciŭ	Kategori:Sentral-Amerika
分類:Hiŏng-gē̤ng	Kategori:Hongkong
分類:Ĭ-siòng	Kategori:Klær
分類:Cáik-nĭk	Kategori:Festivaler
分類:Kuàng-ciék dông-ŭk	Kategori:Leddormer
分類:Bâng	Kategori:Sykdommer
分類:Kiŏng-diòng dông-ŭk	Kategori:Nesledyr
分類:Gùng-dō̤	Kategori:Øygrupper
分類:Káh-dièu-nó̤h	Kategori:Leketøy
分類:Gă-dìng	Kategori:Familie
分類:Dṳ̆ng-guók huòng-dá̤	Kategori:Kinesiske keisere
分類:Huòng-dá̤	Kategori:Keisere
分類:Nguòng-dièu huòng-dá̤	Kategori:Kinesiske Yuan-keisere
分類:Chĭng-dièu huòng-dá̤	Kategori:Kinesiske Qing-keisere
分類:Báe̤k Mī-ciŭ	Kategori:Nord-Amerika
分類:Gŏ̤-chiū	Kategori:Sangere
分類:Hù	Kategori:Innsjøer
分類:Só-hŏk-gă	Kategori:Matematikere
模板:Infobox ngṳ̄-ngiòng	Mal:Infoboks språk
分類:Dâi-iòng-ciŭ	Kategori:Oseania
分類:Tiĕng-căi	Kategori:Naturkatastrofer
分類:Gô-dā̤ gì guók-gă	Kategori:Historiske stater
分類:Dṳ̆ng-huà Ìng-mìng Gê̤ṳng-huò-guók	Kategori:Folkerepublikken Kina
Cāi-puŏi	Bølgepapp
分類:Giông-kŏng	Kategori:Helse
Hâ-cé	Sommersolverv
分類:Sĕng-lī	Kategori:Fysiologi
分類:Â-muòng	Kategori:Xiamen
Trojany	Trojany
模板:Infobox color	Mal:Infoboks farge
分類:Ā-ciŭ guók-gă	Kategori:Land i Asia
分類:Huák-lŭk	Kategori:Lover
分類:Dṳ̆ng Mī-ciŭ guók-gă	Kategori:Land i Sentral-Amerika
分類:Bēng-guòng	Kategori:Opphavsrett
分類:Hók-ciŭ	Kategori:Fuzhou
分類:Hók-gióng lĭk-sṳ̄	Kategori:Fujians historie
分類:Ôi-sĕng	Kategori:Hygiene
分類:Dṳ̆ng-huà Mìng-guók	Kategori:Republikken Kina
分類:Hók-ciŭ-nè̤ng	Kategori:Personer fra Fuzhou
模板:Image label begin	Mal:Image label begin
分類:Sĕng-uăk	Kategori:Dagligliv
模板:User vi	Mal:Bruker vi
分類:User en-1	Kategori:Bruker en-1
分類:User de-1	Kategori:Bruker de-1
Lăk-dâi-cé-liŏk Siông	Første Krønikebok
Mìng-kiŏk	Min-opera
Wikipedia:失效鏈接	Wikipedia:Døde eksterne lenker
Liù-giù	Ryukyuøyene
模板:User wuu	Mal:Bruker wuu
模組:Citation/CS1/Whitelist	Modul:Citation/CS1/Whitelist
Hù-diĕk	Rhopalocera
Chái-tàu	Reddik
模板:Ping	Mal:Svar til
模組:Arguments	Modul:Arguments
特殊:最近其改變	Spesial:Siste endringer
模組:Citation/CS1	Modul:Citation/CS1
模組:Citation/CS1/Configuration	Modul:Citation/CS1/Configuration
模組:TableTools	Modul:TableTools
模組:HtmlBuilder	Modul:HtmlBuilder
模組:Coordinates	Modul:Coordinates
模組:Math	Modul:Math
模組:Infobox	Modul:Infoboks
Ciá	Sukkerrør
