ᎬᎿᎦᏍᏛ	Afrika
ᏣᏩᏂᏏ	Japan
ᏧᎦᎾᏮ ᎠᎹᏰᏟ	Sør-Amerika
ᎠᏂᏍᏆᏂᏱ	Spania
ᏌᏊᎢᏳᎾᎵᏍᏔᏅᏍᎦᏚᎩ ᎾᎿ ᎠᎺᏰᏟ	USA
ᏇᎵᏥᎥᎻ	Belgia
ᎡᎶᎯ	Jorden
ᏣᏥ ᏩᏒᏓᎾ	George Washington
ᏫᏂᎦᏙᎯ	Finland
ᏍᏫᏕᏂ	Sverige
ᏗᏂᎹᎦ	Danmark
ᏉᎳᏂ	Polen
ᎢᏔᎵ	Italia
ᏍᏫᏍ	Sveits
ᎠᏍᏟᏯ	Østerrike
ᎪᎢᎯ	Hellas
ᎬᏃ	Tyrkia
ᏉᏥᎦᎳ	Portugal
ᏳᎳᏛ	Europa
ᏓᎶᏂᎦᏍᏛ	Asia
ᏧᏴᏢ ᎠᎹᏰᏟ	Nord-Amerika
ᏧᏁᏍᏓᎸ	Antarktika
ᏫᎩᏇᏗᏯ	Wikipedia
ᎾᏍᎩ ᏁᏛᎳᏂ	Nederland
ᏩᏙᎵ	Penis
ᏄᏯᎩ BMX	New York
ᏆᎳᎩ ᎣᏆᎹ	Barack Obama
ᎫᎴ ᏗᏍᎪᏂᎯᏱ	London
ᏒᎦᏔ	Epleslekten
ᎺᏏᎪ	Mexico
ᎤᏃᎸᏔᏅ	Januar
ᎧᎦᎵ	Februar
ᎠᎾᏱᎵᏒ	Mars (måned)
ᎹᏏ	Mars (planet)
ᎫᏬᏂ	April
ᎠᎾᏍᎬᏘ	Mai
ᏕᎭᎷᏱ	Juni
ᎫᏰᏉᏂ	Juli
ᎦᎶᏂ	August
ᏚᎵᏍᏗ	September
ᏚᏂᏃᏗ	Oktober
ᏅᏓᏕᏆ	November
ᎥᏍᎩᏱ	Desember
ᏢᏓᏥ ᎤᏃᏕᎾ	Løve
ᎩᏟ	Tamhund
ᎩᎵᏏᏲ	Storbritannia
ᏪᏌ	Tamkatt
ᏓᎶᏂᎨᏍᏛ	Folkerepublikken Kina
ᎠᏣᏗ	Fisk
ᏆᏏᎵ	Brasil
ᏲᏂᎢ	Russland
Cetacea	Hvaler
ᎠᏛᏥ	Tyskland
ᏇᎳᎷᏍ	Hviterussland
ᎠᏂᏛᏥ ᎦᏬᏂᎯᏍᏗ	Tysk
ᏧᏁᏍᏓᎸᎯ	Island
ᎡᏍᏙᏂᏯ	Estland
ᏌᏓᏂ	Saturn
ᏣᏥ ᎡᏙᎯ ᏊᏏ	George W. Bush
ᏳᎧᎴᏂ	Ukraina
ᏤᎩ ᏍᎦᏚᎩ	Tsjekkia
ᎹᎵᏙᏫᎠ	Moldova
ᎶᎹᏂᏯ	Romania
ᎹᏏᏙᏂᎢᎠ	Republikken Makedonia
ᎠᎵᏇᏂᏯ	Albania
ᎢᏤᎢᏳᏍᏗ ᎦᏙᎯ	Grønland
ᏆᏍᏂᏯ ᎠᎴ ᎲᏤᎪᏫᎾ	Bosnia-Hercegovina
ᎠᏏᎵᏆᏌᏂ	Aserbajdsjan
ᎠᏂᏙᎳ	Andorra
ᎧᏌᎩᏍᏔᏂ	Kasakhstan
ᎢᏂᏙᏂᏍᏯ	Indonesia
ᎠᏂᎬᎾ ᎧᏬᏂᎯᏍᏗ	Tyrkisk
ᎤᏍᏇᎩᏍᏖᏂ	Usbekistan
ᎠᎹ	Vann
ᎦᏃᏥ	Lær
ᎠᏓ	Treverk
ᏥᎵ	Chile
ᎹᎫᎵ	Merkur
ᎠᎾᏂᏍᏓᎾᎵ	Venus
ᎦᏬᏂᎯᏍᏗ	Språk
ᏧᏈᏓ	Jupiter
ᏳᏪᏅᏍ	Uranus
ᏁᏩᏚᏂ	Neptun (planet)
ᏡᏙ	Pluto
ᎠᏂᎶᎻ ᎦᏬᏂᎯᏍᏗ	Latin
ᎠᎵᎻᏂᎠ	Armenia
ᏒᏈᏯ	Serbia
ᎡᎳᏗᏜ	Australia
ᏘᏲᎭᎵ ᎡᏆ	Dinosaurer
ᏅᏩᏙ ᎯᏯᏛ	Fred
Star Wars	Star Wars
ᎴᎹᏂ	Sitron
ᏆᏁᎾ	Bananer
ᎦᏚᎲᎢ	By
Napoleon	Napoléon Bonaparte
ᏃᏈᏏ	Stjerne
ᏅᏓ	Solen
ᏅᏓ ᎠᎴ ᏚᏓᏕᏫᏍᏛ	Solsystemet
ᎦᏌᎧᎯᎨ ᎤᏃᎴ	Helium
ᎵᏘᎥᎻ	Litium
ᏇᎵᎵᎥᎻ	Beryllium
ᎪᏪᎵ	Bok
ᏒᏃᏱ	Natt
ᎤᎦᏔ ᏅᏓᏳᏓᎴᏅ ᏬᏗᎨ	Karbon
ᎾᎢᏠᏤᏂ	Nitrogen
ᏗᎧᏃᎩᏛ	Musikk
ᏩᎶᏫᏂ	Fluor
ᏥᏩᏩ	Chihuahua (delstat)
ᎦᏌᎧ ᏔᎷᎩᏍᎩ	Aluminium
ᎢᏂᏗᎢᎠ	India
ᏔᎷᎩᏍᎩ	Jern
ᏉᏔᏏᎥᎻ	Kalium
ᎪᎳ ᏗᏝᏂᎪᎯᏍᏗᏍᎩ	Kalsium
ᎦᏂ	Bly
ᎹᏂᎪᎵᎠ	Mongolia
ᏔᎢᏖᏂᎥᎻ	Titan (grunnstoff)
ᏩᏁᏗᎥᎻ	Vanadium
ᏐᏈᎵ	Hest
ᎦᏂᏝᎢ	Dyr
ᏉᎵᏫᎠ	Bolivia
ᎥᏣᏱ	Kobber
ᎩᎵᏣᎢᏍ	Kirgisistan
ᏩᎧ	Storfe
ᏔᏥᎩᏍᏕᏂ	Tadsjikistan
ᏉᎨᎼᏂ	Pokémon
ᏔᏯᎴᏂ	Thailand
ᎠᎢᎵᏗᏴᎻ	Iridium
ᏝᏘᏅᎻ	Platina
ᏧᎦᎾᏮ ᎪᎵᎠ	Sør-Korea
ᎠᏕᎸ ᏓᎶᏂᎨ	Gull
ᎠᏂᏉᎵᏍ	Polakker
Julius Caesar	Julius Cæsar
ᎤᏅᏉᎳᏛ	Regnbue
ᎠᏑᏫᏍᏗ	Farge
ᎠᏕᎸ ᎤᏁᎦ	Sølv
ᏔᎷᎩᏍᎩᏳᏍᏗ	Tinn (grunnstoff)
ᏳᏪᏂᎥᎻ	Uran
ᏡᏙᏂᎥᎻ	Plutonium
ᏁᏩᏚᏂᎥᎻ	Neptunium
ᏇᎵᎥᎻ	Barium
ᏍᏆᏂ ᎧᏬᏂᎯᏍᏗ	Spansk
Johann Sebastian Bach	Johann Sebastian Bach
ᎧᎿᏁᏍᎩ	Edderkopper
ᎠᏓᎵᏍᎩᏱᏍᎩ	Apekatter
ᎠᏕᎳ	Penger
ᏄᏯᎩ	New York (delstat)
ᏳᎳᏈᎥᎻ	Europium
Augustus	Augustus
Trajan	Trajan
ᏙᎩᏲ	Tokyo
ᏍᏆᏂᏤᏍᏛᎢ	New Mexico
ᎣᎦᎳᎰᎹ	Oklahoma
ᎩᎵᏏ ᎦᏬᏂᎯᏍᏗ	Engelsk
ᎠᎺᎵᏏᏯᎻ	Americium
ᎠᏔᏩ, ᎨᎾᏓ	Ottawa
ᎠᏤᏙ	Jakarta
Wikipedia:ᏃᏯᎭ ᎧᏁᏌᎢ	Wikipedia:Sandkasse
ᎤᏪᏴ	Elv
ᎠᎧᏔᏘ	Teleskop
ᎫᎵᏘᎦ	Curitiba
ᏌᎶᎵ	Ekorn
ᎠᏙᎯ ᎢᎾᎨ	Skog
ᎪᏈᏂ ᏌᎪᏂᎨ	Corbin Bleu
ᏧᏈᏓ (ᎤᏁᎳᏅᎯ)	Jupiter (gud)
ᏉᏧᎾ	Fortuna
ᏳᎳᏛ ᎠᏕᎳ	Euro
Category:ᎠᏂᎶᎻ ᎤᎾᏁᎳᏅᎯ	Kategori:Romerske guder
ᎡᏆ ᎦᏙᎯ	Kontinent
ᎯᎸᏍᎩ ᏥᏍᏆ	Fugler
ᏏᏅᏙ	Måned
ᎤᎵᎮᎵᏍᏗ	Portal:Forside
ᎤᎴᏍᏓᎸ	Vagina
ᎤᏬᎳᏨᎯ	Filosofi
Category:Candidates for speedy deletion	Kategori:Sider som er foreslått raskt slettet
ᎤᏔᏅ ᏗᎧᏃᎩᏍᏗ	Piano
ᏗᎧᏃᎩᏍᏗ	Gitar
ᎤᏬᏚ	Skjønnhet
ᏙᏒᏓᎵ	Maur
ᏩᏚᎵᏏ	Bier
ᏕᎭᎷᎨ ᎠᏓᏛᏍᎩ	Aubergine
ᎧᏬᏄ	Andefamilien
ᎤᏂᏥ	Mor
ᎤᎾᏥ	Snø
ᎠᏲᎵ	Barn
ᎠᎦᏍᎬ	Regn
Nelson Mandela	Nelson Mandela
ᏅᏯ	Bergart
ᎤᎶᎩᎸ	Sky
ᎠᎦᎷᎦ	Tornado
ᏗᏎᏍᏗ ᏓᏍᏓᏅᏅ	Geometri
Category:ᏗᎧᏃᎩᏛ	Kategori:Musikk
ᎬᏂᎨᏧᎵ	Rødrev
ᎧᏫ	Kaffe
ᎣᏓᎸᎢ	Fjell
ᎤᎧᏲᏗ ᎡᎶᎯᏱ	Ørken
ᏴᏩᏁᎬ Civil ᏓᏄᏩ	Den amerikanske borgerkrigen
ᏆᏍᎩ ᎦᏬᏂᎯᏍᏗ	Baskisk
Unicode/Cherokee	Unicode
ᎠᏂᏍᏫᏗ ᎦᏬᏂᎯᏍᏗ	Svensk
ᎥᎦᏔᎲᎢ	Kunnskap
ᎪᎵᎥ	Koreansk
ᎦᎴᎪ ᎦᏬᏂᎯᏍᏗ	Galisisk
ᏁᎵᏒ	Tanke
ᎠᎺᏉᎯ	Verdenshav
ᎠᏤᎷᎯᏍᏗ	Saksofon
ᏬᎾᎵᏗ ᏪᎦᏂ	Ronald Reagan
ᎠᏣᏅᏙ	Plasma
ᎠᎴᏂ	Bekasi
ᏏᏆ	Svin og griser
ᏚᎵᏍᏗ 11, 2001 ᏗᎦᏘᎸᏍᏗ	Terrorangrepet 11. september 2001
ᏡᎬ	Tre
ᎤᏅᏗ ᎦᏚᏅ	Ost
ᏖᎸᎳᏗ	Druer
ᏐᎯ	Nøtt
ᎠᎱᎵ	Tromme
ᏄᏓᎨᏒ (Gravitation)	Tyngdekraft
ᏧᏙ	Judo
ᎠᎾᎦᎵᏍᎩ ᎦᏂᏱᏍᎩ	Metall
ᎠᏥᎸ ᏔᎷᎩᏍᎩ	Stål
ᏗᎦᎶᎪᏗ	Landbruk
ᏎᎷ	Mais
ᎠᏍᏓᏩᏛᏍᏙᏗ	Frekvens
ᎠᏰᎵ ᏚᎾᏙᏢᏩᏗᏒ ᏙᎪᏪᎸ	Liste over stater
ᏲᎾ	Bjørnefamilien
ᏧᏍᎦ	Eikeslekten
ᎠᏂ	Hagejordbær
ᎧᏄᎦᎸ	Bjørnebær
ᏆᏅ	Fersken
ᎣᏂᏥ	Appelsin
ᎳᎢᎻ	Lime
ᎠᎵᎮᎵᏍᏗ ᎢᎦ	Thanksgiving
ᎦᏓᏘ	Flagg
ᎦᏍᎩᎶ	Stol
ᏗᎦᎵᏍᏚᎩᏍᎩ	Sjiraff
ᎹᏱᏕ	Nebbdyr
Queen	Queen
ᏗᎦᎭᎵ	Øgle
ᏫᎩᏇᏗᏯ:ᎾᎥ ᏄᎾᏓᎸ ᎾᎿᎢ	Wikipedia:Tinget
ᎠᏍᏘᏂ	Austin
ᎭᏫᎾᏗᏢ ᏗᏎᏍᏗ ᎤᎬᏩᎵ	Plan (matematikk)
ᎬᎾ ᎤᏔᎾ	Struts
ᎠᎺᎵᎨ ᎬᎾ ᎤᏔᎾ	Nanduer
ᏓᏂᏍᏓᏲᎯᎲ	Jul
Indo-European languages	Indoeuropeiske språk
ᏢᏓᏥᏧᎶᎸᏗ	Tiger
ᎠᏕᎵ	Adele (sangerinne)
ᎠᏫ	Hjortedyr
ᎤᏁᏍᏓᎳ	Is
ᎣᎩᏙᏓ ᎦᎸᎳᏗ ᎮᎯ	Fader vår
ᎦᎦᎹ	Agurk
ᏔᎹᏟ	Tomat
ᏎᎵᎾ	Selena
ᎵᎳ ᏙᏮᏍ	Lila Downs
ᏢᏓᏥ ᎠᎦᏣᏄᎳ	Gepard
Felidae	Kattefamilien
ᏑᎵ	Musvåk
Escherichia coli	Escherichia coli
ᎠᏐᎠᏍᏙ	Selfamilien
ᎠᏫᏳᏍᏘ	Antiloper
ᎤᏍᏗᏰᎬ	Hår
ᎠᏍᏛᎭᏟ	Sandwich
ᏥᏯ	Oter
ᏩᏂᎨ ᎠᏣᏗ	Manet
Pinnipedia	Seler
ᎭᏰᎳᏍᏗ	Kniv
ᏐᏈᎵ-ᏧᎶᎸᏗ	Sebra
ᏣᎳᎩ ᎧᏬᏂᎯᏍᏗ	Cherokesisk
ᎠᎹᏍᎧᎦᎯ	Foss
ᏣᏱ ᎤᏬᏗᎨ	Bronse
ᏩᎭᎧ	Oaxaca
ᎪᏢᏅ	Smør
ᏗᎧᏃᎩᏛ ᎬᏔᏂᏓᏍᏗ	Musikkinstrument
ᏌᏌ	Svaner
ᏅᏃᎯ	Vei
ᏝᏪᏆ	Vanlig flodhest
ᎾᏳ	Sand (materiale)
ᎫᏔᏍᏲᏍᏗ	Roseslekta
ᏢᏓᏥ ᎤᏅᏣᏗ	Leopard
ᎠᏂᎪᎢ ᎤᏂᏃᎮᎸᎯ	Gresk mytologi
ᎠᎺᎵᎨ ᎤᏂᎬᏫᏳᎯ	Liste over USAs presidenter
ᏓᏎᏘ	Speil
ᏢᏓᏥ	Puma
ᎠᏩᎶᏓᎢᏘ	Afrodite
ᎤᏍᏔᎦᎳᏱ	Grotte
ᎠᎺᎵᎨ ᏢᏓᏥ ᎤᏅᏣᏗ	Jaguar
ᎪᏩᎳ ᏲᎾ	Koala
ᎤᎶᎩᎸ ᏢᏓᏥ	Treleopard
ᎠᏍᎩᏘᏍᏗ	Drøm
ᏥᏍᏕᏥ	Rotter
ᎠᏂᎪᎢ ᎧᏬᏂᎯᏍᏗ	Nygresk
ᎠᏂᏃᎯᎵᏙᎲ	Jakt
ᎠᏉᎳ	Apollon
ᎬᎩᏍᏗ	Vannmelon
ᎤᎬᏫᏳᎯ ᎡᏆ	Keiser
ᎪᎱᏍᏗ ᎬᏔᏂᏓᏍᏗ	Verktøy
ᏣᏱ	Messing
ᎤᎨᏓᎵᏴ	Dal
ᏗᏑᏫᏍᎩ ᎡᏆ	Hvalross
ᎭᎹᏏ	Hermes
ᏧᎾᏓᏱᎵᏓᏍᏗ	Domstol
ᏚᏯ	Hagebønne
ᎠᏂᏨᎹᏂ	Engelskmenn
ᎠᎵᏍᏕᎸᏙᏗ ᎠᏕᎸ ᎬᏗ	Finans
ᏩᎴᎳ	Kolibrier
ᎬᎾ	Kalkuner
ᎠᏂᏳᎧᏪᏂ	Ukrainere
ᎤᎦᏔ	Lin
The Doors	The Doors
ᎠᏂᏣᏍᎩᎵ	Spøkelse
ᎠᏂᏔᎢᏖᏂ	Titaner
ᏑᏏ	Sushi
ᏐᏃᎳ	Sonora
ᎤᏪᏴᎢ	Bekk
ᏙᏯ	Bevere
ᏫᎾᏏ	Venus (gudinne)
ᎤᏯᏍᎦᎳ	Beltedyr
Template:Commonscat	Mal:Commonscat
ᏧᎴᎯᏌᏅᎯ	Fugl Føniks
ᎠᏂᏲᎾ	Russere
Dire Straits	Dire Straits
ᏓᎬᎾ ᏥᏳ ᏗᏔᎳᏗᏍᏗ ᏚᎦᏘᎸᏒᎢ	Angrepet på Pearl Harbor
Template:Taxobox	Mal:Taksoboks
ᏩᎶᏏ	Springpadder
ᏧᎵᏍᏓᎾᎵ	Maller
ᏳᎧᏔᏂ	Yucatán (delstat)
ᎭᏩᏱ ᏗᎧᏃᎩᏍᏗ	Ukulele
ᎬᎪᏩᏛᏗ ᏗᎧᏃᏗ	Visuelt spektrum
Morse ᎠᏍᏓᏩᏛᏍᏙᏗ	Morsealfabetet
ᏳᏪᏅᏍ (ᎤᏁᎳᏅᎯ)	Uranos
ᏩᏓᏚᎦ	Øyenstikkere og libeller
ᎠᎳ ᏊᎦᏦᏩ	Alla Pugatsjeva
ᎦᏃᎸᏍᎩ ᎠᎦᏍᎩ	Storm
ᎦᏩᏒᎩ	Melon
ᎠᏂᏍᏆᏂ (ᎧᏃᎮᎭ)	México (delstat)
ᏝᏍᎧᎳ	Tlaxcala
ᏓᏫᏍᎦᎳ	Flint
ᏓᏬᎵ	Fruktlegeme
ᏐᏈᎵ-ᎠᏍᎦᏯ	Kentaur
ᏗᎳ	Stinkdyrfamilien
Carl Menger	Carl Menger
Template:Cite book	Mal:Kilde bok
ᎦᏯ	Gaia
ᎡᎳᏗᏝ ᎬᎾ ᎤᏔᎾ	Emu
ᎠᎹᏳᎸᏗ	Kyst
ᏣᎳᎩ	Cherokee
ᎠᏂᎾᏩᎰ	Navajo
Uriah Heep	Uriah Heep
ᏗᏂᏃᎨᏂ	Gevær
ᏧᏃ (ᎤᏁᎳᏅᎯ)	Juno
ᏌᏆᏯ	Safir
ᎠᏍᏆᏂᎪᏒᏗ ᏂᎦᎵᏍᏔᏂᏙᎲ	Fyrverkeri
Panthera	Brølekatter
ᎠᏥᎾ	Sederslekten
ᏢᏕᎦ	Ålefisker
ᏋᏏᎥᏍ	Persevs
ᏓᎾᎵᏍᏓᏴᎲᏍᎬ	Festival
ᏓᏰᏂ	Diana (gudinne)
ᎠᏂᎲᏂᎦᎵ	Madjarere
ᎬᏙ ᎾᏍᏅᏏ	One Direction
ᏃᏥᏳᏍᏗ ᏒᎦᏔ	Ananas
ᎤᎬᏫᏳᎯ ᎡᏆ ᏇᏠ II	Pedro II av Brasil
ᎾᏍᎦᏅᎾ	Dyd
Inachis io	Dagpåfugløye
ᏤᏊᎳᏍᎧ	Tsjeburasjka og Krokodillen Gena
ᎠᏂᏕᏂ	Dansker
ᎠᏂᏍᏫᏗ	Svensker
ᏭᏕᎵᎬ	Solnedgang
ᏌᎪᏂᎨ ᏣᎴᎩ	Blue Ridge Mountains
ᎤᏁᎫᎯᏍᏗ	Majones
ᏓᏆ	Bardehvaler
ᎠᏂᏫᏂ	Finner
ᎢᎣᎷ	Aiolos
ᎾᎥ ᏄᎾᏓᎸ	Gemeinschaft
ᏪᏍᏔ (ᎤᏁᎳᏅᎯ)	Vesta (gudinne)
ᎠᏂᏍᎧᏥ	Skotter
ᎠᎺᏉ ᎠᎨᏴ	Havfrue
Rita Levi-Montalcini	Rita Levi-Montalcini
ᏧᎳ	Ekte rever
ᎠᏂᏃᏫᏥᏂ	Nordmenn
ᎠᏂᎤᏁᏍᏓᎳ	Islendinger
ᎡᏆ ᎠᎺᎵᎨ ᎬᎾ ᎤᏔᎾ	Stornandu
ᎠᏂᏛᏥ	Nederlendere
Tigranes the Great	Tigranes I av Armenia
ᎭᏯᏏᏂ	Hyakinthos
ᎶᏃᎶᏃ	Rongorongo
ᎤᏁᎳᏅᎢᎤᏪᏥ	Amazing Grace
ᎤᏯᏍᎦ	Konkylie
ᎠᎺᏉᎯ ᎤᏁᏍᏓᎳ	Sjøis
Ayyavazhi	Ayyavazhi
ᎠᏅᎬᏂ	Anggun
ᎤᎵᎾᏫ	Skilpadder
ᏓᎦᎦ	Klegger
ᎢᏃᎵ	Amerikansk grevling
ᎠᏂᏓᏪᎯ	Engel
ᎠᏂᎡᏍᏙᏂᎠᏂ	Østerrikere
ᎪᎷᏩᏛᎲ ᎢᎬᏁᏗ	Patent
Neofelis	Treleoparder
ᏗᎭᏄᎧᎯ	Julenissen
Anthocharis cardamines	Aurorasommerfugl
Delias eucharis	Delias eucharis
ᎠᏓᏍᏕᎸᏗ	Nestekjærlighet
ᏴᏩᏁᎬ ᏥᏉᏉ	Vandretrost
ᎠᏂᏇᎳᎷᏍ	Hviterussere
ᏈᎵᎩ ᎩᎵᎪᎶᏫ	Filipp Kirkorov
ᎠᏂᎪᎢ	Grekere
ᎬᎮ	Ekte gauper
ᏕᎦᏃᏣᎸ	Telegrafi
Struthioniformes	Strutsefugler
ᎬᎿᎨ ᏎᏗ	Svart valnøtt
ᎠᏂᎢᏤᎢᏳᏍᏗ	Kalaallit
ᎧᏁᏨᎢ	Stemmeseddel
ᏥᏍᏛᎾ	Langhalekreps
ᎢᏤ ᎢᏳᏍᏗᎤ ᏪᏴ	Green (Utah)
ᎠᏫᏒᏅ	Hage
ᎡᎩᏁᏍ ᎹᏂᎧ	Agnes Monica
Category:ᎠᎹᏰᏟ	Kategori:USA
Category:ᎨᎾᏓ	Kategori:Canada
Category:ᏥᏍᏆ	Kategori:Fugler
Category:Plantae	Kategori:Planter
Category:ᎧᏃᎮᏍᎩ	Kategori:Historie
Category:ᎤᎾᏙᏢᎯ	Kategori:Samfunn
Category:ᏗᏛᎪᏔᏅ	Kategori:Kommunikasjon
Category:ᎡᎶᎯ	Kategori:Jorden
Rathinda amor	Rathinda amor
Dryas iulia	Dryas iulia
ᏬᎭᎵ	Ørner
ᎠᎳᏍᏚᎶ	Turban
ᏧᎾᎦ	Ørret
Category:Stub	Kategori:Stubber
Category:ᎡᏆ ᎦᏙᎯ	Kategori:Kontinenter
Category:ᎠᏰᎵ ᏚᎾᏙᏢᏩᏗᏒ	Kategori:Land
Category:ᎠᎾᎵᏏᎾᎯᏍᏗᏍᎩ	Kategori:Nasjonaløkonomi
Wikipedia:Administrators	Wikipedia:Administratorer
Category:ᎠᏂᏴᏫ	Kategori:Personer
Category:ᎤᏁᎳᏅ ᎤᏬᏢᏅ	Kategori:Natur
Category:ᎠᏕᎸ	Kategori:Penger
Template:Bot	Mal:Bot
Wikipedia:What Wikipedia is not	Wikipedia:Hva Wikipedia ikke er
ᎨᎾᏓ	Canada
Category:ᏳᎳᏛ	Kategori:Europa
Template:Documentation	Mal:Dokumentasjon
Wikipedia:Neutral point of view	Wikipedia:Objektivitet
Wikipedia:Vandalism	Wikipedia:Vandalisme
ᏗᎦᎸᏫᏍᏓᏁᏗ	Næringsliv
Template:Softredirect	Mal:Softredirect
Template:Delete	Mal:Hurtigsletting
ᎹᏱᎩᎵ	Michael
Category:ᎦᏬᏂᎯᏍᏗ	Kategori:Språk
Category:ᏫᎩᏇᏗᏯ	Kategori:Wikipedia
Wikipedia:TROLL	Wikipedia:Hva er et troll?
Template:Navbox	Mal:Navboks
Template:Nutshell	Mal:Nøtteskall
Template:!	Mal:!
Template:Clear	Mal:Clear
Template:Col-break	Mal:Col-break
Template:Col-begin	Mal:Col-begin
Template:Col-end	Mal:Col-end
Template:Bots	Mal:Bots
Template:Anchor	Mal:Anchor
Category:ᎬᎿᎦᏍᏛ	Kategori:Afrika
Category:ᏗᎪᏪᎵ	Kategori:Bøker
Template:Babel-3	Mal:Babel-3
Template:Babel	Mal:Babel
Template:Commons	Mal:Commons
Template:Reflist	Mal:Referanser
Wikipedia:Searching	Hjelp:Søking
Template:Stub	Mal:Stubb
Template:User af-1	Mal:Bruker af-1
Template:User eo-1	Mal:Bruker eo-1
Template:User da	Mal:Bruker da
Template:User da-1	Mal:Bruker da-1
Template:User eo-3	Mal:Bruker eo-3
Template:User de	Mal:Bruker de
Template:User de-1	Mal:Bruker de-1
Template:User et-1	Mal:Bruker et-1
Template:User el	Mal:Bruker el
Template:User es	Mal:Bruker es
Template:User en-3	Mal:Bruker en-3
Template:User en-1	Mal:Bruker en-1
Template:User en-2	Mal:Bruker en-2
Template:User eo-2	Mal:Bruker eo-2
Template:User en-4	Mal:Bruker en-4
Template:User en	Mal:Bruker en
Template:User de-2	Mal:Bruker de-2
Template:User fr-1	Mal:Bruker fr-1
Category:ᎥᎴᏂᏙᎲ	Kategori:Livet
Template:User ia-2	Mal:Bruker ia-2
Template:User io-3	Mal:Bruker io-3
Template:User ja-4	Mal:Bruker ja-4
Template:User sk	Mal:Bruker sk
Template:User fr-2	Mal:Bruker fr-2
Template:User ja	Mal:Bruker ja
Template:User ja-1	Mal:Bruker ja-1
Template:User fr	Mal:Bruker fr
Category:ᏨᏍᎪᏱ	Kategori:Insekter
Category:ᏓᎶᏂᎦᏍᏛ	Kategori:Asia
Category:ᏧᎦᎾᏮ ᎠᎹᏰᎵ	Kategori:Sør-Amerika
Category:User uk-N	Kategori:Bruker uk-N
Template:Esoteric	Mal:Komplisert mal
Template:Mod	Mal:Mod
Template:User sv	Mal:Bruker sv
Template:User uk	Mal:Bruker uk
Template:User es-2	Mal:Bruker es-2
Template:Tsilugi	Mal:Reg-velkommen
Template:Wikipediasister	Mal:Søsterprosjekt
Category:User fr-1	Kategori:Bruker fr-1
Template:Wikiquote	Mal:Wikiquote
Template:Image label	Mal:Image label
Category:User en-4	Kategori:Bruker en-4
Category:User en	Kategori:Bruker en
Template:Ombox	Mal:Pmboks
Category:ᎠᎵᏍᏓᏴᏗ ᎠᎴ ᎠᏗᏔᏍᏗ	Kategori:Mat og drikke
Template:Pp-template	Mal:Beskyttet side
Template:Wiktionary	Mal:Wiktionary
Template:Multi-listen start	Mal:Multi-listen start
Category:ᏗᎦᎶᎪᏗ	Kategori:Landbruk
Template:Babel-4	Mal:Babel-4
Template:Babel-5	Mal:Babel-5
Template:Babel-2	Mal:Babel-2
Template:Babel-6	Mal:Babel-6
Template:Babel-1	Mal:Babel-1
Template:Ethnic group	Mal:Infoboks folk
Template:Namespace detect	Mal:Namespace detect
Template:User nl	Mal:Bruker nl
Template:User no-2	Mal:Bruker no-2
Template:Documentation subpage	Mal:Dokumentasjonsunderside
Template:Userpage	Mal:Brukerside
Template:Image label small	Mal:Image label small
Template:Mbox	Mal:Mbox
Category:User ja-N	Kategori:Bruker ja-N
Category:User chr	Kategori:Bruker chr
Category:User sk	Kategori:Bruker sk
Category:User eo	Kategori:Bruker eo
Category:User fr	Kategori:Bruker fr
Category:User gl	Kategori:Bruker gl
Category:User ja	Kategori:Bruker ja
Category:User sv	Kategori:Bruker sv
Category:User fr-N	Kategori:Bruker fr-N
Category:User gl-N	Kategori:Bruker gl-N
Category:Wikipedia cleanup	Kategori:Opprydning
Category:User chr-1	Kategori:Bruker chr-1
Category:User sk-N	Kategori:Bruker sk-N
Category:User de	Kategori:Bruker de
Category:User de-2	Kategori:Bruker de-2
Category:User en-3	Kategori:Bruker en-3
Category:User en-N	Kategori:Bruker en-N
Category:User es	Kategori:Bruker es
Category:User es-2	Kategori:Bruker es-2
Category:User es-N	Kategori:Bruker es-N
Template:Adminbox	Mal:Administrator
Category:ᎠᎪᏩᏏᏗ	Kategori:Syn
ᏫᎩᏇᏗᏯ:Babel	Wikipedia:Babel
Template:User sv-1	Mal:Bruker sv-1
Category:ᎠᏂᎪᎢ ᎤᎾᏁᎳᏅᎯ ᎠᏂᎨᏴ	Kategori:Greske gudinner
Category:ᎠᎹ	Kategori:Vann
Template:User ko-3	Mal:Bruker ko-3
Category:User sv-N	Kategori:Bruker sv-N
Template:User zh-2	Mal:Bruker zh-2
Template:Multi-listen end	Mal:Multi-listen end
Category:ᎠᎾᎵᏖᎸᎲᏍᎬ ᎦᏁᏰᎩ	Kategori:Vold
Category:ᏧᏓᎴᏅᏓ ᎫᎵᏍᏔᏅ ᏑᏓᎴᎩ	Kategori:Grunnstoffer
Template:User de-4	Mal:Bruker de-4
Category:ᎠᏣᏗ	Kategori:Fisk
Category:ᎤᎾᏓᏔᏅ ᎠᎩᏍᏗ	Kategori:Frukt
Category:ᏙᏯᏗᎳ ᏄᏍᏗᏓᏅ	Kategori:Klima
Category:Animalia	Kategori:Dyr
Category:ᎠᏂᎪᎢ ᎤᏂᏃᎮᎸᎯ	Kategori:Gresk mytologi
Category:ᎠᏂᎩᏍᏙᏗ	Kategori:Transport
Category:ᏧᏴᏢ ᎠᎹᏰᎵ	Kategori:Nord-Amerika
Category:ᎠᏥᎳ	Kategori:Ild
Category:ᏗᎧᏃᏗ	Kategori:Farge
Template:Image label begin	Mal:Image label begin
Category:User en-1	Kategori:Bruker en-1
Category:User de-1	Kategori:Bruker de-1
ᎧᎹᎹ (ᏨᏍᎪᏱ)	Rhopalocera
Template:Multi-listen item	Mal:Multi-listen item
Special:RecentChanges	Spesial:Siste endringer
Module:HtmlBuilder	Modul:HtmlBuilder
