Mo'hetaneho'e	Afrika
Norway	Norge
Ireland (Republic)	Irland
Spain	Spania
United States	USA
Poland	Polen
Lithuania	Litauen
Italy	Italia
Switzerland	Sveits
Austria	Østerrike
Turkey	Tyrkia
Héesevo'tamahpe	Øl
Hóxovê-hooma	Europa
Asia	Asia
Wikipedia	Wikipedia
Netherlands	Nederland
Vášêtaëno	Washington, D.C.
San Francisco	San Francisco
Los Angeles	Los Angeles
Tséohketoetanóto	Datamaskin
Netse Ôhmo'ôhtávaestse	Barack Obama
Má'xeme	Epleslekten
Paris	Paris
Mé'šeeséve'ho'évenó	Mexico
California	California
Péhpe'énanóse'hame	Løve
France	Frankrike
Oeškese	Tamhund
United Kingdom	Storbritannia
China (People's Republic of China)	Folkerepublikken Kina
Manestôtse	Alkoholholdig drikke
Russia	Russland
Ma'evé'ho'éno	Tyskland
Ame'hahtôtse'	Fly
Ukraine	Ukraina
Czechia	Tsjekkia
Slovakia	Slovakia
Slovenia	Slovenia
Roma	Roma
Croatia	Kroatia
Wolfgang Amadeus Mozart	Wolfgang Amadeus Mozart
Mo'hetaneho'e hánêsóvóne	Sør-Afrika
Mahpe	Vann
Chile	Chile
Serbia	Serbia
Taa'é-eše'he	Månen
Tsésáa-nanóhehane ame'hahtôtse	Uidentifisert flygende objekt
Vé'ôhkêheóvemá'xeme	Sitron
Vóhka'émene	Bananer
Hotohke	Stjerne
Éše'he	Solen
Chihuahua	Chihuahua (delstat)
Tonga	Tonga
Nauru	Nauru
Mo'éhno'ha	Hest
Hova	Dyr
Kokêhéaxa	Tamhøns
Arizona	Arizona
Amérika	Amerika
Utah	Utah
Republic of China	Republikken Kina
Ma'aataemeo'o	Jernbanetog
Vietnam	Vietnam
Véhone-ma'kaata	Gull
Tanzania	Tanzania
Zambia	Zambia
Zimbabwe	Zimbabwe
Republic of the Congo	Republikken Kongo
Democratic Republic of the Congo	Den demokratiske republikken Kongo
Madagascar	Madagaskar
Malawi	Malawi
Namibia	Namibia
Julius Caesar	Julius Cæsar
South Dakota	Sør-Dakota
Ho'honáéšé'e	Montana
Wyoming	Wyoming
Nevada	Nevada
Colorado	Colorado
Tseohke-pano'ohe	Syltetøy
Category:Wikipedia content	Kategori:Kategorier
Chicago	Chicago
Mene	Frukt
Mákohe	Apekatter
Meškêso	Insekter
Amâho'hestôtse	Bil
Toháano'ého'ëva	Texas
Buenos Aires	Buenos Aires
Barcelona	Barcelona
Ma'xeé'ome'tää'e	Mississippi (elv)
Caracas	Caracas
Nebraska	Nebraska
Kansas	Kansas
Heévȧhetanéno	Oklahoma
Ma'heónemôxe'êstoo'o	Bibelen
Ho Chi Minh City	Ho Chi Minh-byen
Dong Hoi	Dong Hoi
Concepción	Concepción
Še'šenovôtse	Slanger
Madrid	Madrid
Santiago (Chile)	Santiago de Chile
Mé'hahtsékósa	Geit
Ho'ësta	Ild
Antofagasta	Antofagasta
Brazzaville	Brazzaville
Copiapó	Copiapó
Moxe'estonemaheo'o	Skole
Oomâhóoné-mâhéó'o	Hus
Ó'he'e	Elv
Eschweiler	Eschweiler (Rheinland)
Dong Hoi Airport	Dong Hoi lufthavn
Curitiba	Curitiba
Talca	Talca
Corbin Bleu	Corbin Bleu
Vôhe'so	Fuglerede
Ve'kese	Fugler
Almazán	Almazán
Va'ohtama	Portal:Forside
Hohtsemo	Basketball
Ho'honáá'e Tsé'amoo'êse	Rocky Mountains
Category:Candidates for speedy deletion	Kategori:Sider som er foreslått raskt slettet
Véhpotséhohpe	Te
Axenôhonestôtse	Gitar
Hotohke tséana'ôhtse	Meteoroide
Mâhtovoo'ôtse	Øre
Kosa	Tamsau
Pa'e'pa'onáhe	Kameler
Tsêhe'êseeséhe	Elefanter
Háhnoma	Bier
Hésta'se	Snø
Ka'êškone	Barn
Kóhkonêhëö'o	Brød
O'êhnémâhéó'o	Toalett
Nelson Mandela	Nelson Mandela
Vo'e	Sky
Ma'xêhevovetäso	Tornado
Mahpe hevovetäso	Tropisk syklon
Category:Némenestôtse	Kategori:Musikk
Mó'soonêó'he'e	Arkansas (elv)
Ma'êhóóhe	Rødrev
Mo'ôhtávêhohpe	Kaffe
Matana	Melk
Bilbao	Bilbao
Sevilla	Sevilla
Valencia	Valencia
No'kéeho	Ekornfamilien
Ronald Reagan	Ronald Reagan
Ma'xetoeneško	Karlsvognen
Éškôseeséhotame	Svin og griser
Hoohtsêstse	Tre
Hohpâháa'éheme	Druer
Háhnomápano'êhasëö	Honning
Aéstomemésêhestôtse	Potet
Vé'keemahpe	Sukker
Hóo'xevávôxe'êstoo'o	Avis
Aseéestsestôtse	Telefon
Lugo	Lugo
Onéhavo'e	Tromme
Amo'a'óvâhtsestôtse	Sykkel
Vóhpeeva	Bomull
Môxe'êstoo'o	Papir
Ová'kemâhaemenôtse	Mais
Náhkohe	Bjørnefamilien
Hoéstoneéše'he	Kalender
E'kôsé'haseo'o	Crêpe
Hóxovôho'o	Bro
Jalisco	Jalisco
Hohpâhtsenámenôtse	Rosin
Tsétóno	Iskrem
Vé'keekóhkonôhëö'o	Småkaker
Vé'keahonoo'o	Kake
Asêséoneo'amestôtse	Sprettert
Santiago de Compostela	Santiago de Compostela
Oviedo	Oviedo
Heškóvemata	Kaktusfamilien
Hoohëö'o	Flagg
Táxemésêhestôtse	Bord (møbel)
Heóvâhá'enëö'o	Brødrister
Táxe'êséestôtse	Stol
Tsêhe'êsenotováhe	Sjiraff
Nuevo León	Nuevo León
Freddie Mercury	Freddie Mercury
Denver	Denver
Austin (Texas)	Austin
Naa'émâhéó'o	Sykehus
Sacramento	Sacramento
Vonomóhtâhestôtse	Acetylsalisylsyre
Hó'nehe	Ulv
Bien Hoa	Bien Hoa
Manëhe	Pelikaner
Nha Trang	Nha Trang
Breinigerberg	Breinigerberg
He'kone'éemâsono	Makaroni
Vung Tau	Vung Tau
Aruba	Aruba
Mo'kêhanôtse	Sko
Hestaahtsémeno	Ripser
Váótséva	Hjortedyr
Má'ome	Is
Heškóvemâhöö'o	Agurk
Xaóenêhéstâhévo	Vanlig løk
Moshchena	Mosjtsjena
Mérida (Venezuela)	Mérida (Venezuela)
Ho'ose	Kull
Vé'kêséhemêstaa'e	Ugler
Ca Mau	Ca Mau
Poeso	Kattefamilien
Curaçao	Curaçao
Tôhohko	Hammer (redskap)
Tâhpe'âséhahnoma	Humler
He'haéheséeo'ôtse	Ryllik
Vó'ho'kâsénoma'ne	Lysbiller
Tsêhe'êsevotoná	Fasan
Sint Maarten	Sint Maarten
Heo'këso	Bisam
Héna'e	Kanadagås
Sósone'e	Shoshone
Mâhóomoehá-vé'késo	Måker
Ôhtaenémâhéó'o	Hotell
Mâhpé-aénohe	Gråmåke
Hevavâhkema	Sommerfugler
Méšenonetsénóne	Flaggermus
Tsé-tó'hovane	Sandwich
Kingdom of the Netherlands	Kongeriket Nederlandene
Heóvêstséávó'êstse	Løvetannslekta
Ónonevóneške	Præriehunder
Avril Lavigne	Avril Lavigne
Hoéstónéó'o	Kalkulator
Motšêške	Kniv
Nêškovávo'ha	Sebra
Tsêhesenêstsestôtse	Cheyenne (språk)
Vóhpenáhkohe	Isbjørn
Oaxaca	Oaxaca
Heóveamêške	Smør
Meo'o	Vei
Anastacia	Anastacia
Henenó'e	Roseslekta
Albuquerque	Albuquerque
Tequixquiac	Tequixquiac
Ma'xepóno'e	Oklahoma City
Môxe'êstóonémâhéó'o	Postkontor
Nanóse'hame	Puma
Mâhpémo'éhe	Elg
Vo'kome-mâheo'o	Det hvite hus
Boise	Boise
Semo	Båt
Thanh Hoa	Thanh Hoa
Puerto Montt	Puerto Montt
Mo'otsenahkohe	Brunbjørn
Toóneohëö'o	Spiker
Ma'aataéve'éxanéstotôtse	Briller
Tono'sëö'o	Kjøleskap
Ka'énêhótame	Engelsk bulldog
Éškôsénéhe	Greyhound
Nêxo'mévéhe	Vannmelon
Vótâháéno tsénéma'ó'á'ha	Vindmølle
Péhpe'éoeškëso	Puddel
Hóhkeehe	Mus (slekt)
Heséeotséve'ho'e	Lege
Ma'o'hoáá'e	Murstein
Tó'too'he	Kongeørn
Môxe'a'xémâhéó'o	Kino
Ma'xêheóvema'xemeno	Grapefrukt
Hohpe	Suppe
Hovéo'kôheo'	Paraply
Talcahuano	Talcahuano
Šéeše-stôtse	Seng
Ma'emonêškeho	Hagebønne
Tsé-éškôsa'évetováto	Kjegle
Péhpe'épóéso	Perser
Johnny Cash	Johnny Cash
Homôse-mâheo'o	Kjøkken
Ma'xeamóvôhtó'hestôtse	Lastebil
Háestôheóhtáhe	Skolopendere
Vótâháéno	Brønn
Hotóa'ôxhoo'êstse	Sitting Bull
Ma'kaataevé'késo	Kolibrier
Ma'xêhë'ne	Kalkuner
Ó'kôhóme	Prærieulv
Jim Morrison	Jim Morrison
Sonora	Sonora
Guanajuato	Guanajuato (delstat)
Ma'kaatohko	Bøtte
Móxêšéne	Mynteslekta
Héne'enovâhétane	Student
Hahpenó'estôtse	Symaskin
Mo'ôhtameöhtsêstse	Afrikansk-amerikanere
Coahuila	Coahuila
Baja California	Baja California
Ȧxeohōva	Maller
Chiapas	Chiapas
Guerrero	Guerrero
Yucatán	Yucatán (delstat)
Colima	Colima
Morelos	Morelos
San Luis Potosí	San Luis Potosí
Sóhkomevó'ho'kâsenestôtse	Levende lys
Querétaro	Querétaro (delstat)
Michoacán	Michoacán
Durango	Durango (delstat)
Nayarit	Nayarit
Puebla	Puebla
Aguascalientes	Aguascalientes
Tamaulipas	Tamaulipas
Quintana Roo	Quintana Roo
Sinaloa	Sinaloa
Zacatecas	Zacatecas
Alla Pugacheva	Alla Pugatsjeva
Hidalgo	Hidalgo
Campeche	Campeche
Tabasco	Tabasco
Monterrey	Monterrey
Ma'xeméstaa'e	Amerikahubro
Tlaxcala	Tlaxcala
Hotoa'e	Amerikansk bison
Xäö'o	Stinkdyrfamilien
Grand Theft Auto: San Andreas	Grand Theft Auto: San Andreas
Háhkota	Gresshopper
Môhtséheonetane	Apache
É'koo'óhtotôtse	Kikkert
Sena'kaneo'o	Cherokee
Jaltenco	Jaltenco
Óova'e	Glimmer
Vétapâhaetó'eo'o	Kiowa
Šé'šenovotsétaneo'o	Comanche
Matšeškome	Vanlig vaskebjørn
Mo'ôhtáenáhkohe	Amerikansk svartbjørn
Hohtâhé-noma'he	Gullfisk
Vóaxáa'e	Hvithodet havørn
Tónovâhonónestôtse	Stekepanne
Nêševâhá'eneo'o	Mikrobølgeovn
Ame	Pemmikan
Tamena'éveéstse'he	T-skjorte
Mohkave	Rødgaupe
Ta'ta'ôhëö'o	Nøkkel
Grand Theft Auto	Grand Theft Auto
Vée'e	Tipi
Vé'ho'êškóovo'hestôtse	Synål
Vétánó'êstse	Bred dunkjevle
Oó'omêše	Rødeik
Tsé'amóneane	Gjerde
Onéma'ó'aneo'o	Nøkkelverktøy
Vé'ôhkemahpe	Red (elv)
Otá'tavö'êstse	Lusern
Heóvemo'ôhta'e	Kålrot
Pachuca de Soto	Pachuca de Soto
Onéma'táo'aneo'o	Skrutrekker
Me'êškema	Negundo
Menôtse	Virginiahegg
Hoóxe'e	Vrifuru
Pó'po'êho'hémâhaemenôtse	Popkorn
Hoxo'ôhtséveotá'tavo'honáá'e	Turkis (edelsten)
Hevéesénoma'ne	Gjedde
É'êxováhtóva	Billings
Vé'ho'éome	Telt
Vóhpâhtse-náhkohe	Grizzlybjørn
Hoeseonó'e	Madrass
Xamaesémo	Kano
Môxéhéó'o	Sopelime
Veracruz	Veracruz (by)
Tootómôhéó'o	Klimaanlegg
Ho'êstásémo	Dampskip
Tséx-háenaotséstove	Spanskesyken
Mo'éhe	Wapiti
Vóetséna'évôxe'êstónestôtse	Kritt (bergart)
Heškóvoneanëö'o	Piggtråd
Hova'ó'xestôtse	Sal (dyr)
Vé'ho'éotóaho'évohkôtse	Storfekjøtt
Hevá'xameško	Øse
Ma'xeamâho'hestôtse	Varebil
Otá'tavâho'hé-vé'késo	Blåskrike
Mo'e'évôhkêha'e	Stråhatt
Âxeetoo'é'hasëö'o	Fiskekrok
Tsé'ôhke-énâhenéstove	Bensinstasjon
Ama'éno'hamémôxe'êstoo'o	Førerkort
Nøtterøy	Nøtterøy
Tôhé'kêsaéve'ho'éamo'eétâhestôtse	Rodeo
Háeohémahpe	Rapid City
Tooxo'hamëso	Shetlandsponni
Hesto'tono'kêhanôtse	Truger
Amóvôhtó'hestôtse	Pickup (bil)
Hoóneanatóe-vó'ho'kâsénâhnestôtse	Parafinlampe
Oómêsta'hasené-váótséva	Hvithalehjort
Séavóneške	Skogmurmeldyr
Ma'ëno	Skilpadder
Ma'evé'éso	Kardinaler
Nêhpo'aneo'o	Lås
Apaxco	Apaxco
Ma'háhko'e	Amerikansk grevling
Asêséeéstse'he	Genser
Vó'ho'êho'hóvahtôtse	Lommelykt
Mo'ôhtávo'honáéva	Black Hills
Sáhea'eo'o	Ojibwa
Oo'kó'êxovahtôtse	Plenklipper
Kóhkonôheonané-mâhéó'o	Bakeri
Hestóhkáhne	Paddeiguaner
Tsétsêhéstâhese	Cheyenne (folk)
Ne'potátse	Herodiashegre
Hoxomôho'haméstotôtse	Høy
Mo'éheo'hé'e	Yellowstone (elv)
Monêškeho	Bønne
Ben Harper	Ben Harper
Mo'ôhtávêhahtátaneo'o	Blackfoot Confederacy
Amo'xestôtse	Camping
Ma'êšenévé'késo	Vandretrost
Buffy Sainte-Marie	Buffy Sainte-Marie
A'o'tsémêstaa'e	Graveugle
Mâhöhko	Cantaloupe
Hesó'xôhéó'o	Strykejern
Aésto'épeeneo'o	Blender (redskap)
Vé'evêšéstótó'e	Juniperus scopulorum
Hesó'xêšé'hóno	Duk
Heškóvêstséávó'êstse	Tistel
Ma'xêhestâhtötse	Lyoner
Jimmy Carl Black	Jimmy Carl Black
Ma'xemené-mahpe	Eplemost
He'hemêšéonávo'ha	Appaloosa
Hetanevö'e	Arapaho
Aéstomevé'keemahpe	Kunstig søtningsstoff
Meneo'hé'e	Platte (elv)
Vó'aehno'xâhtóhonôtse	Leggings
Mo'ôhtáevánó'êstse	Beiskambrosia
Mö'ôhvovó'haestse	Big Foot
Nextlalpan	Nextlalpan
Heovese'tahe	Bomullshalekaniner
Ho'néhetane	Pawnee
Môhtáevestôtse	Campingplass
Otaesémenôtse	Svart valnøtt
Méstahke	Megascops
Mâhtä'soeo'hé'e	Green (Utah)
Vó'komêšéstótó'e	Fjelledelgran
Hotóao'hé'e	Cimarron (elv)
Otaesétaneo'o	Nez Perce
Tsé'ôhkê-hóhta'hanéstove	Tinghus
Ónonevonêške-móxêšéne	Tunbalderbrå
Mo'éhno'hamémâhéó'o	Løe
Atlacomulco	Atlacomulco
Honóxeäse	Prærielerketrupial
Category:Ma'evé'ho'éno	Kategori:Tyskland
Category:Italy	Kategori:Italia
Category:Russia	Kategori:Russland
Category:Canada	Kategori:Canada
Category:United Kingdom	Kategori:Storbritannia
Category:Spain	Kategori:Spania
Category:Meško	Kategori:Mexico
Category:Mo'hetaneho'e hánêsóvóne	Kategori:Sør-Afrika
Category:Egypt	Kategori:Egypt
Ó'óéséó'o	Klessnor
Hóxovéstavestôtse	Modulhus
Category:Austria	Kategori:Østerrike
Category:Democratic Republic of the Congo	Kategori:Den demokratiske republikken Kongo
Category:Poland	Kategori:Polen
Category:Switzerland	Kategori:Sveits
Category:Tanzania	Kategori:Tanzania
Category:Ukraine	Kategori:Ukraina
Category:Vietnam	Kategori:Vietnam
Category:Ve'kêseho	Kategori:Fugler
Category:Buildings	Kategori:Byggverk
Mé'konéseno'êhaseo'o	Hårspenne
Ma'kestsêstse	Teltplugg
Hesóva'kove	Indrefilet (kjøtt)
Tonôhené-mâhéó'o	Smed
Tsévovó'hásêstse	Pinto
Netse	Ørner
Sanápevóoma	Sarape
A'kêstséašé'šenovôtse	Kobraslanger
Hoóxe'eo'hé'e	Washita (elv)
Tsé-tšêške'óomoëha	Pytt
Oo'kó'ôheo'o	Slåmaskin
Category:Manȧhého'e	Kategori:Land
Category:Héstanêheo'o	Kategori:Personer
Ma'xêhe'néo'hé'e	Solomon (elv)
Egypt	Egypt
Tónovêšé'hóno	Lerret
Template:Bot	Mal:Bot
Canada	Canada
Category:Slovakia	Kategori:Slovakia
Category:Slovenia	Kategori:Slovenia
Category:Hóxovê-hooma	Kategori:Europa
Category:Wikipedia help	Kategori:Hjelp
Template:Documentation	Mal:Dokumentasjon
Template:Softredirect	Mal:Softredirect
Template:Delete	Mal:Hurtigsletting
Wikipedia:Statistics	Wikipedia:Statistikk
Template:!	Mal:!
Category:Mo'hetaneho'e	Kategori:Afrika
Template:Babel	Mal:Babel
Template:Reflist	Mal:Referanser
Template:Stub	Mal:Stubb
Template:User en-2	Mal:Bruker en-2
Template:User en	Mal:Bruker en
Category:Asia	Kategori:Asia
Category:Chile	Kategori:Chile
Category:Máhtáme	Kategori:Mat
Template:Mod	Mal:Mod
Template:User es-2	Mal:Bruker es-2
Category:User en	Kategori:Bruker en
Template:Documentation/start box	Mal:Dokumentasjon/start boks
Template:Documentation/end box2	Mal:Dokumentasjon/end boks 2
Template:Documentation/start box2	Mal:Dokumentasjon/start boks 2
Category:Máhtáme naa tsémâhpév-oom	Kategori:Mat og drikke
Template:Pp-template	Mal:Beskyttet side
Category:Vose	Kategori:Fjell
Template:IPA	Mal:IPA
Category:Amérika	Kategori:Amerika
Template:Coord/link	Mal:Koord/lenke
Template:UF-coord-classes	Mal:UF-coord-classes
Template:Coord	Mal:Koord
Category:Wyoming	Kategori:Wyoming
Category:User en-N	Kategori:Bruker en-N
Mâ-htáeme	Pels- og fjærlus
Template:Userdraft	Mal:Brukerromsutkast
Category:Mahpe	Kategori:Vann
Category:Tsémâhpév-oom	Kategori:Drikke
Category:Heévȧhetanéno	Kategori:Oklahoma
Pano'êhasëö'o	Sirup
Category:Hoohtsêstse	Kategori:Tresorter
Náhkôhematôtse	Sviske
Template:Coord/dec2dms/dm	Mal:Koord/dec2dms/dm
Category:Nebraska	Kategori:Nebraska
Category:North Dakota	Kategori:Nord-Dakota
Category:South Dakota	Kategori:Sør-Dakota
Category:Idaho	Kategori:Idaho
Category:Alaska	Kategori:Alaska
Category:Oregon	Kategori:Oregon
Category:Kansas	Kategori:Kansas
Category:Colorado	Kategori:Colorado
Category:Toháano'ého'ëva	Kategori:Texas
Category:Šé'hóno	Kategori:Tekstiler
Category:Poeso	Kategori:Kattedyr
Category:Malawi	Kategori:Malawi
Category:Namibia	Kategori:Namibia
Category:Republic of the Congo	Kategori:Republikken Kongo
Category:Ho'honáéšé'e	Kategori:Montana
Template:Citation/core	Mal:Citation/core
Category:Ó'he'e	Kategori:Elver
Category:Zambia	Kategori:Zambia
Category:Zimbabwe	Kategori:Zimbabwe
Category:Nomá'ne	Kategori:Fisk
Category:Énano'émâhtáme	Kategori:Grønnsaker
Category:Mene	Kategori:Frukt
Category:Mo'éhno'häme	Kategori:Hester
Category:Hovahne	Kategori:Dyr
Category:Še'šenovôtse	Kategori:Slanger
Category:Hoohëö'o	Kategori:Flagg
Category:Váótséva	Kategori:Hjortedyr
Anonévee'tose (énano'émâhtáme)	Gulrot
Template:Coord/prec dec	Mal:Koord/prec dec
Trojany	Trojany
Category:Vášêtaëno	Kategori:Washington, DC
Category:Náhkohe	Kategori:Bjørner
Ma'xetôhoo'e	Slegge
Hóxeeséeto'hamestôtse	Grime
Special:RecentChanges	Spesial:Siste endringer
