非洲	Afrika
日本	Japan
南美洲	Sør-Amerika
Nò-vî	Norge
Sû-kak-làn	Skottland
Vî-ngì-sṳ̂	Wales
Pet Oi-ngì-làn	Nord-Irland
Hiûng-ngà-li	Ungarn
Sî-pân-ngà	Spania
Mî-koet	USA
Pí-li-sṳ̀	Belgia
Lù-sêm-pó	Luxembourg
Yî-chhiu	Universet
Thi-khiù	Jorden
Sâng-miang	Liv
Ngìn-lui	Menneske
George Washington	George Washington
Fûn-làn	Finland
Shuì-tién	Sverige
Tan-ma̍k	Danmark
Pô-làn	Polen
Li̍p-thâu-vón	Litauen
Yi-thai-li	Italia
Shuì-sṳ	Sveits
O-thi-li	Østerrike
Hî-lia̍p	Hellas
Thú-ngí-khì	Tyrkia
Phù-thò-ngà	Portugal
歐洲	Europa
亞洲	Asia
北美洲	Nord-Amerika
南極洲	Antarktika
Vì-kî Pak-khô	Wikipedia
Hò-làn	Nederland
Néu-yok-sṳ	New York
Fà-sṳ̀n-tun Kô-lùn-pí-â Thi̍t-khî	Washington, D.C.
Khiu-kîm-sân	San Francisco
Pak-lìm	Berlin
Lo̍k-chhám-kî	Los Angeles
Thien-nó	Datamaskin
Mióng-chi-mióng-lu	Internett
Barack Obama	Barack Obama
Vû-lâ-kûi	Uruguay
Lùn-tûn	London
Phìn-kó	Epleslekten
Pâ-lì-sṳ	Paris
Â-pak-lâ-hón Lìm-khén	Abraham Lincoln
Google	Google
Me̍t-sî-kô	Mexico
Thai-sî-yòng	Atlanterhavet
Thai-phìn-yòng	Stillehavet
Kâ-li-fuk-nì-â	California
Pô-sṳ-tun	Boston
Fó-sên	Mars (planet)
Âi-set-ngò-pí-â	Etiopia
Sṳ̂-é	Løve
Fap-koet	Frankrike
Sṳ-kie-ngî	Esperanto
Kiéu-è	Tamhund
Yîn-koet	Storbritannia
Meu-é	Tamkatt
中華人民共和國	Folkerepublikken Kina
Fap-ngî	Fransk
Ǹg-è	Fisk
Pâ-sî	Brasil
François Hollande	François Hollande
Ngò-lò-sṳ̂	Russland
Kîn-ǹg	Hvaler
Chang-fông-hìn	Kvadrat
Tô-lùn-tô	Toronto
Â-lâ-pâ-mâ	Alabama
Québec-sén	Québec
Boeing 747	Boeing 747
Jimmy Wales	Jimmy Wales
Tet-koet	Tyskland
Pha̍k-ngò-lò-sṳ̂	Hviterussland
Tet-ngî	Tysk
Pên-tó	Island
Song-ti	Gud
Oi-sâ-nì-â	Estland
David Cameron	David Cameron
Thú-sên	Saturn
Ku-thin-yi̍t Fî-kî	Fly
1	1 (tall)
2	2 (tall)
3	3 (tall)
4	4 (tall)
5	5 (tall)
George W. Bush	George W. Bush
Lâ-thot-vì-â	Latvia
Vû-khiet-làn	Ukraina
Tshia̍p-khiet	Tsjekkia
Sṳ̂-lo̍k-vì-nì-â	Slovenia
Lò-mâ-nì-â	Romania
Pó-kâ-li-â	Bulgaria
Lò-mâ	Roma
Mâ-khì-tun	Republikken Makedonia
Â-ngì-pâ-nì-â	Albania
Khiet-lò-âi-sî-â	Kroatia
Pô-sṳ-nì-â lâu Het-set-kô-vì-ná	Bosnia-Hercegovina
Â-set-pai-kiông	Aserbajdsjan
Set-phû-lu-sṳ̂	Republikken Kypros
Kak-lû-kit-â	Georgia
Hâ-sat-khiet-sṳ̂-thán	Kasakhstan
Mí-li-thai	Malta
Mô-na̍p-kô	Monaco
Mùng-thi̍t-nui-kô-lò	Montenegro
Sṳn Mâ-li-nok	San Marino
Kú-pâ	Cuba
Eiffel Thiet-thap	Eiffeltårnet
Yin-thu-nì-sî-â	Indonesia
Wolfgang Amadeus Mozart	Wolfgang Amadeus Mozart
Pi-tô-fûn	Ludwig van Beethoven
Thú-ngí-khì-ngî	Tyrkisk
Nàm-fî	Sør-Afrika
Vû-tsṳ̂-phe̍t-khiet-sṳ̂-thán	Usbekistan
Pô-tsṳ-nàm	Poznań
Fà-sâ	Warszawa
Súi	Vann
Thien-sṳ	Fjernsyn
Chṳ-li	Chile
Yâ-sû	Jesus Kristus
Súi-sên	Merkur
Li̍t-sṳ́	Historie
Phìn-kó Kûng-sṳ̂	Apple
Kîm-sên	Venus
Ngî-ngièn	Språk
Muk-sên	Jupiter
Thiên-vòng-sên	Uranus
Pu-lie̍t-thap-nì	Bretagne (historisk region)
Hói-vòng-sên	Neptun (planet)
Thiên-vùn-ho̍k	Astronomi
Sîn-kâ-po	Singapore
Khô-ho̍k	Vitenskap
Montréal	Montréal
Lie̍t-kî-tûn-sṳ-tên	Liechtenstein
Kiam-khiâu	Cambridge
Thi-ngi-chhṳ Sṳ-kie Thai-chan	Andre verdenskrig
Cologne	Köln
Kak-tên-nì-â	Gdynia
Sṳ̍p-chhiet-chhiâng	Szczecin
Sṳ-ho̍k	Matematikk
Lâ-tên-ngî	Latin
Pâ-lìm	Bahrain
Â-mî-nì-â	Armenia
Set-ngì-vì-â	Serbia
Ngie̍t-khiù	Månen
Àu-thai-li-â	Australia
Vu̍t-lî-ho̍k	Fysikk
Â-kîn-thìn	Argentina
Pi-lû	Peru
Sâng-vu̍t-ho̍k	Biologi
Tsêu-siên Mìn-tsú Tsú-ngi Ngìn-mìn Khiung-fò-koet	Nord-Korea
Kán-pu-chhài	Kambodsja
Khiúng-liùng	Dinosaurer
Yî-sṳ̂-làn-kau	Islam
Lech Wałęsa	Lech Wałęsa
Lin-é	Hjul
Lyon	Lyon
Êu-chû Lièn-mèn	Den europeiske union
Rhône-Alpes	Rhône-Alpes
Chhiòn-khiù Chṳ̂-sín Mióng	World Wide Web
Ńg-ngìn	Kvinne
Khiûng-tsiâu	Bananer
Fâ	Blomst
Mâ-lî-â-na̍p-hói	Marianergropen
Chû-mu̍k-lòng-mâ-fûng	Mount Everest
Sàng-sṳ	By
Nâ-pho-lùn yit-sṳ	Napoléon Bonaparte
Ngit-tèu	Solen
Pâ-sṳ-tet	Louis Pasteur
大洋洲	Oseania
Thai-yòng Hì	Solsystemet
Pô-lò-tit-hói	Østersjøen
Ngâ-chhṳ	Tann
Khîn	Hydrogen
Hoi (氦)	Helium
Angela Merkel	Angela Merkel
Lî	Litium
Phì	Beryllium
Si	Bok
Ngit	Dag
Ngièn	År
Sṳ-ki	Århundre
Lò-tsṳ (Pô-làn)	Łódź
Khà-thok-vì-chṳ	Katowice
Ngie̍t-sû-fû	Rzeszów
Phìn	Bor (grunnstoff)
Thàn	Karbon
Tham	Nitrogen
Yòng	Oksygen
Hàng-sên	Planet
Yîm-ngo̍k	Musikk
Rennes	Rennes
Mo̍k-sṳ̂-khô	Moskva
Fuk	Fluor
Yi-thai-li-ngî	Italiensk
Nái	Neon
Sṳn Pí-tet-páu	St. Petersburg
Na̍p	Natrium
北	Nord
Mî	Magnesium
Lî (鋁)	Aluminium
Néu Sî-làn	New Zealand
南	Sør
Yin-thu	India
Si̍t	Silisium
Fap	Francium
Lìn	Fosfor
Thiet	Jern
Tûng-kâ	Tonga
西	Vest
Liù-vòng	Svovel
東	Øst
Liu̍k	Klor
Pâ-pu-â Néu-kí-nui-â	Papua Ny-Guinea
Vî-lièn Sâ-sṳ-pí-â	William Shakespeare
Â (氬)	Argon
Kap	Kalium
Koi	Kalsium
Yèn	Bly
Mùng-kú-koet	Mongolia
Khong (鈧)	Scandium
Thai	Titan (grunnstoff)
Genghis Khan	Djengis Khan
Fàm	Vanadium
Mien-yîn	Maine
Kok	Krom
Mâ	Hest
Thûng-vu̍t	Dyr
Sû-li-nàm	Surinam
Màng	Mangan
Pâ-lâ-kûi	Paraguay
Koi-â-nâ	Guyana
Ngi-su̍t	Kunst
Lòi	Rhenium
Kô-lùn-pí-â	Colombia
Kû	Kobolt
Vû	Wolfram
Ngiap (鎳)	Nikkel
Fu̍t-kau	Buddhisme
Pô-li-vì-â	Bolivia
Tshṳ̀-nì-tha̍t lâu Tô-pâ-kô	Trinidad og Tobago
Chhṳ̍t-vu̍t	Planter
Sîn	Sink
Néu Hàn-pu-ha	New Hampshire
Pí-â-vùi-sṳ̂-thok-khiet	Białystok
Ngà-mâi-kâ	Jamaica
Mà-sat-chû-set	Massachusetts
Drenthe-sén	Drenthe
Overijssel-sén	Overijssel
Kûa-thi-mâ-là	Guatemala
Gelderland-sén	Gelderland
Pâ-hâ-mâ	Bahamas
Không-nái-tí-khiet-chû	Connecticut
Kiê-é	Tamhøns
Ha-vî-yî	Hawaii
Fùng-tû-lâ-sṳ̂	Honduras
Tô-mí-nì-kâ	Dominica
Tô-mí-nì-kâ Khiung-fò-koet	Den dominikanske republikk
Kâ-chû (Thung-vu̍t)	Gris
Hói-thi	Haiti
Sat-ngì-ngá-tô	El Salvador
Yî-lóng	Iran
Yî-là-khiet	Irak
Â-lâ-sṳ̂-kâ	Alaska
Kô-sṳ̂-tha̍t Lì-kâ	Costa Rica
Yî-set-lie̍t	Israel
Pâ-nâ-mâ	Panama
Ya̍p-mùn	Jemen
Phiang-thu̍k	Virus
Pô-làn-ngî	Polsk
Yok-tan	Jordan
Nì-kâ-lâ-kûa	Nicaragua
Fu-lò-lî-tha̍t	Florida
Kit-ngí-kit-sṳ̂-thán	Kirgisistan
Â-li-sông-ná	Arizona
Khô-vî-thi̍t	Kuwait
Liàu-koet	Laos
Lì-pâ-nun	Libanon
O-le̍t-kông	Oregon
Mâ-ngì-thoi-fû	Maldivene
Yù-thâ	Utah
Mâ-lòi-sî-â	Malaysia
Mién-thien	Myanmar
Nì-pok	Nepal
Â-man	Oman
Pâ-kî-sṳ̂-thán	Pakistan
Khà-tha̍t	Qatar
Mióng-khiù	Tennis
Sâ-vû-thi Â-lâ-pak	Saudi-Arabia
Sṳ̂-lî-làn-khà	Sri Lanka
Si-li-â	Syria
Kâ	Gallium
Thap-kit-khiet-sṳ̂-thán	Tadsjikistan
中華民國	Republikken Kina
YouTube	YouTube
Châ	Germanium
Thai-koet	Thailand
Sṳ̂n	Arsen
Thú-khû-man-sṳ̂-thán	Turkmenistan
Abakan	Abakan
Sî	Selen
Yî	Iridium
Â-lâ-pak Lièn-ha̍p Thai-kûng-koet	De forente arabiske emirater
Tshiù (溴)	Brom
Pha̍k (鉑)	Platina
Ye̍t-nàm	Vietnam
Thai-hòn Mìn-koet	Sør-Korea
Khiet	Krypton
Â-fu-hon	Afghanistan
J. R. R. Tolkien	J. R. R. Tolkien
Lù	Rubidium
Kîm	Gull
Men-kâ-lâ-koet	Bangladesh
Ufa	Ufa (by)
Ôn-kô-lâ	Angola
Vùn-lòi	Brunei
Kúng	Kvikksølv
Fî-li̍t-pîn	Filippinene
Thò	Thallium
Ngie-sat-khiet Ngiù-tun	Isaac Newton
Albert Einstein	Albert Einstein
Sṳ̂	Strontium
Yet	Yttrium
Pit	Vismut
Vòng-set	Gul
Tsan-pí-â	Zambia
Sîn-pâ-pu-vî	Zimbabwe
北京	Beijing
Tuva Khiung-fò-koet	Tuva (republikk)
Pok-tshṳ-ngá-na̍p	Botswana
Pho (釙)	Polonium
Bayern	Bayern
Baden-Württemberg	Baden-Württemberg
Ngo (砈)	Astat
Lòi-sò-thok	Lesotho
Mâ-tha̍t-kâ-sṳ̂-kâ	Madagaskar
Mâ-là-vî	Malawi
Stuttgart	Stuttgart
Màu-li-thap-nì-â	Mauritania
Pô-làn-ngìn	Polakker
Mo̍k-sông-pí-khiet	Mosambik
Na̍p-mí-pí-â	Namibia
Nai-khi̍p-li-â	Nigeria
Ko	Zirkonium
Nì	Niob
Yû-li-vû-sṳ̂ Khái-sat	Julius Cæsar
Sṳ̂-vî-sṳ-làn	Swaziland
Muk	Molybden
Thap	Technetium
Hamburg	Hamburg
Thoi-chhia	Stoffskifte
Miên-yi̍t Hì-thúng	Immunforsvar
Lièn-ha̍p-koet	De forente nasjoner
Sîm-chhong	Hjerte
Thèu-nó	Hjerne
Phì-fû	Hud
Ló	Rhodium
Làm-set	Blå
Pâ	Palladium
Ngiùn	Sølv
Kak	Kadmium
Yîn	Indium
Siak	Tinn (grunnstoff)
Yu	Uran
Thi (銻)	Antimon
Ti	Tellur
Pu	Plutonium
Tièn	Jod
Nai	Neptunium
Set	Cesium
Phù	Protactinium
Pi	Barium
Thú	Thorium
Kap (鉿)	Hafnium
Than (鉭)	Tantal
Luì	Radium
Tûng	Radon
Alsace	Alsace
Auvergne	Auvergne
Ôn-tet-là-pâng	Andhra Pradesh
Me̍t-hiet-kîn	Michigan
Burgundy	Bourgogne
Aquitaine	Aquitaine
Schleswig-Holstein	Schleswig-Holstein
Hâ Saxony	Niedersachsen
Pet Rhine-Westphalia	Nordrhein-Westfalen
Saxony	Sachsen
Yî-li-nò	Illinois
Thuringia	Thüringen
Saxony-Anhalt	Sachsen-Anhalt
Pet Tha̍t-khô-thâ	Nord-Dakota
Brandenburg	Brandenburg
Bremen-chû	Bremen
Nàm Tha̍t-khô-thâ	Sør-Dakota
Mùng-thai-nâ	Montana
Fài-ngò-mìn	Wyoming
Yâ-lu-sat-lâng	Jerusalem
Oi-tha̍t-hòt	Idaho
Fà-sṳn-tun	Washington
Lù (鑪)	Rutherfordium
Nui-fà-tha̍t	Nevada
Hàn (𨧀)	Dubnium
Hí (𨭎)	Seaborgium
Yin-thu-yòng	Indiahavet
Khô-sò-vok	Kosovo
Kâ-le̍t-pí-hói	Det karibiske hav
Pô (𨨏)	Bohrium
Het (𨭆)	Hassium
Phan Kî-vùn	Ban Ki-moon
Ma̍k (䥑)	Meitnerium
Khô-lò-là-tô	Colorado
Tha̍t	Darmstadtium
Siau-pâng	Frédéric Chopin
Lùn	Røntgenium
Kô (鎶)	Copernicium
分類:Chú-yeu fûn-lui	Kategori:Kategorier
Chi-kâ-kô	Chicago
Arnhem	Arnhem
Tûng-kui	Vinter
Sî-pân-ngà-ngî	Spansk
Fî-là-thiet-fî	Philadelphia
Tî-tû	Edderkopper
Hèu-è	Apekatter
Kîm-tshièn	Penger
Vì-kit-nì-â	Virginia
Sî Vì-kit-nì-â	Vest-Virginia
Tshiâng-tséu	Paprika
Néu-yok-chû	New York (delstat)
Sṳ (鈰)	Cerium
Phú	Praseodym
Lò-tet-tó	Rhode Island
Ńg	Neodym
Khûn-chhùng	Insekter
Mâ-lî-làn	Maryland
Thi̍t-lâ-ngá	Delaware
Yû (銪)	Europium
Ngò-hài-ngò	Ohio
Vì-kit-ngì	Vergil
Machiavelli	Niccolò Machiavelli
Pîn-sé-fap-nì-â	Pennsylvania
Uetersen	Uetersen
O-kú-sṳ̂-tû	Augustus
Néu Chhe̍t-sî-chû	New Jersey
Fûn-làn-ngî	Finsk
Yin-thi-ôn-na̍p	Indiana
Vì-sṳ̂-pha-siên	Vespasian
Thù-là-chṳ̂n	Trajan
Hâ-tet-liòng	Hadrian
Khièu-tshṳ-â	Georgia (USA)
Mâ-khù-sṳ̂ O-lie̍t-lî-vû-sṳ̂	Marcus Aurelius
Zagreb	Zagreb
Tet-khiet-sat-sṳ̂	Texas
Thai-mí-ngì-na̍p-tet-pâng	Tamil Nadu
Pet Khà-lò-lòi-na̍p	Nord-Carolina
Nàm Khà-lò-lòi-na̍p	Sør-Carolina
Loire-sén	Loire
Pâ-set-lò-nâ	Barcelona
Me̍t-sî-sî-pí	Mississippi
Thièn-na̍p-sî	Tennessee
Néu Me̍t-sî-kô	New Mexico
Mìn-nì-sû-tha̍t	Minnesota
Vî-sṳ̂-không-sîn	Wisconsin
Oi-hò-fà	Iowa
Nui-pu-lâ-sṳ̂-kâ	Nebraska
Khâm-sat-sṳ̂	Kansas
Yin-thi-ngî	Hindi
Me̍t-sû-lî	Missouri
Lu-yi-sṳ̂-ôn-ná	Louisiana
Khén-thap-kî	Kentucky
Â-khén-set	Arkansas
Neil Armstrong	Neil Armstrong
O-khiet-lâ-hò-mâ	Oklahoma
Pet-hói	Nordsjøen
Mo̍k-sṳ̂-khô-chû	Moskva oblast
Kiel	Kiel
Schwerin	Schwerin
Potsdam	Potsdam
Hanover	Hannover
Düsseldorf	Düsseldorf
Mainz	Mainz
Wiesbaden	Wiesbaden
Saarbrücken	Saarbrücken
Mu-nì-het	München
Erfurt	Erfurt
Dresden	Dresden
Kaliningrad-chû	Kaliningrad oblast
Murmansk-chû	Murmansk oblast
Kak-than-sṳ̂-khiet	Gdańsk
Fap-làn-khiet-fuk	Frankfurt am Main
Fut-lò-tshṳ-ngá-fû	Wrocław
Làn	Lantan
Ki (鉕)	Promethium
Sân	Samarium
Â-chhè Thi̍t-phe̍t Hàng-chṳn-khî	Aceh
Nga̍t (釓)	Gadolinium
Thi̍t (鋱)	Terbium
Tit (鏑)	Dysprosium
Sṳn-kîn	Bibelen
Fó	Holmium
Ngí (鉺)	Erbium
Tiû	Thulium
Yi	Ytterbium
Liu	Lutetium
Hò-nui-sṳ	Hanoi
Yîn-ngî	Engelsk
Màn-kuk	Bangkok
Kit-lùng-po	Kuala Lumpur
Pâng-kâ Vú-lî-thung-sén	Bangka-Belitung
Thòi-pet-sṳ	Taipei
Mî (鋂)	Americium
Arkhangelsk-chû	Arkhangelsk oblast
Khiu̍k	Curium
Thùng-hói-sṳ	Dong Hoi
Concepción	Concepción
Pet (鉳)	Berkelium
Khà (鉲)	Californium
Mìn-kú-lû-sén	Bengkulu
Oi	Einsteinium
Fi	Fermium
Mùn	Mendelevium
Na	Nobelium
Ontario-sén	Ontario
Lò	Lawrencium
Karelia Khiung-fò-koet	Karelia
Końskowola	Końskowola
2002-ngièn	2002
2008-ngièn	2008
Charles de Gaulle	Charles de Gaulle
Cham-pî-sén	Jambi
Komi Khiung-fò-koet	Komi
Nâm-póng-sén	Lampung
Pet Sû-mùn-tap-lia̍p-sén	Sumatera Utara
Syktyvkar	Syktyvkar
Québec-sṳ	Québec (by)
Nenets Chhṳ-chhṳ-khî	Nenetsk
Liàu-nui-sén	Riau
Leningrad-chû	Leningrad oblast
Pskov-chû	Pskov oblast
Liàu-nui Khiùn-tó-sén	Kepulauan Riau
Nizhny Novgorod-chû	Nizjnij Novgorod oblast
Nàm Sû-mùn-tap-lia̍p-sén	Sumatera Selatan
Lò-mâ Ti-koet	Det romerske keiserriket
Mì-ngiôn Kûng-sṳ̂	Microsoft
Tver-chû	Tver oblast
Khù-lû-fû	Kurów
Fa-ho̍k	Kjemi
Smolensk-chû	Smolensk oblast
Yaroslavl-chû	Jaroslavl oblast
Kostroma-chû	Kostroma oblast
Ivanovo-chû	Ivanovo oblast
Arnold Schwarzenegger	Arnold Schwarzenegger
Chiuk-khiù	Fotball
Ryazan-chû	Rjazan oblast
IPhone	IPhone
Sî Sû-mùn-tap-lia̍p-sén	Sumatera Barat
Tula-chû	Tula oblast
IPad	IPad
Mâ-tet-lî	Madrid
Bryansk-chû	Brjansk oblast
Michael Jackson	Michael Jackson
Kaluga-chû	Kaluga oblast
Loire-Atlantique-sén	Loire-Atlantique
Ain-sén	Ain (departement)
Allier-sén	Allier
Khâm-phì-là	Canberra
Sông Alpes-sén	Hautes-Alpes
Oryol-chû	Orjol oblast
Sit-nì	Sydney
Alpes-de-Haute-Provence-sén	Alpes-de-Haute-Provence
Liu̍k-set	Grønn
Alpes-Maritimes-sén	Alpes-Maritimes
Hâ-tet-sùn-hò	Hudson (elv)
Me̍t-ngì-pún	Melbourne
Fùng-set	Rød
Ardèche-sén	Ardèche
Jena	Jena
Kursk-chû	Kursk oblast
Ariège-sén	Ariège
Aude-sén	Aude
Aveyron-sén	Aveyron
Sîn Nàm Vî-ngì-sṳ̂-chû	New South Wales
Bouches-du-Rhône-sén	Bouches-du-Rhône
Àu-thai-li-â Sú-tû Liâng-thi	Australian Capital Territory
Cantal-sén	Cantal
Belgorod-chû	Belgorod oblast
Côte-d'Or-sén	Côte-d'Or
Côtes-d'Armor-sén	Côtes-d'Armor
Drôme-sén	Drôme
Finistère-sén	Finistère
Voronezh-chû	Voronezj oblast
Sû-mùn-tap-lia̍p	Sumatra
Lipetsk-chû	Lipetsk oblast
Van-tan-sén	Banten
Chûng Cháu-ôa-sén	Jawa Tengah
Fùi-sên	Komet
Rostov-chû	Rostov oblast
Tûng Cháu-ôa-sén	Jawa Timur
Ngâ-kâ-tha̍t Sú-tû Thi̍t-khî	Jakarta
Sî Cháu-ôa-sén	Jawa Barat
Adygea Khiung-fò-koet	Adygia
Gera	Gera
Maykop	Majkop
Cháu-ôa-tó	Java (øy)
Kâ-lî-man-tân-chû	Kalimantan
Séu Sùn-thâ Khiùn-tó	De små Sundaøyer
Sû-lâ-vî-sî-tó	Sulawesi
Mô-lu̍k-kâ Khiùn-tó	Molukkene
Nàm Kâ-lî-man-tân-sén	Kalimantan Selatan
Kâ-li-sî-â	Galicia (Spania)
Thai-ho̍k	Universitet
Pretoria	Pretoria
Chok-khiù	Bordtennis
Â-sṳ̂-thù-lî-â-sṳ̂	Asturias
Wikipedia:Sandbox	Wikipedia:Sandkasse
Astrakhan-chû	Astrakhan oblast
Kham-thap-pu-lî-â	Cantabria
Kalmykia Khiung-fò-koet	Kalmykia
Weimar	Weimar
Osasco	Osasco
Â-là-kung	Aragón
Kak-là-sṳ̂-kô	Glasgow
Thùng-hói Kî-chhòng	Dong Hoi lufthavn
Vú-lîn-ngièn Fûng-kín Miàng-sṳn-khî	Wulingyuan
分類:Thòi-vân li̍t-sṳ́	Kategori:Taiwans historie
Curitiba	Curitiba
Chloë Grace Moretz	Chloë Moretz
Khûng-chṳ́	Konfucius
Corbin Bleu	Corbin Bleu
分類:Sṳ-ho̍k	Kategori:Matematikk
分類:Ngìn-kûng ngî-ngièn	Kategori:Konstruerte språk
Pâ-lî-sén	Bali
Mî-kîm	Amerikansk dollar
Thi-chûng-hói	Middelhavet
Hông-chû-sṳ	Hangzhou
Kî-tuk-kau	Kristendom
Vò-é	Ris
Sî Pâ-pu-â-sén	Papua Barat
Dagestan Khiung-fò-koet	Dagestan
Sú-tû	Hovedstad
Monzón	Monzón
Phù-thò-ngà-ngî	Portugisisk
Ngie̍t	Måned
Mustafa Kemal Atatürk	Mustafa Kemal Atatürk
Makhachkala	Makhatsjkala
Chechnya Khiung-fò-koet	Tsjetsjenia
Grozny	Groznyj
Almazán	Almazán
Vòng Hien-fàm	Huang Xian-fan
Ingushetia Khiung-fò-koet	Ingusjetia
Magas	Magas
Pet Ossetia–Alania Khiung-fò-koet	Nord-Ossetia
Kabardino-Balkaria Khiung-fò-koet	Kabardino-Balkaria
Tson-sa̍k	Diamant
Bill Gates	Bill Gates
Ngi̍t-ngî	Japansk
Pak-khô-chhiòn-sû	Encyklopedi
頭頁	Portal:Forside
Karachay-Cherkessia Khiung-fò-koet	Karatsjajevo-Tsjerkessia
Saratov	Saratov
Saratov-chû	Saratov oblast
Orenburg-chû	Orenburg oblast
Mordovia Khiung-fò-koet	Mordovia
Saransk	Saransk
Yâ-khiù	Baseball
Làm-khiù	Basketball
Kirov-chû	Kirov oblast
Udmurtia Khiung-fò-koet	Udmurtia
Sî-pak-li-â	Sibir
Mari El Khiung-fò-koet	Mari El
Yoshkar-Ola	Josjkar-Ola
Stellenbosch	Stellenbosch
Sverdlovsk-chû	Sverdlovsk oblast
Cape Town	Cape Town
Chuvash Khiung-fò-koet	Tsjuvasjia
Durban	Durban
Cheboksary	Tsjeboksary
Tat-tat-sṳ̂-thán Khiung-fò-koet	Tatarstan
Penza-chû	Penza oblast
Là-fî-ngì	Rafael
Pí-tet Lû-pún-sṳ̂	Peter Paul Rubens
Ulyanovsk-chû	Uljanovsk oblast
Gung-gung-hi-tsaa	Buss
Kâ-thai-lò-nì-â	Catalonia
Bashkortostan Khiung-fò-koet	Basjkortostan
Chelyabinsk-chû	Tsjeljabinsk oblast
Pâ-lùn-sî-â Chhṳ-chhṳ-khî	Comunitat Valenciana
Khà-sṳ̂-tì-li-â lâu Lòi-ngong	Castilla y León
Kurgan-chû	Kurgan oblast
Mô Chhe̍t-tûng	Mao Zedong
Tyumen-chû	Tjumen oblast
Omsk-chû	Omsk oblast
Thai-mí-ngì-ngî	Tamilsk
Chet-ho̍k	Filosofi
分類:Candidates for speedy deletion	Kategori:Sider som er foreslått raskt slettet
Altai Khiung-fò-koet	Altaj
Kòng-khìm	Piano
Gorno-Altaysk	Gorno-Altajsk
Kemerovo-chû	Kemerovo oblast
Hebe Camargo	Hebe Camargo
Chṳ̂-pún chú-ngi	Kapitalisme
Mìn-chhu̍k	Nasjon
Khanty-Mansi Chhṳ-chhṳ-khî	Khanty-Mansia
Yamalo-Nenets Chhṳ-chhṳ-khî	Jamalo-Nenetsk
Montpellier	Montpellier
分類:Thiên-vùn-ho̍k	Kategori:Astronomi
Khakassia Khiung-fò-koet	Khakasia
Irkutsk-chû	Irkutsk oblast
Sakha Khiung-fò-koet	Sakha
Khiet-lò-âi-sî-â-ngî	Kroatisk
Hon-pó	Hamburger
Buryatia Khiung-fò-koet	Burjatia
Vû-làn Vû-tet	Ulan-Ude
Amur-chû	Amur oblast
Ngi-sṳ̍p Sṳ-ki	20. århundre
Gotha	Gotha
Dijon	Dijon
Kâ-thai-lò-nì-â-ngî	Katalansk
Kit-lò-na̍p-sén	Girona
Eisenach	Eisenach
Se-pâu Sâng-vu̍t-ho̍k	Cytologi
Sṳ-kie Ngiùn-hòng Si̍p-thòn	Verdensbanken
A-la-pak Liên-mên	Den arabiske liga
Mìn-tsú Tsú-ngi	Demokrati
Chhîn-chhèu (秦朝)	Qin-dynastiet
Pet Thai-sî-yòng Kûng-yok Chû-chṳt	NATO
Chhìn Sṳ Fòng	Qin Shi Huangdi
Hon-chhèu	Han-dynastiet
Hon Vú-ti Liù Chha̍t	Keiser Wu av Han
Sâng-vu̍t	Organisme
Kiûn-chú-chṳ	Monarki
Khiung-fò-koet	Republikk
Yí-mô-khiù	Badminton
Ngièn-chhèu	Yuan-dynastiet
Nazi Tet-koet	Tysklands historie (1933–1945)
Yù-thai-ngìn	Jøder
Chang Fò	Zheng He
Chìn-chhèu	Jin-dynastiet (265–420)
Ngí	Øre
Phi	Nese
Ngién	Øye
Mûn-é	Stikkemygg
Mièn-yòng	Tamsau
Lo̍k-thò	Kameler
Phú-nen thung-vu̍t	Pattedyr
Siong	Elefanter
Ngie-kûng	Maur
Phûng-é	Bier
Hò-làn-ngî	Nederlandsk
Fà-thi̍t Thit-sṳ-nì Kûng-sṳ̂	The Walt Disney Company
Thot-yong Fu̍t-thông Fu̍t-son	DNA
Khiô	Aubergine
Siet	Snø
Â-pâ	Far
Fûn	Minutt
Yù-thai Chhṳ-chhṳ-chû	Den jødiske autonome oblast
Ngò-lò-sṳ̂-ngî	Russisk
Tûng-nàm-â Koet-kâ Lièn-mèn	Association of Southeast Asian Nations
Sakhalin-chû	Sakhalin oblast
Mien-pâu	Brød
Sṳ-kie Mo-yi Chû-chṳt	Verdens handelsorganisasjon
漢語	Kinesisk
Se-pâu	Celle
Hiet-yi̍t	Blod
Hi	Lunge
Lò-mâ-nì-â-ngî	Rumensk
Pó-kâ-li-â-ngî	Bulgarsk
Magadan-chû	Magadan oblast
Chhṳ-yèn Khô-ho̍k	Naturvitenskap
Het-chhe̍t Mìn	Akira Kurosawa
Franklin D. Roosevelt	Franklin D. Roosevelt
Thi-khiù Khô-ho̍k	Geovitenskap
Sa̍k-thèu	Bergart
Yùn	Sky
Kí-hò-ho̍k	Geometri
Tet-lu-kú-ngî	Telugu
Thai-hì-chhèn	Atmosfære
Kak-lû-kit-â-ngî	Georgisk
Kîn-chi-ho̍k	Samfunnsøkonomi
Pîn-kóng	Pangkal Pinang
漢字	Kinesiske tegn
Sî-lî-ngì Sṳ-mû	Det kyrilliske alfabetet
Lâ-tên sṳ-mû	Det latinske alfabetet
Vùn-ho̍k	Litteratur
分類:Fap-koet	Kategori:Frankrike
分類:Yîm-ngo̍k	Kategori:Musikk
分類:Vùn-ho̍k	Kategori:Litteratur
La̍p-pá	Trompet
Â-li̍t-sân-thai sâm-sṳ	Aleksander den store
Kiûn-sṳ-thán-tên Yit-sṳ	Konstantin den store
Set-lû-sṳ thai-ti	Kyros den store
Vùn-mìn	Sivilisasjon
Kau-yuk	Utdannelse
Kâ-thìn	Familie
Nàm-ngìn	Mann
Fûn-yîn	Ekteskap
Kiûn-sṳ	Militærvesen
Kâ-pî	Kaffe
Ngiù-nen	Melk
Sûn Chûng-sân	Sun Yat-sen
Â-yuk-vòng	Ashoka den store
香港	Hongkong
Thai-yîn Ti-koet	Det britiske imperiet
Sú-ngì	Seoul
Kâm-nái-thit Koet-chi Kî-chhòng	John F. Kennedy internasjonale lufthavn
上海	Shanghai
Lùn-tûn Hî-sṳ̂-lu Kî-chhòng	London Heathrow lufthavn
Lùn-tûn Kak-vet Kî-chhòng	London Gatwick lufthavn
Set-vì-li-â	Sevilla
Chhîn-chhèu	Qing-dynastiet
Â-ngì-pâ-nì-â-ngî	Albansk
Pâ-sṳ̂-khiet-ngî	Baskisk
Â-lâ-kung-ngî	Aragonesisk
Yîn-koet Hòng-khûng	British Airways
Â-mî-nì-â-ngî	Armensk
Vû-khiet-làn-ngî	Ukrainsk
Pâ-lùn-sî-â	Valencia
Shuì-tién-ngî	Svensk
Tan-ma̍k-ngî	Dansk
Nò-vî-ngî	Norsk
Kô-thi̍t-fu̍t-lòi-tet Vî-liâm Lòi-pu-nì-tsṳ	Gottfried Leibniz
Tshia̍p-khiet-ngî	Tsjekkisk
Sṳ̂-lo̍k-phat-khiet-ngî	Slovakisk
Sṳ̂-lo̍k-vì-nì-â-ngî	Slovensk
Hiûng-ngà-li-ngî	Ungarsk
Oi-sâ-nì-â-ngî	Estisk
Là-thot-vì-â-ngî	Latvisk
Li̍p-thâu-vón-ngî	Litauisk
Pha̍k-ngò-lò-sṳ̂-ngî	Hviterussisk
Kui-mí-thi̍t-lî Mùn-tet-lie̍t-fû	Dmitrij Mendelejev
Ngièn-chṳ́	Atom
Lâ-set-fuk	Ernest Rutherford
Hî-lia̍p-ngî	Gresk
Oi-ngì-làn-ngî	Irsk
Pô-sṳ̂-ngî	Persisk
Chûng-kau	Religion
Chêu-sién-ngî	Koreansk
Chhóng-sṳ-ki	Første Mosebok
Kóng-tûng-fa	Standard kantonesisk
Chhut-âi-khi̍p-ki	Andre Mosebok
Ye̍t-nàm-ngî	Vietnamesisk
Pó-lò	Apostelen Paulus
Kô-mièn-ngî	Khmer (språk)
Thai-ngî	Thai
Mâ-lòi-ngî	Malayisk
Yin-nì-ngî	Indonesisk
Mùng-kú-ngî	Mongolsk
Hâ-sat-khiet-ngî	Kasakhisk
Vû-tsṳ̂-phe̍t-khiet-ngî	Usbekisk
Thú-khù-màn-ngî	Turkmensk
Yù-thai-kau	Jødedom
Hî-pak-lói-ngî	Hebraisk
Â-set-pai-kiông-ngî	Aserbajdsjansk
Mâ-khì-tun-ngî	Makedonsk
Set-ngì-vì-â-ngî	Serbisk
Set-ngì-vì-â Khiet-lò-thi-â-ngî	Serbokroatisk
Pô-sṳ-nì-â-ngî	Bosnisk
Kâ-lî-sî-â-ngî	Galisisk
Vî-ngì-sṳ̂-ngî	Walisisk
Sû-kak-làn Koi-ngì-ngî	Skotsk-gælisk
Siak-khiet-kau	Sikhisme
John Maynard Keynes	John Maynard Keynes
Lufthansa Hòng-khûng	Lufthansa
Ló-chṳ́	Laozi
Kôn-chhóng	Lever
Shìn	Nyre
Sṳ̀n-kîn Ne-thúng	Nervesystem
Sîm-lî-ho̍k	Psykologi
Sṳt-kâ-mèu-nì	Buddha
Mâ-tên Lu-tet	Martin Luther
Yî-kâ	Konfucianisme
Thiên-chú-kau	Den katolske kirke
Tho-kau	Taoisme
Chit-siói	Ryggmargen
Sa̍t	Tunge
Yî-tshóng	Bukspyttkjertel
Hèu-thèu	Strupehode
Fuk-khiet-làn khiùn-tó	Falklandsøyene
Vàng-kak-mo̍k	Mellomgolv
Elizabeth Ngi-sṳ	Elisabeth II av Storbritannia
Thòng-chhèu	Tang-dynastiet
John F. Kennedy	John F. Kennedy
Mìn-chhèu	Ming-dynastiet
Dwight D. Eisenhower	Dwight D. Eisenhower
Ronald Reagan	Ronald Reagan
Sat-là-kô-sat	Zaragoza
Kîm Tsang-ngit	Kim Jong-il
Ngièn-su Chû-khì-péu	Periodesystemet
Chû-su̍k	Svin og griser
Mariano Rajoy	Mariano Rajoy
Se-khiûn	Bakterier
Phù-thò	Druer
Phûng-thòng	Honning
Thông	Sukker
Vòng-theu	Soyabønne
Kûng-chhàng-ho̍k	Ingeniørvitenskap
Vùn-fa	Kultur
Fan-vun	Sanskrit
Sùn-fàn Hì-thúng	Sirkulasjonssystem
Sôn	Syre
Yî-ho̍k	Medisin
Néu-Yok Sṳ-kie Mo-yi Chûng-sîm	Verdens handelssenter i New York
分類:Pâ-sî	Kategori:Brasil
Màn-hâ-tun	Manhattan
Ngièn-su	Grunnstoff
Kâ-suk-thu	Akselerasjon
Li̍t	Kraft
Kú	Tromme
Tsṳt-liông	Masse
Thien-yáng	Film
Kîm-su̍k	Metall
Nùng-ngia̍p	Landbruk
Sâng-yîm	Lyd
Sṳ̀-kiên	Tid
Mien-chit	Areal
Kûng-kîn	Kilogram
Kûng-tshak	Meter
Miéu	Sekund
Pâu-siuk	Mais
Kûng-sṳ̂n	Liter
Fà-ngì-kiê	Wall Street
Tûng-nàm-â	Sørøst-Asia
Tshùng-khin	Chongqing
Thiên-tsîn	Tianjin
Vú-hon-sṳ	Wuhan
Kú Hî-lia̍p	Antikkens Hellas
Thomas Jefferson	Thomas Jefferson
Vùi-sṳ̂-khà	Huesca
Tychy	Tychy
Pu-lie̍t-thap-nì-ngî	Bretonsk
Brittany	Bretagne
Lóng	Døvhet
Chhi̍t-phiang	Sykdom
Khien-không	Helse
Màn-tó-ngî	Mansk
Chhiâng-môi-su	Penicillin
Nantes	Nantes
Pot-thâm-fó	Tuberkulose
Mà-chiông	Mahjong
模板:Location map Taiwan	Mal:Kartposisjon Taiwan
Detroit	Detroit
Van-lî Tshòng-sàng	Den kinesiske mur
Gard-sén	Gard (departement)
Gers-sén	Gers
Sông Garonne-sén	Haute-Garonne
Sṳ̀n-sṳn Lò-mâ Ti-koet	Det tysk-romerske rike
Ille-et-Vilaine-sén	Ille-et-Vilaine
Isère-sén	Isère
Chûng-kau Kói-kiet	Reformasjonen
Sông Loire-sén	Haute-Loire
Lot-sén	Lot (departement)
Lozère-sén	Lozère
Maine-et-Loire-sén	Maine-et-Loire
Nì-pu-kap-nì-sat ngi-sṳ	Nebukadnesar II
Mayenne-sén	Mayenne
Morbihan-sén	Morbihan
Nièvre-sén	Nièvre
Nord-sén	Nord (Frankrike)
Calais Hói-hia̍p-sén	Pas-de-Calais
Puy-de-Dôme-sén	Puy-de-Dôme
Sông Pyrénées-sén	Hautes-Pyrénées
Pyrénées-Orientales-sén	Pyrénées-Orientales
Hâ Rhin-sén	Bas-Rhin
Sông Rhin-sén	Haut-Rhin
Saône-et-Loire-sén	Saône-et-Loire
Sarthe-sén	Sarthe
Sông Savoie-sén	Haute-Savoie
Tarn-sén	Tarn
Tarn-et-Garonne-sén	Tarn-et-Garonne
Var-sén	Var (departement)
Vaucluse-sén	Vaucluse
Vendée-sén	Vendée
Yonne-sén	Yonne (departement)
Yî-pí-li-â Pan-tó	Den iberiske halvøy
Lai-kî	Litchi
Yâ-è	Kokospalme
Sa̍k-liù	Granateple
Chong-fa	Zhuang (språk)
Na̍p-ngá-thi̍t-ngî	Nahuatl
Mirandés-ngî	Mirandesisk
Harvard Thai-ho̍k	Harvard University
Néu-yok Chṳn-khèn Kâu-yi-só	New York-børsen
Lie̍t-yî-tha̍t-sén	Lleida (provins)
Â-lâ-pak-ngî	Arabisk
Kiú-chiu	Kyushu
Si-koet	Shikoku
O-khiet-ngî	Oksitansk
Nàm-fî Hò-làn-ngî	Afrikaans
Lí Mìn-pok	Lee Myung-bak
Lû Vú-hién	Roh Moo-hyun
Kâ Mà-chiok	Gråspurv
Kô-thiet	MTR
澳門	Macao
Suhl	Suhl
Mühlhausen	Mühlhausen (Thüringen)
Sâ-thièn-khî	Sha Tin-distriktet
Fù Kím-Thàu	Hu Jintao
Si̍p Khiûn-phìn	Xi Jinping
Chhòng-kiáng-lu̍k	Sjiraff
Phì-âi-mùng-thi̍t-ngî	Piemontesisk
Thap-là-kô-na̍p	Tarragona
Provence-Alpes-Côte d'Azur	Provence-Alpes-Côte d'Azur
Chhṳ̂m-chun-sṳ	Shenzhen
Kóng-tûng	Guangdong
Kóng-sî Chong-chhu̍k Chhṳ-chhṳ-khî	Guangxi
Mô-kài	Ringenes herre
Hiông-kóng Thai-ho̍k	University of Hong Kong
Badajoz	Badajoz
Lu̍k-yì-tó-yen	Kagoshima (prefektur)
Kiok	Fot (kroppsdel)
Sit-thit	Øgle
Altenburg	Altenburg
Kiên	Skulder
Midi-Pyrénées	Midi-Pyrénées
Wikipedia:Chhâm-siòng	Wikipedia:Tinget
Fu-mùng-thi̍t	Vermont
Hiû-sṳ̂-tûn	Houston
Kóng-chiu-sṳ	Guangzhou
Chiông Kie-sa̍k	Chiang Kai-shek
Vûn Kâ-pó	Wen Jiabao
Nàm-kîn-sṳ	Nanjing
Phiang-yèn	Sykehus
Kông-sû	Jiangsu
Chet-kông-sén	Zhejiang
Thèn Séu-phìn	Deng Xiaoping
Pet-phu Calais Hói-hia̍p	Nord-Pas-de-Calais
Pays de la Loire	Pays de la Loire
Languedoc-Roussillon	Languedoc-Roussillon
Thiap-sat-lò-nì-kâ	Thessaloniki
西藏自治區	Den autonome region Tibet
Hàng-thung Thien-fa	Mobiltelefon
Thò-niâu	Struts
Manchester	Manchester
Pu-lû-khiet-lìm	Brooklyn
Fòng-heu-khî	Queens
Liùng-yìn-sṳ	Yongin
Lòng	Ulv
Mâ-lòi Pan-tó	Malayahalvøya
Sîn-yok Sṳn-kîn	Det nye testamente
9	9 (tall)
Zung-gok Thaai-liuk	Fastlandskina
Het-liùng-kông	Heilongjiang
Mâ Yîn-kiú	Ma Ying-jeou
Piên-fò-sṳ	Bien Hoa
Hiông-kóng-tó	Hongkongøya
Ngà-tsông-sṳ	Nha Trang
Podolsk	Podolsk
Pô-tô Lì-kok Thu̍k-li̍p-tóng	Partido Independentista Puertorriqueño
Lì-è	Afrikansk villesel
Si-chhôn-sén	Sichuan
Khiu-yok Sṳn-kîn	Det gamle testamente
Sṳn-tan-chiet	Jul
Lò-màn Ngî-chhu̍k	Romanske språk
Sâm-kok-hìn	Trekant
Steve Jobs	Steve Jobs
Yin-Êu Ngî-ne	Indoeuropeiske språk
Breinigerberg	Breinigerberg
Lo-fú	Tiger
Fù-ôn Khà-lo̍k-sṳ̂ Yit-sṳ	Juan Carlos I av Spania
Súi-ngièn-sṳ	Suwon
Sâm-sên Si̍p-thòn	Samsung
Louis Couturat	Louis Couturat
Thai-thièn Kóng-vet-sṳ	Daejeon
Kîn-ki-tho	Gyeonggi
Sṳ̂-khâm-tit-nâ-vì-â	Skandinavia
Fu̍k-fa̍t-chiet	Påske
Thien-nó Khô-ho̍k	Informatikk
Koet-chi Yîm-phiêu	Det internasjonale fonetiske alfabetet
Hò-pet	Hebei
Phú-lìm-sṳ̂-tun Thai-ho̍k	Princeton University
Fôn-hìn-muk	Storkefugler
Chhṳ̀n Súi-pién	Chen Shui-bian
台灣	Taiwan
Chṳ-fi-hîn Sú-kî	Smarttelefon
Sa̍k-yù	Petroleum
Hài-è	Sko
Ngiùn-hòng	Bank
Ngièn-lun Chhṳ-yù	Ytringsfrihet
Oi-ngì-làn	Irland (øy)
Cheshire	Cheshire
Cumbria	Cumbria
Lancashire	Lancashire
Northumberland	Northumberland
Tyne and Wear	Tyne and Wear
County Durham	Durham (grevskap)
Pet Yorkshire	North Yorkshire
Lincolnshire	Lincolnshire
Nottinghamshire	Nottinghamshire
Derbyshire	Derbyshire
Merseyside	Merseyside
Leicestershire	Leicestershire
Rutland	Rutland
Lû-sùn	Lu Xun
Northamptonshire	Northamptonshire
Devon	Devon
Oxfordshire	Oxfordshire
Wiltshire	Wiltshire
Hampshire	Hampshire
Buckinghamshire	Buckinghamshire
Surrey	Surrey
West Sussex	West Sussex
East Sussex	East Sussex
Kent	Kent
Thai Lùn-tûn	Stor-London
7	7 (tall)
8	8 (tall)
Lu̍k-é	Hjortedyr
Pên	Is
Chú ke Khì-tó-vùn	Fader vår
Ngìn-lui-ho̍k	Antropologi
Fùng-hói	Rødehavet
Oi-tên-páu	Edinburgh
Pha̍k-set	Hvit
Marseille	Marseille
Thai-chhûng-thèu	Vanlig løk
6	6 (tall)
Kôn-fông ngî-ngièn	Offisielt språk
Kháu-kú-ho̍k	Arkeologi
George H. W. Bush	George H.W. Bush
Pâ-ngì-kòn pan-tó	Balkan
Dmitry Medvedev	Dmitrij Medvedev
Entrena	Entrena
Sîn-kau	Protestantisme
Selena	Selena
Mî-koet Thai-khûng Chúng-shu	NASA
Thai Put-lie̍t-tiên-tó	Storbritannia (øy)
Pâ-le̍t-sṳ̂-thán	Palestina (område)
10	10 (tall)
Lila Downs	Lila Downs
Lia̍p-pau	Gepard
Liverpool	Liverpool
Bremen	Bremen (by)
Sîn Nò-vî-ngî	Nynorsk
Meu-thèu-tiâu	Ugler
Sṳ̀	Time (tidsenhet)
Fap-lò-ngî	Færøysk
Kîm-eu-sṳ	Ca Mau
Meu-khô	Kattefamilien
Koet-chi Thai-khûng Chhàm	Den internasjonale romstasjonen
Tà-la-sṳ	Dalat
Tat-tat-ngî	Tatarisk
Tshûng-liông	Tyngde
Tsûng-su	Daddelpalme
Fan-tshiet-sṳ	Phan Thiet
Sî Fut-lî-sî-ngî	Frisisk
Séu Vòng-chṳ́	Den lille prinsen
Phiàng-fông kûng-tshak	Kvadratmeter
Fó-yam-chhùng	Lysbiller
Li̍p-fông kûng-tshak	Kubikkmeter
Fàn-chiet-thûng-vu̍t-mùn	Leddormer
Chhú-khô	Musefamilien
Lû-sêm-nì-â-ngî	Rusinsk
Fú-kîn	Spekkhogger
Sâ-thi̍t-fut-lî-sî-ngî	Saterfrisisk
Liû-khiù-koet	Kongedømmet Ryukyu
Pet-fut-lî-sî-â-ngî	Nordfrisisk
Â-mê-ha̍p-lâ-ngî	Amharisk
蝠婆	Flaggermus
Tarnobrzeg	Tarnobrzeg
Vòng Ti	Den gule keiser
Tiau-ǹg-thòi Lie̍t-yí	Senkakuøyene
Khiung-fò-tóng (Mî-koet)	Det republikanske parti (USA)
Â-sṳ̂-thù-lî-â-sṳ̂-ngî	Asturiansk
中國	Kina
O-thi-li Pâ-vî-li-â-ngî	Bairisk
Mìn-chú-tóng (Mî-koet)	Det demokratiske parti
Sàng-tû-sṳ	Chengdu
Âi-sṳ̂-thi̍t-lùi-mâ-thu-lâ-ngî	Ekstremaduransk
Sàng-fà-khî	Chenghua (Chengdu)
Séu-su mìn-chhu̍k	Minoritet
Pô-lòi-kú	Pleiku
Â-ha̍p-sṳ̂-vòng	Akas av Juda
Chûng-chû-sṳ	Chungju
Yî-liàu Ví-sâng	Helsevesen
Yòng-suk-yen	Yangshuo
Khiet-là-khô-fû	Kraków
臺灣省	Taiwan (provins)
Pet-kîn Sú-tû Koet-chi Kî-chhòng	Beijing internasjonale lufthavn
Sîn-kâ-po Hòng-khûng Kûng-sṳ̂	Singapore Airlines
Thien-nó Thôn-chhèn Só-mèu	Computertomografi
Vî-nî-sṳ̂-ngî	Venetiansk
Koet-li̍p Thòi-vân Thai-ho̍k	Taiwans nasjonale universitet
Vì-phú-sêm-ngî	Vepsisk
Fu̍t-lò-ngî	Sørestisk
Pân-mâ	Sebra
Valery Leontiev	Valerij Leontjev
Khô-sî-kâ-ngî	Korsikansk
Buryat-ngî	Burjatisk
Sùn-tho-chûng	Metodisme
Suk-vú-ngî	Cebuano
Tha̍t-lò-phî-thû Ngî-hì	Dravidiske språk
Ló-kiê-sṳ	Lao Cai
客家語	Hakka (språk)
Liòng-sân-sṳ	Lang Son
Hiuk-tsin-sṳ	Soc Trang
Liùng-chhôn-sṳ	Long Xuyen
Mî-tshiu-sṳ	My Tho
Fut-liù-li-ngî	Friulisk
Pâng-mî-tsuk	Ban Ma Thuot
Kàm-ngî	Gan (språk)
Pok-vu̍t-kón	Museum
Yin-thu Yî-lóng Ngî-chhu̍k	Indoiranske språk
Thai-yùng-meu	Panda
Kalmyk-ngî	Kalmykisk
Mân-ngî	Mandsjuisk
Kû-li̍p ngî-ngièn	Isolerte språk
Kit-là-kî-ngî	Gileki
Khà-sû-pí-ngî	Kasjubisk
Karachay-Balkar-ngî	Karatsjajbalkarsk
Lùn-pâ-tí-ngî	Lombardisk
Sú	Hånd
Thu fú	Du Fu
O-lî-â-ngî	Oriya
Ngìn-khiéu	Befolkning
Nò-man-thi-ngî	Normannisk
Pet-sat-mí-ngî	Nordsamisk
O-set-thôi-ngî	Ossetisk
Sî-sî-lî-ngî	Siciliansk
Sat-tên-nî-â-ngî	Sardisk
Nì-ngá-ngì-ngî	Nepal bhasa
Valparaíso	Valparaíso
Yên-yèn	Skuespiller
Thap-kâ-lo̍k-ngî	Tagalog
Thùng	Bronse
Vlaams-ngî	Flamsk (språk)
Fà-liùng-ngî	Vallonsk
Sú-ngî	Tegnspråk
Międzyrzec Podlaski	Międzyrzec Podlaski
Phiêu-chún Chhông-ngî	Tibetansk
Ngá-shuì-ngá-shuì-ngî	Waray-waray
Yì-ku-tshu̍k	Yugurer
N̂g-ngî	Wu (språk)
Woodrow Wilson	Woodrow Wilson
Fu̍t-sân-sṳ	Foshan
Ngiù-chîn Thai-ho̍k	University of Oxford
Sṳ̍p-thiàu Kie-min	De ti bud
Yok-hon-nì-sṳ̂-páu	Johannesburg
Pau-é	Leopard
Sîn-kiông	Xinjiang
Muk-kôa	Papaya
Pu-lî-sṳ̂-pân	Brisbane
Vî-liâm Lùn-khìm	Wilhelm Conrad Röntgen
Chû-chhèu	Zhou-dynastiet
Ido-ngî	Ido
Brad Pitt	Brad Pitt
Pa̍k-kiûng	Det hvite hus
Tha̍t-mâ-thai-ngî	Dalmatisk
Tat-tat-chhu̍k	Tatarer
Thai-fán-sṳ	Osaka
Kiam-khiâu Thai-ho̍k	University of Cambridge
Kûng-khín	Hektar
Sé-lî	Dåp
Pông-hâ	Astma
Chuk	Bambus
Fù Tsṳ-mìn	Hồ Chí Minh
Thièn-piên-fú	Dien Bien Phu
Khûn-sṳ-làn-chû	Queensland
Ha-liùng-sṳ	Ha Long
Kûi-yìn-sṳ	Quy Nhon
Mìn-nì-â-pô-li-sṳ̂	Minneapolis
Li̍t-ka-sṳ	Rach Gia
Phô-lò-chû	Borneo
Sun-fa-sṳ	Huế
Tshòng-thu	Lengde
Sṳ̂-chhù-chṳ̂-lu	Silkeveien
Mô-li-ngî	Maorisk
Mên-tûng-ngî	Mindong
Mên-pet-ngî	Minbei
Mên-nàm-ngî	Minnan
Tshiên-ngièn	Millennium
Vì-tô-li-â-chû	Victoria (Australia)
Chong-chhu̍k	Zhuang (folk)
Sông-hói-fa	Shanghainesisk
Aung San Suu Kyi翁山蘇姬	Aung San Suu Kyi
Tshèu-chû-fa	Teochew
Yok-hon-fuk-yîm	Evangeliet etter Johannes
William Vòng-chṳ́	William av Cambridge
Chhṳ̀n Kóng-sâng	Jackie Chan
12	12 (tall)
Vok-là-phú-khiet-ngî	Volapük
Toshiro Mifune	Toshiro Mifune
Kám-lám-su	Oliven
Só-lò-mùn-vòng	Salomo
O-khiet-làn	Auckland
Chhṳ̍t-sien	Linje
11	11 (tall)
13	13 (tall)
Sûn-chṳ́	Sunzi
Sṳn-lìn	Den Hellige Ånd
Lû-pu-lìm	Lublin
Thì-thèu	Peanøtt
100	100 (tall)
Tshit-thèu	Kne
Tô-piên-hìn	Polygon
Nàm Chûng-koet Hói	Sørkinahavet
Pien-set-liùng	Kameleoner
Bloemfontein	Bloemfontein
Ngiam-set-thí	Kromosom
O-khiet-làn Vùn-fap Ho̍k-káu	Auckland Grammar School
Ngióng-kông	Yangôn
Ma̍k-tông-lò Kûng-sṳ̂	McDonald’s
1000000	Million
Meu-miàng-sṳ	Maoming
Liú-chiu-sṳ	Liuzhou
Pet-pan-khiù	Nordlige halvkule
Ló-chhú	Mus (slekt)
Thí-tsit	Volum
Het-tsṳ̂	Hertz
Pak-pân-khiet	Burbank
Sien-lia̍p-thí	Mitokondrium
Yî-sên	Lege
Ki-sa̍k-chhṳn	Stonehenge
Chúng-thí Kîn-chi-ho̍k	Makroøkonomi
Ágreda	Ágreda
Lu-kâ-fuk-yîm	Evangeliet etter Lukas
Sîn Kí-nui-â	Ny-Guinea
Sṳ́-thù-hàng-chhon	Apostlenes gjerninger
Mô-hái	Krabber
PH	PH
Khì-tó	Bønn
Ôn-fui-sén	Anhui
Chûng-chhîn Pet-tho	Nord-Chungcheong
Chûng-chhîn Nàm-tho	Sør-Chungcheong
Kông-ngièn-tho (Hôn-koet)	Gangwon
Nui Mùng-kú	Indre Mongolia
Kîm Ngit-sṳ̀n	Kim Il-sung
Chhái-na̍p Koet-chi Phú-chhu Ngî-ngièn Thoi-péu-thòn	Delegasjonen for antakelse av et internasjonalt hjelpespråk
Pí-tet-kô-sṳ̍p	Bydgoszcz
Nottingham	Nottingham
Thai-ví-vòng	David av Israel
Li-vi-ki	Tredje Mosebok
Sṳ̂-thán-fuk Thai-ho̍k	Stanford University
Fuk-kian	Fujian
Kûng-khiet	Gram
Mùng-kú-tshu̍k	Mongolene
Khí-sṳ-liu̍k	Johannes' åpenbaring
Kong-lîn-sṳ	Gangneung
Kiê-liùng-sṳ	Gyeryong
Kô-yòng-sṳ	Goyang
Kûng-chû-sṳ	Gongju
Kó-chhôn-sṳ	Gwacheon
Kông-mìn-sṳ	Gwangmyeong
Kóng-chû-sṳ (Hôn-koet)	Gwangju (Gyeonggi)
Kiú-lî-sṳ	Guri (Gyeonggi)
Kiûn-phú-sṳ	Gunpo
Kîm-phú-sṳ	Gimpo
Nàm-yòng-chû-sṳ	Namyangju
Lun-sân-sṳ	Nonsan
Thông-chîn-sṳ (Hôn-koet)	Dangjin
Tûng-theu-chhôn-sṳ	Dongducheon
Tûng-hói-sṳ (Hôn-koet)	Donghae
Pó-nèn-sṳ	Boryeong
Fu-chhôn-sṳ	Bucheon
Sâm-chit-sṳ	Samcheok
Shuì-sân-sṳ	Seosan
Sàng-nàm-sṳ	Seongnam
Suk-chhó-sṳ	Sokcho
Sṳ́-hîn-sṳ	Siheung
Ngà-sân-sṳ	Asan
Ôn-sân-sṳ	Ansan
Ôn-sàng-sṳ (Hôn-koet)	Anseong
Ôn-yông-sṳ	Anyang (Gyeonggi)
Yòng-chû-sṳ	Yangju
Vû-sân-sṳ	Osan
Ngièn-chû-sṳ	Wonju
Ngi-vòng-sṳ	Uiwang
Ngi-chṳn-fú-sṳ	Uijeongbu
Li-chhôn-sṳ (Hôn-koet)	Icheon
Thî-chhôn-sṳ	Jecheon
Thiên-ôn-sṳ	Cheonan
Chhîn-chû-sṳ	Cheongju
Chhûn-chhôn-sṳ	Chuncheon
Thai-pha̍k-sṳ	Taebaek (Gangwon)
Po-chû-sṳ	Paju
Phìn-tshe̍t-sṳ	Pyeongtaek
Phàu-chhôn-sṳ	Pocheon
Hò-nàm-sṳ	Hanam
Fà-sàng-sṳ	Hwaseong
Buckingham Kiûng	Buckingham Palace
Hói-nàm	Hainan
Yén-tûng	Det fjerne østen
Ngiên-kiu	Forskning
Kâm-suk	Gansu
Pha̍k Se-pâu	Hvit blodcelle
York	York
Tsiú	Albue
Sṳ̂n-min-ki	Femte Mosebok
Sû-chû-sṳ	Suzhou
Vûn-chû-sṳ	Wenzhou
Windsor Sàng-páu	Windsor Castle
Hòn-chhu̍k	Han-kinesere
Nèn-pô-sṳ	Ningbo
Tet-koet-ngìn	Tyskere
Ko-men	Allergi
Fù-khì	Igler
Kîm-yùng	Finans
1000	1000 (tall)
Mìn-su-ki	Fjerde Mosebok
Liu̍k Khiet-vùn	Kevin Rudd
Ngo̍k-ǹg	Egentlige krokodiller
Yùn-nàm	Yunnan
Plymouth	Plymouth
Sân-tûng	Shandong
Pí	Arm
Derby-sṳ	Derby (Derbyshire)
Thàn-khîn Fa-ha̍p-vu̍t	Hydrokarbon
Hò-nàm	Henan
Montehermoso	Montehermoso
Liâu-nèn	Liaoning
El Cid	El Cid
Jim Morrison	Jim Morrison
Kóng-khiéu	Havn
Kit-lìm	Jilin (provins)
Fù-nàm	Hunan
Chhiâng-hói	Qinghai
Vì-ngâ-ngì-tshu̍k	Uighurer
Rhône-sén	Rhône (departement)
Koet-kâ Kûng-yèn	Nasjonalpark
Pâ-lì Charles-de-Gaulle Koet-chi Kî-chhòng	Charles de Gaulle internasjonale lufthavn
Chṳ̂-sán	Aktiva
O-le̍t-liòng	Aurelian
Fù-pet	Hubei
Sân-sî	Shanxi
Hòng-khûng Kûng-sṳ̂	Flyselskap
Hò-khiéu-vân	Estuar
Chûng-set	Brun
Kui-chû	Guizhou
Chûng-khi Sṳ̀n-kîn Ne-thúng	Sentralnervesystemet
Yî-fut-só	Efesos
Ôn-tha̍t-màn Hói	Andamanhavet
Yok-sû-â-ki	Josvas bok
Sî-pet Yîn-kak-làn	Nordvest-England
Shám-sî-sén	Shaanxi
Tûng-pet Yîn-kak-làn	Nordøst-England
Tûng Midlands	Øst-Midlands
Tûng Yîn-kak-làn	Øst-England
Tûng-nàm Yîn-kak-làn	Sørøst-England
Sî-nàm Yîn-kak-làn	Sørvest-England
模板:Commonscat	Mal:Commonscat
Sî Midlands	Vest-Midlands
Yorkshire lâu Humber	Yorkshire og Humber
Kòn Se-pâu	Stamcelle
Lò-mâ-sû	Paulus' brev til romerne
Mâ-liuk-kap Hói-hia̍p	Malakkastredet
Yù-thai Vòng-koet	Kongedømmet Judea
Fî-yí Mî-koet Het-ngìn	Afrikansk-amerikanere
Mà-sat-chû-set Lî-kûng Ho̍k-yen	Massachusetts Institute of Technology
Pô-sṳ-tun Thai-ho̍k	Boston University
Yâ-lû Thai-ho̍k	Yale University
Nàm-pet-chêu	Nord- og Sør-dynastienes tid
Liû-Sùng	Det tidlige Song-dynasti
Fûn-lî	Bryllup
Pan Chúng-thúng-chṳ	Semipresidentialisme
Kâ-phìn-khiùn	Gapyeong
Kô-sàng-khiùn (Hôn-koet)	Goseong (Gangwon)
Fâi-sân-khiùn	Goesan
Kím-sân-khiùn	Geumsan
Tan-yòng-khiùn (Hôn-koet)	Danyang (Nord-Chungcheong)
Po-ên-khiùn	Boeun
Fù-yì-khiùn	Buyeo (Sør-Chungcheong)
Sû-chhôn-khiùn	Seocheon
Yòng-khiéu-khiùn	Yanggu (Gangwon)
Siong-yòng-khiùn	Yangyang
Yòng-phìn-khiùn	Yangpyeong
Lî-chû-sṳ	Yeoju
Liên-chhôn-khiùn	Yeoncheon
Yún-thùng-khiùn	Yeongdong (Nord-Chungcheong)
Nèn-ye̍t-khiùn	Yeongwol
Lî-sân-khiùn	Yesan
Vok-chhôn-khiùn	Okcheon
Yîm-sàng-khiùn	Eumseong
Lîn-thài-khiùn	Inje
Tsin-san-khiùn	Jeongseon
Chên-phiàng-khiùn	Jeungpyeong
Chṳ́n-chhôn-khiùn	Jincheon
Thiet-ngièn-khiùn	Cheorwon
Chhiâng-yòng-khiùn	Cheongyang
Thai-ôn-khiùn	Taean
Fùng-sàng-khiùn	Hongseong
Fùng-chhôn-khiùn	Hongcheon
Fà-chhôn-khiùn	Hwacheon
Vàng-sàng-khiùn	Hoengseong
Fî-li̍p-pí-sû	Paulus' brev til filipperne
Thiên-koet Pat-fuk	Saligprisningene
Mî-koet Lièn-pâng Chún-phi Ne-thúng	Federal Reserve
Kúai-é	Springpadder
Hâ Sî-lî-sî-â-sén	Nederschlesiske voivodskap
Khù-â-vì - Pô-mî-là-nì-â-sén	Kujaviskpommerske voivodskap
Lû-pu-lìm-sén	Lublin voivodskap
Lû-pu-sṳ̂-khà-sén	Lubusz voivodskap
Lò-tsṳ-sén	Łódź voivodskap
Séu Pô-làn-sén	Lillepolske voivodskap
Mâ-tsó-fû-sá-sén	Masoviske voivodskap
O-pô-lòi-sén	Opole voivodskap
Khak-ngì-pâ-yèn-sân-sén	Subkarpatiske voivodskap
Pô-tet-là-chhia-sén	Podlasie voivodskap
Pô-mî-là-nì-â-sén	Pommerske voivodskap
Sî-lî-sî-â-sén	Schlesiske voivodskap
Sṳn-sṳ̍p-sṳ-sén	Helligkorsvoivodskapet
Sî Pô-mî-là-nì-â-sén	Vestpommerske voivodskap
Pâ-lùn-sî-â-sén	Valencia (provins)
Sat-là-kô-sat-sén	Zaragoza (provins)
Vùi-sṳ̂-khà-sén	Huesca (provins)
Baak-gaa-seng	Baijiaxing
Sok-lî-â-sén	Soria (provins)
Hien-thoi Khì-chhâ	Hyundai
Kîm Tsang-ên	Kim Jong-un
Phû-sien-ngî	Puxian
Kông-sî	Jiangxi
Wernher von Braun	Wernher von Braun
Nèn-ha	Ningxia
Lí Hién-liùng	Lee Hsien Loong
Kîm-fà-sṳ	Jinhua
Thòi-chû-sṳ	Taizhou (Zhejiang)
Phòng-châ-phú-ngî	Panjabi
Phú-sṳ̍p-thok-ngî	Pashto
Yâ-chû	Villsvin
Chû-hói-sṳ	Zhuhai
Sân-thèu-sṳ	Shantou
Shâu-kûan-sṳ	Shaoguan
Kông-mùn-sṳ	Jiangmen
Chhám-kông-sṳ	Zhanjiang
Shàu-khin-sṳ	Zhaoqing
Fi-chiu-sṳ	Huizhou (Guangdong)
Mòi-chiu-sṳ	Meizhou (Guangdong)
San-mî-sṳ	Shanwei
Hò-ngièn-sṳ	Heyuan
Yòng-kông-sṳ	Yangjiang
Chhîn-yén-sṳ	Qingyuan (Guangdong)
Tûng-kôn-sṳ	Dongguan
Chûng-sân-sṳ	Zhongshan (Guangdong)
Chhèu-chiu-sṳ	Chaozhou
Thiên-tén-yen	Tiandeng
Liùng-chiu-yen	Longzhou
Nèn-mìn-yen	Ningming
Thai-sîn-yen	Daxin
Sâ-chhà-chiòng	Shachasaus
Mâ-liuk-kap-sṳ	Malakka (by)
Khiâu-chhṳ-sṳ	George Town (Penang)
IPhone 5	IPhone 5
Nàm-Chhî	Det sørlige Qi-dynasti
Sṳn-chhôn-lî	Nattverd
Fuk-chiu-sṳ	Fuzhou
Nàm-phìn-sṳ	Nanping
Phû-thièn-sṳ	Putian
Sâm-mìn-sṳ	Sanming
Tshièn-chiu-sṳ	Quanzhou
Hà-mûn-sṳ	Xiamen
Chông-chiu-sṳ	Zhangzhou
Liùng-ngâm-sṳ	Longyan
Nèn-tet-sṳ	Ningde
Sî-pak-li-â Fú	Sibirtiger
Thiên-ngô-yen	Tian'e
Nàm-tan-yen	Nandan
Fung-sân-yen	Fengshan (Hechi)
Tûng-làn-yen	Donglan
Thông Ngiâ-mong	Johann Adam Schall von Bell
Yáng-chhiong Chín-thôn-ho̍k	Radiologi
Rumia	Rumia
La̍p-tsuk	Levende lys
Hiet-chiong	Blodplasma
Southampton	Southampton
Lu-tet-ki	Ruts bok
Hâ-sat-khiet-chhu̍k	Kasaker
Yòng-mî	Øyenstikkere og libeller
Chit-fûn-ho̍k	Integral (matematikk)
Kô-lìm-tô-chhièn-sû	Paulus' første brev til korinterne
Sî-pân-ngà Ti-koet	Det spanske imperiet
Pha̍k-yùn-khî (Kóng-chiu-sṳ)	Baiyun (Guangzhou)
Sṳ-sṳ̂-ki	Dommernes bok
Po-lîn-chhòi	Spinat
Pâ-set-lò-nâ-sén	Barcelona (provins)
Liuk-piên-hìn	Heksagon
Thòi-pet 101	Taipei 101
Lùn-tûn Thap-khiâu	Tower Bridge
Siù-li Yún-kòn-sien-chhùng	Caenorhabditis elegans
O-pô-lòi	Opole
Sopot	Sopot
Kám-lám-yù	Olivenolje
Chim-sin-fi	Baptisme
Vú-yî-sân-sṳ	Wuyishan (Nanping)
Set-vì-li-â-sén	Sevilla (provins)
Thap-là-kô-na̍p-sén	Tarragona (provins)
Provence-sén	Provence
Apeldoorn	Apeldoorn
Lìm-pó-ngî	Limburgsk
Khái-ngì-chhái	Kielce
Bytom	Bytom
Ôn-sit-ngit	Sabbat (jødisk)
Khìm-sṳ̂-thok-khok-ngá	Częstochowa
Zabrze	Zabrze
Ôn-sit-ngit-fi	Syvendedags Adventistsamfunnet
Jean Michel Jarre	Jean-Michel Jarre
Thai Pô-làn Thi-khî Kô-yî-fû	Gorzów Wielkopolski
Là-tô-mê	Radom (by i Polen)
Lo̍k-chham-ki-yen	Los Angeles County
Słupsk	Słupsk
Sosnowiec	Sosnowiec
Gliwice	Gliwice
Yo̍k-sṳ̂	Farmasøyt
Hi-kôn Yì-chhṳ̍t	Transplantasjon
Bielsko-Biała	Bielsko-Biała
Rybnik	Rybnik
Tân-fu̍t Se-pâu	Monocytt
Mâ-khó-fuk-yîm	Evangeliet etter Markus
Ruda Śląska	Ruda Śląska
Yok-thán-vòng	Jotam av Juda
Kîn-tû-fú	Kyoto (prefektur)
Kau-su	Professor
Thai-fán-fú	Osaka (prefektur)
Fuk-kông-yen	Fukuoka (prefektur)
Oi-yèn-yen	Ehime (prefektur)
Kô-lìm-tô-heu-sû	Paulus' andre brev til korinterne
Khien-mî	Kroppsbygging
Port Elizabeth	Port Elizabeth
Kimberley (Nàm-fî)	Kimberley (Sør-Afrika)
Yok-sâ-fap-vòng	Josjafat av Juda
Thòi-vân Hói-hia̍p	Taiwanstredet
Sî Khôi-phú-sén	Western Cape
Yamaguchi-yen	Yamaguchi (prefektur)
Khiâu-chhṳ Sâm-sṳ	Georg III av Storbritannia
Chûng-koet Thi-fông	Chūgokuregionen
Mî-koet Thu̍k-li̍p Siên-ngièn	USAs uavhengighetserklæring
Sâm-tshûng-yen	Mie (prefektur)
Yù-mu̍k mìn-chhu̍k	Nomade
Hiông-pak-su	Sederslekten
Hî-pak-lòi-sû	Brevet til hebreerne
Kâ-lâ-thai-sû	Paulus' brev til galaterne
Màn-é	Ålefisker
Sông-chhèu	Shang-dynastiet
Thai-thúi	Lår
Pîn-khù-yen	Hyōgo (prefektur)
Kiûng-khì-yen	Miyazaki (prefektur)
Yùng-pún-yen	Kumamoto (prefektur)
Stamford Raffles	Stamford Raffles
Sha̍m-é	Sangsikader
Tûng Khôi-phú-sén	Eastern Cape
Fap-koet Hòng-khûng	Air France
Kô-lò-sî-sû	Paulus' brev til kolosserne
Ngâ-kok-sû	Jakobs brev
Yok-hon-yit-sû	Johannes' første brev
Fî-li-mùn-sû	Paulus' brev til Filemon
Thiap-sat-lò-nì-kâ-heu-sû	Paulus' andre brev til tessalonikerne
Thiap-sat-lò-nì-kâ-chhièn-sû	Paulus' første brev til tessalonikerne
Pí-tet-chhièn-sû	Peters første brev
Thì-mô-thai-chhièn-sû	Paulus' første brev til Timoteus
Lí Kông-yeu	Lee Kuan Yew
Chṳ̂-kâ-kô Thai-ho̍k	University of Chicago
Tsṳ̂-fo-yen	Shiga (prefektur)
Mu-nì-het Kî-chhòng	Franz Josef Strauß lufthavn
Yok-hon-ngi-sû	Johannes' andre brev
Thì-mô-thai-heu-sû	Paulus' andre brev til Timoteus
Thì-tô-sû	Paulus' brev til Titus
Yî-sṳ̂-lâ-ki	Esras bok
Nì-hî-mí-ki	Nehemjas bok
Pietersburg	Polokwane
Séu Pha̍k-Lù	Silkehegre
Chhòn-ngiam-phiang	Infeksjonssykdom
Kôn-yàm	Hepatitt
Chhûn-chiet	Kinesisk nyttår
Shinzō Abe	Shinzō Abe
Mpumalanga-sén	Mpumalanga
Pet Khôi-phú-sén	Northern Cape
Tó-kîn-yen	Shimane (prefektur)
Kông-sân-yen	Okayama (prefektur)
Gauteng-sén	Gauteng
Thung-fûng	Urinsyregikt
Thai-fûn-yen	Ōita (prefektur)
Tiâu-tshí-yen	Tottori (prefektur)
Nùng-la̍k	Den kinesiske kalender
Kô-tî-yen	Kōchi (prefektur)
Liû-liên	Durian
Pha̍k-hèu	Difteri
Exeter	Exeter
Saint Lawrence-hò	St. Lawrence (elv)
Limpopo-sén	Limpopo (provins)
Kô-tén Kau-yuk	Høyere utdannelse
Sân-tá-kîn	Sandakan
Â-pí	Kota Kinabalu
Phok Kiún-fi	Park Geun-hye
Thòi-nàm-sṳ	Tainan
Mâ-lòi Pô-lî-nì-sî-â Ngî-chhu̍k	Malayopolynesiske språk
Fên-yòng-sṳ	Hengyang
Pet-lûn-khî	Beilun
Mân-chiu-tshu̍k	Mandsjuer
Zamość	Zamość
Malbork	Malbork
Ngo̍k-yòng-sṳ	Yueyang
BP	BP
Sú-thiàu	Pommes frites
Kiok-tsṳ́	Tå
Vî-liâm Â-li̍t-sân-thai (Hò-làn)	Willem-Alexander av Nederland
Sî-fù-khî (Hông-chû-sṳ)	Xihu (Hangzhou)
Mâ-nâ-sî-vòng	Manasse av Juda
Kî-kîm-fi	Stiftelse
A-hîn Kôn-yàm	Hepatitt A-virus
Yù-tsiâm-vong-khî	Yau Tsim Mong
Fûng-sái	Kaki
Tshṳ̍t-tshòng	Endetarm
Chhṳ-yù Pâng-sén	Free State
Tsó-fo-yen	Saga (prefektur)
Tet-tó-yen	Tokushima (prefektur)
Fu̍t-chhṳ̂ Khiung-chṳn Sṳ̀n-siong	Magnetresonanstomografi
Hiông-tshon-yen	Kagawa (prefektur)
Reading, Berkshire	Reading (Berkshire)
Kâ-chû Lî-kûng Ho̍k-yen	California Institute of Technology
Vì-ngì-tshṳ-páu Thai-ho̍k	Det bayerske Julius-Maximilian-universitetet i Würzburg
Fên-yòng-yen	Hengyang (Hengyang)
Êu-kí-lî-tet Kí-hò	Euklidsk geometri
Si̍t-kuk	Silicon Valley
Barneveld	Barneveld
Khiu Tha̍t-sîn	Thaksin Shinawatra
Thòi-sân-sṳ	Taishan (Jiangmen)
Lièn-phìn-yen	Lianping
Thai Sùn-thâ Khiùn-tó	De store Sundaøyer
Sî-pet-sén	North West (Sør-Afrika)
Sien-thon	Linjestykke
Vûn-tai	Temperert klima
Â-kûng	Besteforeldre
Thai-khi̍t-khièn	Tai chi chuan
Kiok-khwá	Ankelledd
Hò-làn Tâi-thi Sat-khiet-sùn-ngî	Vestnedertysk
Pân-kiêu-é	Turteldue
Tshòng-khì-yen	Nagasaki (prefektur)
Hà-chhèu	Xia-dynastiet
Chû-vì Sṳ̀n-kîn Ne-thúng	Det perifere nervesystemet
Lùn-tûn Thai-ho̍k	University of London
Kip-sú	Rekke (matematikk)
Nelspruit	Nelspruit
Sâ-là-ye̍t-chû	Sarawak
Â-chû Thai-phìn-yòng Kîn-tsi Ha̍p-tsok Fi-ngi	APEC
Kôan-chiet-yàm	Artritt
Ngò-piên Yì-chhu̍k Chhṳ-chhṳ-yen	Ebian Yi
Montauban	Montauban
Chhòng-sâ-sṳ	Changsha
Thai Put-lie̍t-tiên lâu Oi-ngì-làn Lièn-ha̍p Vòng-koet	Det forente kongerike Storbritannia og Irland
Kiok-kiên	Hæl
Kûng-fûn	Centimeter
Lièn-ha̍p Hòng-khûng	United Airlines
Yen-thèu	Svelg
Hò-mí	Millimeter
Mì-mí	Mikrometer
Pâ-mâ Yâu-chhu̍k Chhṳ-chhṳ-yen	Bama Yao
Khi̍t-han (Sú-ho̍k)	Grenseverdi
Theu-fú	Tofu
Phù-sat	Bodhisattva
Chóng-ló Kau-fi	Presbyterianisme
Nai-mí	Nanometer
Pâ-chûng-sṳ	Bazhong
Fu̍t-kông-yen	Fogang
Sâ-pâ-chû	Sabah
Nàm-nèn-sṳ	Nanning
Ngâ-li-ôn-ngìn	Ariere
Yù-sṳn-mî-thi Koet-kâ Kûng-yèn	Yosemite nasjonalpark
Ho̍k-yen	Fakultet (utdanning)
Kô-hiùng-sṳ	Kaohsiung
Pet-mî Chhṳ-yù Mo-yi Hia̍p-ngi	NAFTA
Sû-kak-làn-ngìn	Skotter
Rustenburg	Rustenburg
Yen-tsong-fui	Konsert
Yù-fu̍t-chû	Johor
Fì-tshu̍k	Huikinesere
Sha̍k-sṳ	Mastergrad
Preston, Lancashire	Preston (Lancashire)
Sî-tí-kâ-vòng	Sidkia av Juda
Sâm-koet	De tre rikers tid
Chhûn-chhiû Sṳ̀-khì	Vår- og høstannalenes tid
Chan-koet Sṳ̀-khì	De stridende staters tid
Mâ-liuk-kap-chû	Malakka
Pietermaritzburg	Pietermaritzburg
Kit-làn-tan-chû	Kelantan
Tshông-tshu̍k	Tibetanere
Pîn-sàng-chû	Penang
Blackburn	Blackburn
Chûng-sin Pha̍k-hiet-khiû	Nøytrofil granulocytt
Pâng-kâ-tó	Bangka
Phìn-chhông-khiùn	Pyeongchang
Thai-koet Koet-chi Hòng-khûng Kûng-sṳ̂	Thai Airways International
Hiûng-nù	Xiongnu
Phit-li̍t-chû	Perak
Lùn-tûn Ti-koet Ho̍k-yen	Imperial College London
Tsen-sàng-sṳ	Zengcheng
Kui-lìm-sṳ	Guilin
Siet-làn-ngô-chû	Selangor
Tui-kok-sien	Diagonal
Fi-li-phi Liuk-sṳ	Felipe VI av Spania
Kûng-tún	Tonn
Phàng-hên-chû	Pahang
中國象棋	Xiangqi
Pit-sṳn-hak	Pizza Hut
Ngo̍k-vûn-khiet-tshu̍k	Evenker
Kiu-ên	Frelse (kristendom)
Nàm-kîn Thai-thù-sat	Nanjingmassakren
Yún Chṳ-Hau	Yun Chi-ho
Phì-mí	Picometer
Chûng-koet 2010-ngièn Sông-hói Sṳ-kie Pok-lám-fi	Expo 2010
Ngiù-ngiuk	Storfekjøtt
Carlisle, Cumbria	Carlisle
Sandomierz	Sandomierz
Ngit-tèu-kông	Solstråling
Khwon-kûan-tsiet	Hofte
Chàu-yòng-sṳ	Shaoyang
Hién-mì-kiang	Mikroskop
Chông-phìn-sṳ	Zhangping
Chông-kâ-kie-sṳ	Zhangjiajie
Tsàu-ôn-yen	Zhao'an
Chau-phìn-yen	Zhaoping
Chṳ Sṳ̀n-kûng	Koxinga
Tsṳn-fò-yen	Zhenghe (Nanping)
Chin-siong-khî	Zhengxiang
Chṳ́n-hói-khî (Nèn-pô-sṳ)	Zhenhai
Tsà-yùng-yen	Zherong
Chûng-kông-yen	Zhongjiang
Chung-sân-yen	Zhongshan (Hezhou)
Tsû-nèn-yen	Zhouning
Chon-hiuk	Zhuanxu
Chu-chû-sṳ	Zhuzhou
Nàm-sâ-khî	Nansha
Kûng-tshun	Desimeter
McGill Thai-ho̍k	McGill University
Sâm-fòng Ńg-ti	Sanhuangwudi
Sanok	Sanok
Tsṳ́-kîm-yen	Zijin
Chhṳ-liù-chiáng-khî	Ziliujing
Milton Keynes	Milton Keynes
Ên-tién	Nåde
Hiong-sàng-khî	Xiangcheng (Zhangzhou)
Hî-lìn-tên-khî	Hillingdon (distrikt)
Chṳ̂-hîn-sṳ	Zixing
Chṳ̂-yòng-sṳ	Ziyang (Sichuan)
Chṳ̂-ngièn-yen	Ziyuan
Sṳ̀n-chhùng	Imago
Chang Thien-chṳ́ Fat-sa Kie-son-kî Thôn-chhèn Só-mèu	Positronemisjonstomografi
Przemyśl	Przemyśl
Chhiòn-khiû Sàng-sṳ	Verdensby
Pî-mí	Femtometer
Burnley	Burnley
Tûng Lùn-tûn, Tûng Khôi-phú-sén	East London
Li̍t-thoi-chṳ-ha	Andre Krønikebok
Biała Podlaska	Biała Podlaska
Mèu-tshu̍k	Miao
Pet-hói-sṳ	Beihai
Mafikeng	Mafikeng
Mí-sâ-yên Khiùn-tó	Visayas
Lò-pô-ôn-vòng	Rehabeam av Juda
Slough	Slough
Thì-mô-thai	Timoteus
Chho̍k-sṳ̂-lia̍p	Centromer
Tûng-hò, Néu-yok-sṳ	East River
Chhêu-fông-hìn	Hyperkube
Sêm-mî-làn-chû	Negeri Sembilan
Fidel Valdez Ramos	Fidel V. Ramos
Łomża	Łomża
Siong-thâm-sṳ	Xiangtan
Thûng-tshu̍k	Dong (folk)
Pak-fo Kûng-sṳ̂	Varemagasin
騷靈現象	Poltergeist
Tha̍t-vat-ngì-tshu̍k	Daur
Na̍p-sî-tshu̍k	Nakhi
Outaouais	Outaouais (Québec)
Kuî-é	Skilpadder
Pak-sâ-sat	Belsassar
Yî-set-lie̍t Vòng-koet	Kongedømmet Israel (Samaria)
Sîn-sân-sṳ	Johor Bahru
Khiu-kîm-sân Vân	San Francisco-bukta
Li Mâ-teu	Matteo Ricci
Tshài Yîn-vùn	Tsai Ing-wen
Chełm	Chełm
Â-ha̍p-vòng	Akab av Israel
Suwałki	Suwałki
Sî-làn-ngî	Zeeuws
Maidenhead	Maidenhead
Kiú-liùng	Kowloon
Nâ-pô-nì-tha̍t	Nabonidus
Kiap-kông-yen	Jiajiang
Hâ-phú-yen	Xiapu
Hî-sî-kâ-vòng	Hiskia av Juda
Thòi-chûng-sṳ	Taichung
Kîm-mùn-yen	Kinmen
Sîn-chuk-sṳ	Hsinchu
Kâ-ngi-sṳ	Chiayi
Kî-lùng-sṳ	Chilung
Busko-Zdrój	Busko-Zdrój
Àu-thai-li-â Ngièn	Australsk dollar
Thùng-lû-yen	Tonglu
Fuk-tshîn-sṳ	Fuqing
Nyèn-sân-khî	Yanshan (Guilin)
Ngo̍k-thòng-khî	Yuetang
Hon-ho̍k	Sinologi
Yî-pó-sṳ	Ipoh
Ná-pô-pha-lâ-sâ-ngì	Nabopolassar
Â-pí-ngâ-vòng	Abia av Juda
Sûn N̂g	Østre Wu
Pha̍k-chhu̍k	Bai (folk)
Chàu-tûng-yen	Shaodong
Lai-phú-yen	Lipu
Hâu-kông-khî	Haojiang
Yòng-sân-yen	Yangshan
Montréal-tó	Île de Montréal
IPhone 4	IPhone 4
Tûng-Chû	Det østlige Zhou-dynasti
Mâ-lòi-sî-â Hòng-khûng	Malaysia Airlines
Lì-tshu̍k	Li (folk)
Chûng-sî-khî (Hiông-kóng)	Sentral- og vestdistriktet
Mí-nâ-hien-vòng	Menahem av Israel
Â-ha̍p-chhia-vòng (Yî-set-lie̍t)	Akasja av Israel
Â-ha̍p-chhia-vòng (Yù-thai)	Akasja av Juda
Yok-làn-vòng (Yù-thai)	Joram
Â-sat-li-ngâ	Ussia av Juda
Yâ-lò-pô-ôn yit-sṳ	Jeroboam av Israel
Am-li-vòng	Omri av Israel
Nâ-tap-vòng	Nadab av Israel
Pâ-sâ-vòng	Basja av Israel
Yâ-fu-vòng	Jehu av Israel
Yok-sî-â-vòng	Josjia av Juda
Yok-â-sṳ̂-vòng (Yù-thai)	Joasj av Juda
Sîm-li-vòng	Simri av Israel
Yâ-lò-pô-ôn ngi-sṳ	Jeroboam II av Israel
Yî-vi-mí-lò-tha̍t	Amel-Marduk
Â-mâ-chhia-vòng	Amasja av Juda
Yî-sṳ̂-pô-sat-vòng	Isjbosjet
N̂g Chok-tùng	Goh Chok Tong
Â-sat-vòng	Asa av Juda
Â-mùn-vòng	Amon av Juda
Chong Koet-yùng（Chong Fat-chûng）	Leslie Cheung
Lí Tên-Fî	Lee Teng-hui
Yî-lâ-vòng	Ela av Israel
Yok-ngâ-kin-vòng	Jojakim av Juda
Hò-se-â-vòng	Hosea av Israel
Yok-ngâ-kîn-vòng	Jojakin av Juda
Biłgoraj	Biłgoraj
Puławy	Puławy
Chuk Hon	Shu Han
Chhâu Ngùi	Wei-dynastiet
Abitibi-Témiscamingue	Abitibi-Témiscamingue
Mò-tóng-sit	Partiløs politiker
Iwakuni-sṳ	Iwakuni
Kâu-thûng kûng-khí	Transportmiddel
Phok Hièn-yún	Park Hon-young
Sat-kâ-li-ngâ-vòng	Sakarja av Israel
Yok-ha̍p-sṳ̂-vòng	Joakas av Israel
Fùng Siù-chhiòn	Hong Xiuquan
Yok-â-sṳ̂-vòng (Yî-set-lie̍t)	Joasj av Israel
Yok-làn-vòng (Yî-set-lie̍t)	Joram av Israel
Pí-kâ-vòng	Pekah av Israel
Sâ-liùng-vòng	Sjallum av Israel
Pí-kâ-hot-vòng	Pekahja av Israel
Khiu Sṳ̀n-thûng	Shing-Tung Yau
Fùng Puk-kím Kiê	Gullfasan
Yok-ha̍p-sṳ-vòng	Joakas av Juda
Sin-ngióng	Brud
Chhiâng-pa̍k-kông-khî	Qingbaijiang
Mî-yî-mî-fi	Methodist Episcopal Church
瑤族	Yao (folk)
Wong Hi-zi	Wang Xizhi
Meu-nàm-khî	Maonan (Maoming)
Chûng-chhiû-chiet	Månefesten
Nài-lî-kak-li-sâ-ngì	Neriglissar
Pô-sṳ̂ Ti-koet	Akamenide-dynastiet
Nagato-sṳ	Nagato (Yamaguchi)
Sî-lìm-yen	Xilin (Baise)
Mâ-thai-fuk-yîm	Evangeliet etter Matteus
Â-chû Hòng-khûng	AirAsia
Yî-fut-só-sû	Paulus' brev til efeserne
Sòng-tet-sṳ	Changde
Yit-yòng-sṳ	Yiyang (Hunan)
Chhim-chû-sṳ	Chenzhou
Tshî Kông-khí	Xu Guangqi
Súi-nèn-sṳ	Suining (Sichuan)
Nui-kông-sṳ	Neijiang
Tha̍t-chû-sṳ	Dazhou
Ngá-ôn-sṳ	Ya'an
10000	10 000
Fún-fùng-set	Rosa
Nâ-sat-le̍t	Nasaret
Yî-tshu̍k	Yi (folk)
Mî-koet Kûng-lî-fi Chhâ-fi	American Board of Commissioners for Foreign Missions
Â-thâ-li-ngâ	Atalja
Augustów	Augustów
Windsor, Berkshire	Windsor (England)
Tai Tet-sâng	Hudson Taylor
Hòn Hòn	Han Han
Tczew	Tczew
Hâ-nì-tshu̍k	Hani
Fù-chṳ-mìn-sṳ Kî-chhòng	Tan Son Nhat internasjonale lufthavn
Hien-thoi Accent	Hyundai Accent
Vû-tsṳ-phe̍t-khiet-chhu̍k	Usbekere
Thap-kit-khiet-tshu̍k	Tadsjiker
Wal-Mart Kûng-sṳ̂	Walmart
Yùn-tôn yun-son	Nettskyen
Ńg-sùn-chiet Yun-thung	Pinsebevegelsen
Liu̍k-theu	Mungbønne
Chêu-siên-chhu̍k	Koreanere
Sông-hói Ha̍p-tsok Tsû-tsṳt	Shanghaigruppen
Reus	Reus
Sṳ̀n-chheu-fi	Assemblies of God
Fâ-tû-khî	Huadu
Sâ-â-nàm	Shah Alam
Kit-lùng-po Koet-chi Kî-chhòng	Kuala Lumpur internasjonale lufthavn
Ngiu̍k-Sân	Yushan (fjell)
Thai-yí-sân	Lantau
Het-tsat-tshu̍k	Hezhen
Sîn-chhèu	Xin-dynastiet
Mauricie	Mauricie
Khiùn	Kommanderi
Vû-yìn	Møkkfluer
Tha̍t-mâ-thai	Dalmatia
Witwatersrand Thai-ho̍k	Universitetet i Witwatersrand
Pat-phu-khî	Babu (Hezhou)
Ôn-fa-yen	Anhua
Hà (Sṳ̍p-liuk-koet)	Xia (sekstenkongerikene)
Sîn-chîn-yen	Xinjin
Mâ-lî-sûn	Robert Morrison
Mùng-sân-yen	Mengshan
Pán-khièu-khî	Panchiao
Thâm-súi	Tamsui
Fû-lùn-pi-ngì-sṳ	Hulun Buir
Ǹg-chiu-sṳ	Wuzhou
Fòng-sàng-kóng-sṳ	Fangchenggang
Khîm-chiu-sṳ	Qinzhou
Kui-kóng-sṳ	Guigang
Ngiu̍k-lìm-sṳ	Yulin (Guangxi)
Pak-set-sṳ	Baise (Guangxi)
Fo-chiu-sṳ	Hezhou
Hò-chhṳ̀-sṳ	Hechi
Lòi-pîn-sṳ	Laibin
Fuk-thièn-khî	Futian (Shenzhen)
Chhùng-chó-sṳ	Chongzuo
Lùng-fi-yen	Longhui
Thú-kâ-tshu̍k	Tujia
Lai-vân-khî	Liwan
Hîn-nèn-khî	Xingning (Nanning)
Siau-sân-khî	Xiaoshan
Fûng-khôi-yen	Fengkai
Khôi-phìn-sṳ	Kaiping (Jiangmen)
Tsit-sa̍k-sân Pó-ôn-tshu̍k Tûng-hiông-tshu̍k Sat-lâ-tshu̍k Tshṳ-tshṳ-yen	Jishishan
Mo-yi	Handel
Kô-mìn-khî	Gaoming
Saam-zi-gang	Tretegnsklassikeren
Thí-lîn-sṳ	Liling
Kóng-hon-sṳ	Guanghan
Meu-yen	Mao (Ngawa)
Ôn-hiông-yen	Anxiang
Ôn-hâi-yen	Anxi
Yo̍k-ho̍k	Farmasi
Chhiâng-yòng-khî	Qingyang (Chengdu)
Fi-yòng-khî	Huiyang
Kóng-tó-yen	Hiroshima (prefektur)
Thu̍k-liùng-tshu̍k	Derung
Ye̍t-nàm-ngî sṳ-mû	Quốc ngữ
Sîn Pâ-pí-lùn Vòng-koet	Det nybabylonske rike
Fuk-tín-sṳ	Fuding
Khîm-nàm-khî	Qinnan
Thú-ngí-khì-ngî sṳ-mû	Det tyrkiske alfabetet
Kien-yòng-sṳ	Jianyang (Nanping)
Kô-tá-ha̍p-lû-sṳ	Kota Bharu
Sú-chiuk-khiéu-phiang	Hånd-, fot- og munnsykdom
Kông-phú	Frekvensspekter
Yùn-siau-yen	Yunxiao
客家	Hakkaer
Pu-yî-chhu̍k	Bouyei
Mí-yi-yen	Miyi
Nâ-po-yen	Napo (Baise)
Ńg-fù Sṳ̍p-liuk-koet	Sekstenkongerikene
Néu-yok Tû-fi-khî	Storbyområdet New York
Ng̀-tshon-sṳ	Wuchuan (Zhanjiang)
Lanaudière	Lanaudière
Lo̍k-chhîn-sṳ	Yueqing
Eu-hói-khî	Ouhai
Liùng-vân-khî	Longwan
Lu̍k-sàng-khî	Lucheng (Wenzhou)
Phìn-yòng-yen	Pingyang (Wenzhou)
Yún-kâ-yen	Yongjia
Thung-thèu-yen	Dongtou
Ǹg-yèn	Fiskeboller
Chhṳ̀-hâi-sṳ	Cixi (Ningbo)
Thai-lû-kok Koet-kâ Kûng-yèn	Taroko nasjonalpark
Vòng Sṳ́m-tî	Wang Shenzhi
Phìn-fông Kûng-lî	Kvadratkilometer
Fâ-lièn-sṳ	Hualien
Shuì-ôn-sṳ	Rui'an
Fung-fa-sṳ	Fenghua
Chùng-chṳ́	Zongzi
Kôn-yîm	Guanyin
Lìm-pâ Se-pâu	Lymfocytter
Hak-kâ thú-lèu	Fujian Tulou
Chûng-fà Thai-ho̍k	Chung Hua-universitetet
Kô-sîn-shì	Keiser Ku
Jarosław	Jarosław
Gaspésie–Îles-de-la-Madeleine	Gaspésie-Îles-de-la-Madeleine
Pok-lò-yen	Boluo
Sa̍k-fûng-khî	Shifeng
Tshiâ-tshu̍k	She (folk)
Sên-sán	Produksjon
Thi-kip-sṳ	By på prefekturnivå
Mì-fûn-ho̍k	Differensial (matematikk)
Tûng-hiông-tshu̍k	Dongxiang (folk)
Lâ-fú-tshu̍k	Lahu
Chat-ho̍k Pok-sṳ	Filosofisk doktorgrad
Lì-tó-khî	Øydistriktet
Thông-phûng	Langtungebier
Tshûng-shîn-yen	Okinawa (prefektur)
Tshòng-lo̍k-sṳ	Changle (Fuzhou)
Yí-fù-khî	Yuhu
Sâm-súi-khî	Sanshui
Nàm-thin-sṳ	Nam Định
Montpellier Thai-ho̍k	Université de Montpellier
Kien-nèn-yen	Jianning
Lô-kông-khî	Luogang
Tshṳ-tshṳ-chû	Autonomt prefektur (Kina)
Medway	Medway (Kent)
Pó-ôn-khî	Bao'an (Shenzhen)
Pet-liù-sṳ	Beiliu
Nysa, Pô-làn	Nysa (Polen)
Pó-ôn-chhu̍k	Bonan
Kôan-tan-sṳ	Kuantan
Thâu-thông-shì	Keiser Yao
Kûng-lî	Kilometer
Abejar	Abejar
Shâu-sân-sṳ	Shaoshan
梅縣話	Meixianhua
Tai-tshu̍k	Dai (folk)
Mùn-pâ-tshu̍k	Monba
Kiong-tshu̍k	Qiang
Afrikaner-ngìn	Afrikandere
Ngá-tshu̍k	Wa (folk)
Kûng-yîn	Hektometer
Fû-yûng-sṳ	Seremban
Â-chhông-chhu̍k	Achang
Thú-tshu̍k	Tu (folk)
Kîn-mí	Gigameter
Sîn-lòng	Brudgom
Pân-kap	Spragledue
Súi-tshu̍k	Shui
Nyet-láu-tshu̍k	Gelao
Lo̍k-pâ-tshu̍k	Lhoba
Li̍t-siuk-tshu̍k	Lisu
Vì-kî Pak-khô Ngî-ngièn Lie̍t-péu	Liste over Wikipediaer
Siên-pî-chhu̍k	Xianbei
Pin-kông-khî	Binjiang
Pet-khî (Hiông-kóng)	Norddistriktet (Hongkong)
Mô-nàm-tshu̍k	Maonan (folk)
Mu̍k-láu-tshu̍k	Mulam
Sî-sûng-pán-na̍p Thài-tshu̍k Tshṳ-tshṳ-chû	Xishuangbanna
Tet-ngo-tshu̍k	De'ang
Pu-lóng-chhu̍k	Blang
Pok-pha̍k-yen	Bobai
Chhîn-sîn-yen	Qingxin
Pâ-thìn-khiùn	Ba Dinh
Bracknell Sêm-lìm	Bracknell Forest
Mìn-chú Chin-phu-tóng	Demokratisk framskrittsparti
Liú-kông-yen	Liujiang
Thiên-hò-khî	Tianhe
Po-thèu-khî	Potou
Liùng-mùn-yen	Longmen (Huizhou)
Hói-tshong-khî	Haicang
Montérégie	Montérégie
Nàm-hiùng-sṳ	Nanxiong
Hói-nàm-fa	Hainanesisk
Chhièn-Liòng	Tidlige Liang
Liú-sàng-yen	Liucheng
Sun-tet-khî	Shunde
Fân-nyî-khî	Panyu
Grahamstown	Grahamstown
Cape Town Thai-ho̍k	Universitetet i Cape Town
Phìn-lo̍k-yen	Pingle
Kui-phìn-sṳ	Guiping
Sasolburg	Sasolburg
Kûng-nèn-hîn Sú-kî	Dumtelefon
Tûng-sân-yen	Dongshan (Zhangzhou)
Hò-thòng-khî	Hetang
Si̍p-mî-khî	Jimei
Ǹg-fûng-khî	Yufeng
Kiú-liùng-sàng-khî	Kowloon-distriktet
Kóng-nèn-yen	Guangning
Sî-Liòng	Vestlige Liang
Fûng-hâi-khî	Fengxi
Lò-fù-khî	Luohu
Yàm-thièn-khî	Yantian
Khiâm-nàm Pu-yî-tshu̍k Mèu-tshu̍k Tshṳ-tshṳ-chû	Qiannan Buyei Miao
Lìm-ha Fì-tshu̍k Tshṳ-tshṳ-chû	Linxia (Gansu)
Liùng-kông-khî	Longgang (Shenzhen)
Graaff-Reinet	Graaff Reinet
Fu-yòng-sṳ	Fuyang (Zhejiang)
Yì-yâu-sṳ	Yuyao
Â-pa Chhong-chhu̍k Kiông-chhu̍k Chhṳ-chhṳ-chû	Ngawa
Vú-mîn-yen	Wuming
Lìm-ôn-sṳ	Lin'an (Hangzhou)
Hói-tsû-khî	Haizhu
Ye̍t-siù-khî	Yuexiu
Swellendam	Swellendam
Kwun-lò-sṳ	Miluo (Yueyang)
Vòng-pu-khî	Huangpu (Guangzhou)
Nàm-hói-khî	Nanhai
Sin-nî-sṳ	Xinyi (Maoming)
Lùng-ôn-yen	Long'an (Nanning)
Tû-kông-yén-sṳ	Dujiangyan
Mâ-sân-yen	Mashan (Nanning)
Sîn-fi-khî	Xinhui
Tshiùng-fa-sṳ	Conghua
Lièn-sân Chong-chhu̍k Yâu-chhu̍k Chhṳ-chhṳ-yen	Lianshan (Qingyuan)
Lo̍k-tshông-sṳ	Lechang
Lièn-chiu-sṳ	Lianzhou
Kô-yêu-sṳ	Gaoyao
Fû-yûng-khî	Furong
Hîn-nèn-sṳ	Xingning (Meizhou)
Ho̍k-sân-sṳ	Heshan (Jiangmen)
Yòng-chhûn-sṳ	Yangchun
Mo̍k-li̍t Tha̍t-ngá Tha̍t-vat-ngì-tshu̍k Tshṳ-tshṳ-khì	Morin Dawa Daur-banneret
Thùng-ôn-khî	Tong'an
Liu̍k-fûng-sṳ	Lufeng (Shanwei)
Thòi-kông-khî	Taijiang (Fuzhou)
Liùng-hói-sṳ	Longhai
Sa̍k-sṳ̂-sṳ	Shishi (Quanzhou)
Siông-ôn-khî	Xiang'an
Mên-hêu-yen	Minhou
Lìm-siong-sṳ	Linxiang (Yueyang)
Liù-yòng-sṳ	Liuyang
Lói-yòng-sṳ	Leiyang
Tsàu-vú-sṳ	Shaowu
Hói-shù-khî	Haishu
Kien-tet-sṳ	Jiande
Phî-yen	Pi (Chengdu)
Sîn-tû-khî	Xindu
Phìn-siông-sṳ	Pingxiang (Chongzuo)
Nî-chiu-sṳ	Yizhou (Hechi)
Tshîn-hói-khî	Chenghai
Yîn-tet-sṳ	Yingde
Sṳ̍p-fong-sṳ	Shifang
Vi	Magesekk
Tshông-sân-khî	Cangshan (Fuzhou)
Chhông-ǹg-yen	Cangwu
Liùng-hâ	Hummere
Pak-van-mí	Megameter
Kî-nok-tshu̍k	Jino
Chhém-hâi-sṳ	Cenxi
Chhà-lîn-yen	Chaling
Shèn-sàng-khî	Chancheng
Chhòng-sâ-yen	Changsha (Changsha)
Tshòng-thai-yen	Changtai
Tshòng-tin-yen	Changting
Chhòng-chû-khî	Changzhou (Wuzhou)
Tshèu-ôn-yen	Chao'an
Sî-Chû	Det vestlige Zhou-dynasti
Liông (Nàm-chhèu)	Liang-dynastiet
Sṳ̀n-Hòn	Cheng-Han
Sàng-phu Mèu-chhu̍k Chhṳ-chhṳ-yen	Chengbu Miao
Sàng-siong-khî	Chengxiang (Putian)
Tshak-kham-khî	Chikan
Sî-Hon	Det vestlige Han-dynasti
Chhùng-chû-sṳ	Chongzhou
Sùn-ôn-yen	Chun'an
Lí-sàng-khî	Licheng (Quanzhou)
Tha̍k-é	Dizi
Kiet-chhu̍k	Jie (folk)
Su-nèn-yen	Shouning
Thûng-chhôn-khî	Tongchuan (Dazhou)
Thai-phû-yen	Dabu
Thai-fa Yâu-chhu̍k Chhṳ-chhṳ-yen	Dahua Yao
Tân-yit kón-lî-khî	Enhetlig myndighet
Kú-thièn-yen	Gutian
Tet-pó-yen	Debao
Tet-fa-yen	Dehua
Hiông-kóng Thit-sṳ-nì Lo̍k-yèn Thu-ká-khî	Hong Kong Disneyland Resort
Tet-khin-yen	Deqing (Zhaoqing)
Tí-chhu̍k	Di (folk)
Fi-sàng-khî	Huicheng (Huizhou)
Chiáng-ngân-yen	Jingyan
Fài-si̍p-yen	Huaiji
Khien-vì-yen	Qianwei
Ńg-thûng-khiàu-khî	Wutongqiao
Kông-hói-khî	Jianghai
Khì-yen	Qu
Sun-khin-khî	Shunqing
Kô-phiàng-khî	Gaoping (Nanchong)
Mu̍k-chhôn-yen	Muchuan
Liú-pet-khî	Liubei
Liú-nàm-khî	Liunan
Thien-pha̍k-yen	Dianbai
Sông-lìm-yen	Shanglin
Thâm-thòng-khî	Tantang
Mòi-yen	Mei (Meizhou)
Chṳ̂-yòng-khî	Ziyang (Yiyang)
Sâm-kông Thûng-chhu̍k Chhṳ-chhṳ-yen	Sanjiang
Na̍p-hâi-khî	Naxi (Luzhou)
Mièn-chuk-sṳ	Mianzhu
Lièn-sàng-yen	Liancheng
Kô-chiu-sṳ	Gaozhou
Khiûng-lôi-sṳ	Qionglai
Si-fi-sṳ	Sihui
Ngièu-phìn-yen	Raoping
Lùi-chiu-sṳ	Leizhou
Sun-tshông-yen	Shunchang
Lò-ngièn-yen	Luoyuan
Phîn-nàm-yen	Pingnan (Ningde)
Phìn-thâm-yen	Pingtan
Nàm-ôn-sṳ	Nan'an (Quanzhou)
Àu-choi Fôn	Sadelnebbstork
Thia̍p-chhái-khî	Diecai
Ya̍k-sân-khî	Dieshan
Tín-sàng-khî	Dingcheng
Tín-fù-khî	Dinghu
Chhîn-sàng-khî	Qingcheng (Qingyuan)
Tûng-khî (Pan-kî-fâ-sṳ)	Dong (Panzhihua)
Tûng-hîn-sṳ	Dongxing (Fangchenggang)
Tûng-ngièn-yen	Dongyuan (Heyuan)
Kî-chhòng	Flyplass
Téu-mùn-khî	Doumen
Liu̍k-chhôn-yen	Luchuan
Tû-ôn Yâu-chhu̍k Chhṳ-chhṳ-yen	Du'an Yao
Tôn-chiu-khî	Duanzhou
Ha̍p-phû-yen	Hepu
Lî Ngâ-kok	James Legge
Yen	Fylke (Kina)
Lò-kông-yen	Luojiang (Deyang)
Thèn-yen	Teng (Wuzhou)
Thi-fông Kau-fi	Den lille hjord
Nàm-Yèn	Sørlige Yan
Nàm-Liòng	Sørlige Liang
Fûng-sun-yen	Fengshun
Siong-sân-yen	Xiangshan (Ningbo)
Ngiûn-chû-khî	Yinzhou (Ningbo)
Kông-pet-khî (Nèn-pô-sṳ)	Jiangbei (Ningbo)
Nèn-hói-yen (Chet-kông-sén)	Ninghai
Kông-kòn-khî	Jianggan
Ngò-mì-sân-sṳ	Emeishan
Siù-yí-khî	Xiuyu
Yún-tshûn-yen	Yongchun
Chàu-yòng-yen	Shaoyang (Shaoyang)
Sa̍k-kú-khî	Shigu
Tsiau-sàng-khî	Jiaocheng (Ningde)
Sien-yù-yen	Xianyou
Fên-sân-yen	Hengshan (Hengyang)
Yèn-phìn-khî	Yanping
Sîn-lò-khî	Xinluo
Phú-sàng-yen	Pucheng (Nanping)
Sâm-ngièn-khî	Sanyuan (Sanming)
Ngièn-fung-khî	Yanfeng
Hâm-kông-khî	Hanjiang (Putian)
Fûng-tshe̍t-khî	Fengze
Lai-sàng-khî	Licheng (Putian)
Sông-hông-yen	Shanghang
Tshiùng-hâi-yen	Songxi
Fên-nàm-yen	Hengnan
Vú-phìn-yen	Wuping
Fên-tûng-yen	Hengdong
Nàm-tshìn-yen	Nanjing (Zhangzhou)
Khî-tûng-yen	Qidong (Hengyang)
Lù-siung-khî	Lusong
Kâ-vò-yen	Jiahe
Sû-sien-khî	Suxian
Thâu-ngièn-yen	Taoyuan (Changde)
Liùng-fù-khî	Longhu
Sông-chhṳ̍t-yen	Sangzhi
Het-sân-khî	Heshan (Yiyang)
Kông-sàng-khî	Jiangcheng
Phûng-kông-khî	Pengjiang
Yòng-sî-yen	Yangxi
Hon-su-yen	Hanshou
Sa̍k-mùn-yen	Shimen (Changde)
Lìm-lí-yen	Linli
Lìm-vú-yen	Linwu
Kui-yòng-yen	Guiyang (Chenzhou)
Yòng-tûng-yen	Yangdong
Hiông-chû-khî	Xiangzhou (Zhuhai)
Liùng-mâ-thâm-khî	Longmatan
Ngiùn-hói-khî	Yinhai
Vú-siên-yen	Wuxuan
Kóng-nàm-khî (Kui-kóng-sṳ)	Gangnan
Yùng-yen (Chhṳ-kung-sṳ)	Rong (Zigong)
Meu-kóng-khî	Maogang
Kîm-phìn-khî	Jinping (Shantou)
Yùng-yen	Rong (Yulin)
Lû-yen	Lu (Luzhou)
Siong-sân-khî	Xiangshan (Guilin)
Chin-yòng-khî	Jingyang (Deyang)
Ket-sî-yen	Jiexi
Siù-fûng-khî	Xiufeng (Guilin)
Thièn-yòng-yen	Tianyang
Chhìn-sî-yen	Jingxi
Yún-fuk-yen	Yongfu
Thièn-tûng-yen	Tiandong
Kiûng-sàng Yâu-chhu̍k Chhṳ-chhṳ-yen	Gongcheng
Kung-chiáng-khî	Gongjing
Mòi-kông-khî	Meijiang
Hîn-pîn-khî	Xingbin
Siong-khiâu-khî	Xiangqiao
Hîn-ngia̍p-yen	Xingye
Kú-nìn-yen	Gulin
Lìn-yùn-yen	Lingyun
Lò-sàng Mu-láu-chhu̍k Chhṳ-chhṳ-yen	Luocheng
Yàm-piên-yen	Yanbian (Panzhihua)
Lìm-kui-yen	Lingui
Ket-tûng-yen	Jiedong
Sî-khî (Pan-kî-fâ-sṳ)	Xi (Panzhihua)
Kon-yòng-yen	Guanyang
Kîm-sàng-kông-khî	Jinchengjiang
Kóng-héu-khî	Gangkou (Fangchenggang)
Phû-pet-yen	Pubei
Ngiu̍k-chiu-khî	Yuzhou (Yulin)
Yùng-ôn-yen	Rong'an
Lìn-chhôn-yen	Lingchuan (Guilin)
Chhiòn-chiu-yen	Quanzhou (Guilin)
Van-siu-khî	Wanxiu
Khîm-pet-khî	Qinbei
Sîn-fûng-yen	Xinfeng (Shaoguan)
Fò-phìn-yen	Heping (Heyuan)
Kîm-vân-khî	Jinwan
Liùng-sṳn-kok-chhu̍k Chhṳ-chhṳ-yen	Longsheng
Sîn-sàng-yen	Xincheng (Laibin)
Thiet-sân-kóng-khî	Tieshangang
Siong-chiu-yen	Xiangzhou (Laibin)
Kîm-siu Yâu-chhu̍k Chhṳ-chhṳ-yen	Jinxiu Yao
Lùng-lìn Kok-chhu̍k Chhṳ-chhṳ-yen	Longlin
Chhiâng-siù-khî	Qingxiu
Chhit-sên-khî	Qixing
Thièn-lìm-yen	Tianlin
Liòng-khin-khî	Liangqing
Phìn-nàm-yen	Pingnan (Guigang)
Hói-sàng-khî	Haicheng (Beihai)
Phìn-kó-yen	Pingguo
Yung-nèn-khî	Yongning (Nanning)
Fòng-sàng-khî	Fangcheng (Fangchenggang)
Sông-sṳ̂-yen	Shangsi
Lìn-sân-yen	Lingshan
Lu̍k-tshài-yen	Luzhai
Hîn-ôn-yen	Xing'an (Guilin)
Phû-kông-yen	Pujiang (Chengdu)
Kîm-thòng-yen	Jintang
Vûn-kông-khî	Wenjiang
Phìn-yén-yen	Pingyuan (Meizhou)
Hói-fûng-yen	Haifeng
Lièn-nàm Yâu-chhu̍k Chhṳ-chhṳ-yen	Liannan
Liùng-tshôn-yen	Longchuan (Heyuan)
Liu̍k-hò-yen	Luhe (Shanwei)
Vú-hêu-khî	Wuhou
Liùng-chhièn-yi̍t-khî	Longquanyi
Chiau-liang-yen	Jiaoling
Kông-chiu-khî	Jiangzhou
Yu-kông-khî	Youjiang
Ha̍p-sân-sṳ	Heshan (Laibin)
Kîm-ngiù-khî	Jinniu
Kím-kông-khî	Jinjiang (Chengdu)
Phàng-chû-sṳ	Pengzhou
Kông-tûng-khî (Nèn-pô-sṳ)	Jiangdong
Hâ-sàng-khî	Xiacheng
Kiúng-shú-khî	Gongshu
Yì-hông-khî	Yuhang
Sông-sàng-khî	Shangcheng (Hangzhou)
Lo̍k-ngia̍p-yen	Leye
Windsor lâu Maidenhead	Windsor and Maidenhead
Mà-tsông-khî	Mazhang
Ńg-fà-yen	Wuhua (Meizhou)
Súi-hâi-yen	Suixi (Zhanjiang)
Sui-nèn-yen	Suining (Shaoyang)
Tshî-vùn-yen	Xuwen
Fuk-ôn-sṳ	Fu'an
Nàm-àu-yen	Nan'ao
Chîn-sṳ-sṳ	Jinshi (Changde)
Liâm-kông-sṳ	Lianjiang (Zhanjiang)
Mên-tshîn-yen	Minqing
Hâ-sân-khî	Xiashan
Vung-ngièn-yen	Wengyuan
Fa-chiu-sṳ	Huazhou (Maoming)
Kien-eu-sṳ	Jian'ou
Mâ-mî-khî	Mawei
Yún-thai-yen	Yongtai
Nèn-hiông-yen	Ningxiang
Liùng-vùn-khî	Longwen
Sṳ-mìn-khî	Siming
Yí-fâ-khî	Yuhua (Changsha)
Ngiên-kông-sṳ	Yuanjiang (Yiyang)
Fi-tûng-yen	Huidong (Huizhou)
Siong-thâm-yen	Xiangtan (Xiangtan)
Phìn-fò-yen	Pinghe
Thai-nèn-yen	Taining
Kông-tshe̍t-yen	Guangze
Yún-ôn-sṳ	Yong'an
Thí-ngoi Mo̍k-yòng-ha̍p	Ekstrakorporal membranoksygenering
Lìm Tan	Lin Dan
分類:Tet-koet	Kategori:Tyskland
分類:Yi-thai-li	Kategori:Italia
分類:Kâ-nâ-thai	Kategori:Canada
分類:Sî-pân-ngà	Kategori:Spania
分類:Chûng-koet	Kategori:Kina
分類:Ngi̍t-pún	Kategori:Japan
分類:Àu-thai-li-â	Kategori:Australia
分類:Yin-thu	Kategori:India
分類:Yî-set-lie̍t	Kategori:Israel
分類:Nàm-fî	Kategori:Sør-Afrika
Redcar and Cleveland	Redcar and Cleveland
分類:Yin-thu-nì-sî-â	Kategori:Indonesia
分類:Pâ-kî-sṳ̂-thán	Kategori:Pakistan
分類:Pô-làn	Kategori:Polen
分類:Sîn-kâ-po	Kategori:Singapore
分類:Hòn-koet	Kategori:Sør-Korea
分類:Thai-koet	Kategori:Thailand
分類:Ye̍t-nàm	Kategori:Vietnam
分類:Phú-nen-lui	Kategori:Pattedyr
分類:Tiâu	Kategori:Fugler
分類:Chhṳ̍t-vu̍t	Kategori:Planter
分類:Vu̍t-lí-ho̍k	Kategori:Fysikk
分類:Chhṳ-yèn Khô-ho̍k	Kategori:Naturvitenskap
分類:Sâng-vu̍t-ho̍k	Kategori:Biologi
分類:Fa-ho̍k	Kategori:Kjemi
分類:Li̍t-sṳ́	Kategori:Historie
分類:Thi-lî	Kategori:Geografi
分類:Sa-fi	Kategori:Samfunn
分類:Chûng-kau	Kategori:Religion
分類:Thí-yuk	Kategori:Sport
分類:Khô-ho̍k	Kategori:Vitenskap
分類:Lièn-ha̍p-koet	Kategori:FN
分類:Êu-chû Lièn-mèn	Kategori:Den europeiske union
分類:Kien-chuk-vu̍t	Kategori:Byggverk
分類:Thûng-sin	Kategori:Kommunikasjon
分類:Thi-khiù	Kategori:Jorden
Chhièn-Chhîn	Tidligere Qin
Chhièn-Yèn	Tidlige Yan
Sî Berkshire	West Berkshire
Hiông-kóng Thiet-lu Yû-han Kûng-sṳ̂	MTR Corporation
Thai-mo-sân	Tai Mo Shan
Heu-Yèn	Senere Yan
Pet-Liòng	Nordlige Liang
Chhièn-Chhàu	Han-Zhao
Sî-Chhîn	Vestlige Qin
Heu-Chhîn	Senere Qin
Kú Lò-mâ	Romerriket
Sân-thi-mâ-lî-ngî	Vestmarisk
Tsui-heu ke Sṳ́m-phan	Dommens dag
Yok-hon-nì-sṳ̂-páu Thai-ho̍k	Universitetet i Johannesburg
分類:Chet-ho̍k	Kategori:Filosofi
分類:Fu̍t-kau	Kategori:Buddhisme
分類:Kî-tuk-kau	Kategori:Kristendom
分類:Yù-thai-kau	Kategori:Jødedom
Pet-Yèn	Nordlige Yan
Ên-tiâu	Ørner
Ngùi Pó-lò	Paul Wei
Heu-Liòng	Senere Liang
Heu-Chhàu	Senere Zhao
Hò-sṳ̂n	Milliliter
Bochotnica	Bochotnica
香港客家話	Hongkong-hakka
分類:Hàng-sên	Kategori:Planeter
分類:Vùn-fa	Kategori:Kultur
分類:Ngìn-vùn Khô-ho̍k	Kategori:Humaniora
分類:Tî-sṳt	Kategori:Kunnskap
Hòn Sân-mìn	Theodor Hamberg
Phiàng-fa-sṳ	Foochow Romanized
Ngiu̍k-sân Koet-kâ Kûng-yèn	Yushan nasjonalpark
Ap-è	Ender
Lù-tshṳ̀	Skarver
分類:Yên-yèn	Kategori:Skuespillere
模板:Tl	Mal:Mal
模板:Userbox	Mal:Userbox
Nèn-pô-fa	Ningbohua
分類:Koet-kâ	Kategori:Land
Wikipedia:Kón-lî-yèn	Wikipedia:Administratorer
分類:Chûng-fà Mìn-chhu̍k	Kategori:Folkegrupper i Kina
分類:Ngìn-vu̍t	Kategori:Personer
分類:Mìn-chhu̍k	Kategori:Folkeslag
Wikipedia:Kî-hi-ngìn	Wikipedia:Roboter
分類:Sṳ̀-kiên	Kategori:Tid
分類:Chhṳ-yèn	Kategori:Natur
分類:Kûng-chhàng	Kategori:Ingeniørvitenskap
分類:Yî-ho̍k	Kategori:Medisin
分類:Chṳn-chṳ	Kategori:Politikk
分類:Kau-yuk	Kategori:Utdanning
分類:Kông-ho̍k	Kategori:Optikk
Âi-khi̍p	Egypt
分類:Chat-ho̍k-kâ	Kategori:Filosofer
模板:Bot	Mal:Bot
Kâ-nâ-thai	Canada
分類:Hiûng-ngà-li	Kategori:Ungarn
分類:Hî-lia̍p	Kategori:Hellas
分類:Lâ-thot-vì-â	Kategori:Latvia
分類:Yù-hi	Kategori:Spill
Thiên-koet	Himmelen
Phi Chhṳ-vùn	Elijah Coleman Bridgman
分類:Êu-chû koet-kâ	Kategori:Land i Europa
分類:Êu-chû	Kategori:Europa
模板:Documentation	Mal:Dokumentasjon
Wikipedia:Yung-fu	Wikipedia:Brukertyper
Pok-sṳ	Doktor
Wikipedia:Sa-khî	Wikipedia:Portal
分類:Wikipedians by language	Kategori:Wikipedia-brukere etter språk
Khi-néu Kî-chhòng	Hub
Khî-ngia̍p	Næringsliv
模板:Softredirect	Mal:Softredirect
模板:Delete	Mal:Hurtigsletting
分類:Kî-su̍t	Kategori:Teknologi
分類:Ngî-ngièn	Kategori:Språk
Wikipedia:Chhóng-kien Sîn Thiàu-muk	Hjelp:Hvordan starte en side
分類:含有損壞文件鏈接嘅頁面	Kategori:Sider med brutte fillenker
模板:Navbox	Mal:Navboks
Thoi-chhú	Kenguruer
模板:!	Mal:!
模板:Tnavbar	Mal:Tnavbar
模板:Unicode	Mal:Unicode
模板:Small	Mal:Small
模板:Nowrap	Mal:Nowrap
分類:Fî-chû	Kategori:Afrika
分類:Tûng Khôi-phú-sén	Kategori:Eastern Cape
分類:KwaZulu-Natal-sén	Kategori:KwaZulu-Natal
分類:Sṳn-kîn	Kategori:Bibelen
分類:Sî-pet-sén	Kategori:North West
分類:Si	Kategori:Bøker
模板:Pâ-phe̍t	Mal:Babel
模板:Reflist	Mal:Referanser
模板:Stub	Mal:Stubb
模板:User ca-1	Mal:Bruker ca-1
模板:User de	Mal:Bruker de
模板:User de-1	Mal:Bruker de-1
模板:User en-3	Mal:Bruker en-3
模板:User en-1	Mal:Bruker en-1
模板:User en-2	Mal:Bruker en-2
模板:User en-4	Mal:Bruker en-4
模板:User en-0	Mal:Bruker en-0
模板:User en	Mal:Bruker en
模板:User de-2	Mal:Bruker de-2
模板:User fr-2	Mal:Bruker fr-2
模板:User ja-1	Mal:Bruker ja-1
模板:User fr	Mal:Bruker fr
模板:Location map/Info	Mal:Kartposisjon/Info
分類:Khûn-chhùng	Kategori:Insekter
分類:Â-chû	Kategori:Asia
分類:Chṳ-li	Kategori:Chile
分類:Nàm-mî-chû	Kategori:Sør-Amerika
分類:Khà-sṳ̂-tì-li-â lâu Lòi-ngong	Kategori:Castilla y León
模板:Esoteric	Mal:Komplisert mal
分類:Mâ-lòi-sî-â	Kategori:Malaysia
分類:Sṳ̍t-phín	Kategori:Mat
模板:Mod	Mal:Mod
模板:User es-2	Mal:Bruker es-2
模板:Fôn-ngiàng	Mal:Reg-velkommen
分類:Chû-chṳt	Kategori:Organisasjoner
分類:Ngî-ngièn-ho̍k	Kategori:Lingvistikk
模板:非洲行政區劃	Mal:Afrikaland
模板:Infobox Country	Mal:Infoboks land2
分類:User en-4	Kategori:Bruker en-4
分類:User en	Kategori:Bruker en
分類:User zh	Kategori:Bruker zh
分類:User zh-N	Kategori:Bruker zh-N
分類:User en-2	Kategori:Bruker en-2
模板:User zh	Mal:Bruker zh
模板:Documentation/start box	Mal:Dokumentasjon/start boks
模板:Cite web	Mal:Kilde www
模板:Ombox	Mal:Pmboks
分類:Hòng-khûng	Kategori:Luftfart
分類:Yím-sṳ̍t	Kategori:Mat og drikke
模板:Fong-wui	Mal:Himmelretninger
模板:BS3	Mal:JBS3
分類:Tsúng-thúng	Kategori:Presidenter
模板:IPA	Mal:IPA
分類:Chṳn-chṳ Ngìn-lui	Kategori:Politikere
分類:Mî-chû	Kategori:Amerika
模板:其他	Mal:Andrebetydninger
分類:Language user templates	Kategori:Babel-maler
Wikipedia:GNU自由文檔協議證書	Wikipedia:GNU FDL
模板:Topicon	Mal:Toppikon
模板:Fmbox	Mal:Fmbox
模板:大洋洲行政區劃	Mal:Oseania
分類:Vùn-ho̍k-kâ	Kategori:Forfattere
分類:Kiûn-sṳ	Kategori:Militærvesen
分類:Thai-ho̍k	Kategori:Universiteter
模板:Lang-he	Mal:Lang-he
模板:Both	Mal:Both
分類:Sṳ-kie Pok-lám-fi	Kategori:Verdensutstillinger
模板:Documentation subpage	Mal:Dokumentasjonsunderside
模板:Purge	Mal:Oppdater
模板:Provinces of China	Mal:Kinas provinser
模板:Userpage	Mal:Brukerside
模板:User language-4	Mal:Babel4
分類:Ye̍t-nàm kî-chhòng	Kategori:Flyplasser i Vietnam
分類:Kûng-sṳ̂	Kategori:Selskaper
Â-mí	Attometer
模板:User fr-3	Mal:Bruker fr-3
分類:Thien-nó	Kategori:Datamaskiner
分類:Sṳ-chhòng	Kategori:Markeder
Mô-li-ngìn	Maorier
模板:Disambig	Mal:Peker
模板:Tick	Mal:Hake
分類:Khien-không Khô-ho̍k	Kategori:Helsevitenskap
分類:Hàng-thung Thien-fa	Kategori:Mobiltelefoner
模板:Lifetime	Mal:FD
模板:Lang-en	Mal:Lang-en
分類:Chhòn-ngiam-phiang	Kategori:Infeksjonssykdommer
分類:Sîn-kau	Kategori:Protestantisme
分類:Sâng-vu̍t	Kategori:Organismer
分類:Kâ-li-sî-â	Kategori:Galicia (Spania)
模板:歐洲行政區劃	Mal:Europa
分類:User yue	Kategori:Bruker yue
分類:User fr	Kategori:Bruker fr
分類:User ja	Kategori:Bruker ja
分類:User pt	Kategori:Bruker pt
分類:User nl-3	Kategori:Bruker nl-3
分類:User fr-2	Kategori:Bruker fr-2
分類:User ja-2	Kategori:Bruker ja-2
分類:User ko-N	Kategori:Bruker ko-N
分類:User fr-N	Kategori:Bruker fr-N
分類:Vùn-sṳ	Kategori:Skriftsystem
分類:Tho-kau	Kategori:Taoismen
分類:User ca	Kategori:Bruker ca
分類:User ca-1	Kategori:Bruker ca-1
分類:User de	Kategori:Bruker de
分類:User de-2	Kategori:Bruker de-2
分類:User de-N	Kategori:Bruker de-N
分類:User en-3	Kategori:Bruker en-3
分類:User en-N	Kategori:Bruker en-N
分類:User es	Kategori:Bruker es
分類:User es-2	Kategori:Bruker es-2
分類:User es-N	Kategori:Bruker es-N
分類:Hiông-kóng Thi-lî	Kategori:Hongkongs geografi
分類:Yî-set-lie̍t kiûn-vòng	Kategori:Konger av det gamle Israel
分類:Kí-hò-ho̍k	Kategori:Geometri
模板:Ye̍t-nàm	Mal:Vietnam region
分類:User ja-1	Kategori:Bruker ja-1
分類:User ko	Kategori:Bruker ko
Hà-mà	Padder
分類:Thiên-hi	Kategori:Vær
分類:Lièn-ha̍p-koet Pi-sû-chóng	Kategori:FNs generalsekretærer
分類:Hói-yòng	Kategori:Hav
分類:Thai-yòng-ne	Kategori:Solsystemet
分類:Kóng-tûng-sén	Kategori:Guangdong
分類:Fuk-kian	Kategori:Fujian
分類:Kîn-chi	Kategori:Økonomi
分類:Koet-chi Chû-chṳt	Kategori:Internasjonale organisasjoner
分類:Fat-mìn-kâ	Kategori:Oppfinnere
分類:Yím-liau	Kategori:Drikke
分類:User nan-N	Kategori:Bruker zh-min-nan-N
分類:Sa-fi Khô-ho̍k	Kategori:Samfunnsvitenskap
分類:Mî-koet Koet-kâ Kûng-yèn	Kategori:Nasjonalparker i USA
模板:!w	Mal:!wrap
分類:Thi-hìn	Kategori:Landformer
分類:Pâ-lùn-sî-â Chhṳ-chhṳ-khî	Kategori:Comunitat Valenciana
模板:User ja-2	Mal:Bruker ja-2
分類:Thiên-chú-kau	Kategori:Katolisisme
分類:User yue-N	Kategori:Bruker yue-N
分類:Yîm-ngo̍k-kâ	Kategori:Musikere
模板:!((	Mal:Open wikilink
模板:))!	Mal:Close wikilink
模板:Lang	Mal:Språk
分類:Fa-kâ	Kategori:Malere
分類:Yin-thu chûng-kau	Kategori:Religion i India
分類:Ngìn-lui	Kategori:Mennesker
分類:Yin-thu Thi-lî	Kategori:Indias geografi
分類:Fap-koet fòng-ti	Kategori:Franske keisere
分類:Meu-khô	Kategori:Kattedyr
分類:Thòi-vân Thi-lî	Kategori:Taiwans geografi
分類:Nì-pok Thi-lî	Kategori:Nepals geografi
分類:Thai-khûng-ngìn	Kategori:Romfarere
分類:Chûng-fà Mìn-tshu̍k Tshṳ-tshṳ-chû	Kategori:Autonome prefekturer i Kina
分類:Khî-ngia̍p-kâ	Kategori:Forretningsfolk
分類:Fî-li̍t-pîn	Kategori:Filippinene
分類:User nl	Kategori:Bruker nl
分類:User zh-1	Kategori:Bruker zh-1
分類:User zh-4	Kategori:Bruker zh-4
分類:User zh-3	Kategori:Bruker zh-3
分類:User zh-2	Kategori:Bruker zh-2
分類:Yin-thu kiûn-chú	Kategori:Indiske monarker
分類:Ho̍k-vi	Kategori:Akademiske grader
分類:Pô-sṳ̂ koet-vòng	Kategori:Persiske monarker
分類:Kîm-yùng	Kategori:Finans
分類:Thien-sṳ	Kategori:TV
分類:Chhòn-kau-sṳ	Kategori:Misjonærer
分類:Hói-hia̍p	Kategori:Sund
粵語	Kantonesisk
分類:Yin-Êu Ngî-ne	Kategori:Indoeuropeiske språk
分類:Kî-chhòng	Kategori:Flyplasser
分類:Fa-ho̍k ngièn-su	Kategori:Grunnstoffer
分類:Khô-ho̍k-kâ	Kategori:Forskere
分類:Pâ-kî-sṳ̂-thán Thi-lî	Kategori:Pakistans geografi
分類:Kî-tuk-kau lî-ngì	Kategori:Liturgi
分類:Nì-pok	Kategori:Nepal
分類:Thòi-vân	Kategori:Taiwan
分類:Chûng-koet chhèu-thoi	Kategori:Kinesiske dynastier
分類:Pet-mî-chû koet-kâ	Kategori:Land i Nord-Amerika
分類:Sṳ-tshòi	Kategori:Grønnsaker
分類:Súi-kó	Kategori:Frukt
分類:Khiu-yok Sṳn-kîn	Kategori:Det gamle testamente
分類:Pok-vu̍t-kón	Kategori:Museer
分類:Hì-hèu	Kategori:Klima
分類:Â-chû Thi-lî	Kategori:Asias geografi
分類:Ngìn-lui-ho̍k	Kategori:Antropologi
分類:Thai-khûng Chhàm	Kategori:Romstasjoner
分類:Fap-koet Thai-ho̍k	Kategori:Universiteter i Frankrike
分類:Thung-vu̍t	Kategori:Dyr
分類:Chit-chhûi Thung-vu̍t	Kategori:Virveldyr
分類:Ngî-yîm-ho̍k	Kategori:Fonetikk
分類:Hòng-khûng Kûng-sṳ̂	Kategori:Flyselskaper
分類:Ngìn-khièn	Kategori:Menneskerettigheter
分類:Ngo̍k-hi	Kategori:Musikkinstrumenter
分類:Ngî-ne	Kategori:Språkfamilier
分類:Pó-sa̍k	Kategori:Edelstener
分類:Koet-kâ Kûng-yèn	Kategori:Nasjonalparker
分類:Hi-siong-ho̍k	Kategori:Meteorologi
分類:Chûng-mî-chû	Kategori:Sentral-Amerika
分類:Hiông-kóng	Kategori:Hongkong
分類:Kóng-sî-sén	Kategori:Guangxi
分類:Yên-liau	Kategori:Brensel
分類:Sông-hói	Kategori:Shanghai
分類:Sin-sit kî-su̍t	Kategori:Informasjonsteknologi
分類:Ngiuk-lui	Kategori:Kjøtt
分類:Yo̍k-ho̍k	Kategori:Farmasi
分類:Sú-tû	Kategori:Hovedsteder
分類:Nàm-Â	Kategori:Sør-Asia
分類:Kham-thap-pu-lî-â	Kategori:Cantabria
分類:Â-sṳ̂-thù-lî-â-sṳ̂-sén	Kategori:Asturias
分類:Kîm-su̍k	Kategori:Metaller
分類:Thòi-pet-sṳ	Kategori:Taipei
分類:Lò-màn Ngî-chhu̍k	Kategori:Romanske språk
分類:Kâu-thûng	Kategori:Transport
分類:Ngiên-kiu	Kategori:Forskning
分類:Thông-lui	Kategori:Karbohydrater
分類:Fòng-ti	Kategori:Keisere
分類:Nàm-tó ngî-hì	Kategori:Austronesiske språk
分類:Pet-mî-chû	Kategori:Nord-Amerika
分類:Kô-sú	Kategori:Sangere
分類:Si-chhòng	Kategori:Tibet
分類:Sú-ho̍k-kâ	Kategori:Matematikere
分類:Vu̍t-lî ho̍k-kâ	Kategori:Fysikere
分類:Mìn-tsú	Kategori:Demokrati
分類:Kî-tuk-kau Li̍t-sṳ́	Kategori:Kirkehistorie
分類:Àu-mûn	Kategori:Macao
分類:Hàng-sên-ne	Kategori:Planetsystemer
分類:Hiông-kóng pan-tó	Kategori:Øyer i Hongkong
分類:Thòi-vân ngî-ngièn	Kategori:Språk på Taiwan
分類:Thòi-vân Koet-kâ Kûng-yèn	Kategori:Nasjonalparker i Republikken Kina
分類:Khiù-lui Yun-thung	Kategori:Ballsport
分類:Ngiùn-hòng	Kategori:Banker
Fu̍k-vu	Tjeneste
分類:Chûng-fà Ngìn-mìn Khiung-fò-koet	Kategori:Folkerepublikken Kina
分類:Kâ-thai-lò-nì-â	Kategori:Catalonia
Kap-kut-vùn	Orakelskrift
分類:Khien-không	Kategori:Helse
分類:User zh-classical-2	Kategori:Bruker zh-classical-2
Trojany	Trojany
分類:Â-chû koet-kâ	Kategori:Land i Asia
分類:Kûng-yèn	Kategori:Parker
分類:Hak-kâ-ngî	Kategori:Hakka
分類:Nui-mùng-kú Tshṳ-tshṳ-khî	Kategori:Indre Mongolia
分類:Chúng-chhu̍k	Kategori:Menneskerase
分類:Hiông-kóng Sân-Fûng	Kategori:Fjell i Hongkong
分類:Chûng-fà Mìn-koet	Kategori:Republikken Kina
分類:Siak-khiet-kau	Kategori:Sikhisme
分類:Sa-fi Mìn-tsú Tsú-ngi	Kategori:Sosialdemokrati
分類:Kú-thoi chhu̍k-khiùn	Kategori:Oldtidsfolk
分類:Pâ-set-lò-nâ-sén	Kategori:Barcelona (provins)
分類:Chûng-kau-ho̍k	Kategori:Religionsvitenskap
分類:User hak	Kategori:Bruker hak
分類:Thien-fa	Kategori:Telefoni
分類:Ngân-set	Kategori:Farge
分類:Â-là-kung	Kategori:Aragón
分類:Hak-kâ-ngìn	Kategori:Hakkaer
分類:Lie̍t-yî-tha̍t-sén	Kategori:Lleida (provins)
分類:User en-1	Kategori:Bruker en-1
分類:User de-1	Kategori:Bruker de-1
Li̍t-thoi-chṳ-song	Første Krønikebok
Liû-khiû Khiùn-tó	Ryukyuøyene
模板:User ru-3	Mal:Bruker ru-3
模板:User nl-3	Mal:Bruker nl-3
2013-ngièn Lù-sân Thi-chṳ́n	Jordskjelvet i Lushan i Sichuan 2013
Yòng-ya̍p-é	Rhopalocera
模板:Documentation/end box	Mal:Dokumentasjon/end boks
模板:Style/IPA	Mal:Style/IPA
模板:Style/yid	Mal:Style/yid
模板:Ping	Mal:Svar til
IPhone 5S	IPhone 5s
特殊:最近更改	Spesial:Siste endringer
模組:HtmlBuilder	Modul:HtmlBuilder
模組:Navbar	Modul:Navbar
模組:Navbox	Modul:Navbox
馬來西亞航空17號班機空難	Malaysia Airlines Flight 17
