ʻApelika	Afrika
Iāpana	Japan
‘Amelika Hema	Sør-Amerika
Nolewai	Norge
ʻIlelani	Irland
Hunakalia	Ungarn
Sepania	Spania
‘Amelika Hui Pū ‘ia	USA
Pelekiuma	Belgia
Lukemapuka	Luxembourg
Honua	Jorden
Keoki Wakinekona	George Washington
Pinilana	Finland
Kuekene	Sverige
Kenemaka	Danmark
Pōlani	Polen
Lituania	Litauen
ʻĪkālia	Italia
Kuikilani	Sveits
ʻAukekulia	Østerrike
Helene	Hellas
Tureke	Tyrkia
Potugala	Portugal
‘Eulopa	Europa
‘Ākia	Asia
‘Amelika ‘Ākau	Nord-Amerika
‘Ane‘ālika	Antarktika
Wikipikia	Wikipedia
Hōlani	Nederland
Wakinekona, D.C.	Washington, D.C.
Kapalakiko	San Francisco
Pelelina	Berlin
Barack Obama	Barack Obama
Lākana	London
Palika	Paris
Mekiko	Mexico
Moana ʻAkelanika	Atlanterhavet
Moana Pākīpika	Stillehavet
Kaleponi	California
Pokekona	Boston
Pō‘akahi	Mandag
Ianuali	Januar
Pepeluali	Februar
Malaki	Mars (måned)
Hōkū‘ula	Mars (planet)
Kenia	Kenya
‘Aikiopia	Etiopia
‘Apelila	April
Mei	Mai
Iune	Juni
Iulai	Juli
‘Aukake	August
Kepakemapa	September
‘Okakopa	Oktober
Nowemapa	November
Kēkēmapa	Desember
Pō‘alua	Tirsdag
Pō‘akolu	Onsdag
Pō‘ahá	Torsdag
Pō‘alima	Fredag
Pō‘aono	Lørdag
Pōpule	Søndag
Liona	Løve
Palani	Frankrike
‘Ōlelo Ekepelānako	Esperanto
Aupuni Mōʻī Hui Pū ʻia	Storbritannia
Pōpoki	Tamkatt
Kina	Folkerepublikken Kina
‘Ōlelo Palani	Fransk
Palakila	Brasil
Rūsia	Russland
Pai (makemakika)	Pi
‘Alapama	Alabama
Kelemānia	Tyskland
Belarusa	Hviterussland
ʻĀina Hau	Island
ʻEsetonia	Estland
Makulu	Saturn
1 (helu)	1 (tall)
Lakawia	Latvia
ʻUkelena	Ukraina
Tiekia	Tsjekkia
Solowakia	Slovakia
Solowenia	Slovenia
Molodowa	Moldova
Romānia	Romania
Pulukalia	Bulgaria
Loma	Roma
Repupalika o Masedonia	Republikken Makedonia
ʻAlepania	Albania
Koloatia	Kroatia
Bosenia me Hesegowina	Bosnia-Hercegovina
‘Akepaikana	Aserbajdsjan
ʻAnakola	Andorra
Kupelo	Republikken Kypros
Keokia	Georgia
Kasakana	Kasakhstan
Malata	Malta
Monako	Monaco
Montenegero	Montenegro
Wakikana	Vatikanstaten
Sana Marino	San Marino
‘Inidonesia	Indonesia
Wolfgang Amadeus Mozart	Wolfgang Amadeus Mozart
Ludwig van Beethoven	Ludwig van Beethoven
‘Alekelia	Algerie
Kelewikiona	Fjernsyn
Chile	Chile
Ukaliali‘i	Merkur
Hōkūloa	Venus
Ka‘āwela	Jupiter
Hele‘ekela	Uranus
Nepekune	Neptun (planet)
Kilo hōkū	Astronomi
Sinapoa	Singapore
Akeakamai	Vitenskap
Likenekaina	Liechtenstein
Makemakika	Matematikk
Baharaina	Bahrain
‘Āmēnia	Armenia
Seripia	Serbia
‘Aukekulelia	Australia
Kālaikūlohea	Fysikk
‘Alekina	Argentina
Kālaimeaola	Biologi
Kōlea ʻĀkau	Nord-Korea
Kamabodia	Kambodsja
Nalala	Dinosaurer
Hoʻomana Mohameka	Islam
Kālailau nahele	Botanikk
Sofia	Sofia
Kūlanakauhale	By
Lā	Solen
Kahua o nā hōkū	Solsystemet
Haikokene	Hydrogen
Hiliuma	Helium
Likiuma	Litium
Beryllium	Beryllium
Makahiki	År
Oslo	Oslo
Likepona	Lisboa
Rhône (kahawai)	Rhône
Boron	Bor (grunnstoff)
Kalepona	Karbon
Naikokene	Nitrogen
‘Okikene	Oksygen
Hōkū hele	Planet
Mokekao	Moskva
Fluorine	Fluor
ʻŌlelo ʻĪkālia	Italiensk
Nīane	Neon
Sodiuma	Natrium
Makanekiuma	Magnesium
‘Aluminuma	Aluminium
‘Īnia	India
Silikone	Silisium
Pokepola	Fosfor
Sulufura	Svovel
Kolorine	Klor
William Shakespeare	William Shakespeare
‘Aragona	Argon
Potasiuma	Kalium
Kalipuna	Kalsium
Monokolia	Mongolia
Scandium	Scandium
Titanium	Titan (grunnstoff)
Vanadium	Vanadium
Maine	Maine
Lio	Hest
Hoʻomana Buda	Buddhisme
Nū Hamekia	New Hampshire
Leonardo da Vinci	Leonardo da Vinci
Makakukeka	Massachusetts
Konekikuka	Connecticut
Hawai‘i	Hawaii
Moana ʻĀlika	Nordishavet
Heiti	Haiti
‘Ilana	Iran
‘Ilaka	Irak
‘Ālaka	Alaska
ʻIseraʻela	Israel
Panamā	Panama
Iemene	Jemen
Ioredāne	Jordan
Pololika	Florida
Kaikikana	Kirgisistan
‘Alikona	Arizona
Kuete	Kuwait
Laosa	Laos
Lepanona	Libanon
‘Olekona	Oregon
Maladiwa	Maldivene
Uka	Utah
Malaisia	Malaysia
Puruma	Myanmar
Nepala	Nepal
ʻOmana	Oman
Pakitana	Pakistan
Katala	Qatar
Saudi ʻAlapia	Saudi-Arabia
Sililanaka	Sri Lanka
Suria	Syria
Pokémon	Pokémon
Tailani	Thailand
Wiekanama	Vietnam
‘Apekanikana	Afghanistan
Banagaladesa	Bangladesh
Butana	Bhutan
Brunei	Brunei
ʻĀina Pilipino	Filippinene
Isaac Newton	Isaac Newton
Albert Einstein	Albert Einstein
Tunisia	Tunisia
Beijing	Beijing
Burakina Faso	Burkina Faso
ʻElikilea	Eritrea
Mauritiusa	Mauritius
Iulius Caesar	Julius Cæsar
Hamepuka	Hamburg
Huli honua	Geologi
Mikikana	Michigan
‘Ilinoe	Illinois
Tulinia	Thüringen
Kakoka ‘Ākau	Nord-Dakota
Kakoka Hema	Sør-Dakota
Monekana	Montana
Waiomina	Wyoming
‘Ikahō	Idaho
Wakinekona	Washington
Moana ʻIniana	Indiahavet
Kololako	Colorado
ʻAlepa	Alpene
Kikako, ʻIlinoe	Chicago
‘Ōlelo Sepania	Spansk
Montevideo	Montevideo
Johann Sebastian Bach	Johann Sebastian Bach
Wilikinia	Virginia
Wilikinia Komohana	Vest-Virginia
Nuioka	New York (delstat)
Loke ‘Ailana	Rhode Island
Melelana	Maryland
Kelawea	Delaware
‘Ohaio	Ohio
Penekelewinia	Pennsylvania
Uetersen	Uetersen
Augustus	Augustus
Nū ‘Ieleke	New Jersey
‘Ōlelo Pinilana	Finsk
‘Inikiana	Indiana
Keokia (‘Amelika Hui Pū ‘ia)	Georgia (USA)
Kekeka	Texas
Kalolaina Hema	Sør-Carolina
Seine	Seine
Buenos Aires	Buenos Aires
Mēkiko D.F.	Mexico by
Mikikipi	Mississippi
Kenekī	Tennessee
Nū Mekiko	New Mexico
‘Akenai	Athen
Minekoka	Minnesota
Wikonekina	Wisconsin
‘Iowa	Iowa
Nepalaka	Nebraska
Kanekaka	Kansas
Mikouli	Missouri
Luikiana	Louisiana
Kenekuke	Kentucky
‘Akanaka	Arkansas
‘Okalahoma	Oklahoma
Makekepuka	Magdeburg
Reykjavík	Reykjavík
Paipala	Bibelen
Thulium	Thulium
‘Ōlelo Pelekania	Engelsk
Đồng Hới	Dong Hoi
Concepción, Chile	Concepción
Końskowola	Końskowola
2000	2000
2003	2003
2002	2002
2001	2001
2009	2009
2008	2008
2004	2004
2005	2005
2006	2006
2007	2007
Lipekika	Leipzig
1998	1998
1999	1999
Kurów	Kurów
Kemika	Kjemi
Makelika	Madrid
Lima	Lima
Santiago de Chile	Santiago de Chile
Quito	Quito
Ankara	Ankara
Riyadh	Riyadh
Kamakeko	Damaskus
Amman	Amman
Muscat	Muskat (Oman)
Wikipedia:Sandbox	Wikipedia:Sandkasse
Wehimala	Weimar
Osasco	Osasco
Dong Hoi Airport	Dong Hoi lufthavn
Curitiba	Curitiba
Zichyújfalu	Zichyújfalu
Sarah Bernhardt	Sarah Bernhardt
Mauna Kana Helena	Mount St. Helens
Mokuhonua	Kontinent
Kapikala	Hovedstad
Monzón	Monzón
Almazán	Almazán
Puke noi‘i kū‘ikena	Encyklopedi
Ka papa kinohi	Portal:Forside
Vincent van Gogh	Vincent van Gogh
Frida Kahlo	Frida Kahlo
Michelangelo	Michelangelo
Pablo Picasso	Pablo Picasso
Raffael Santi	Rafael
Rembrandt	Rembrandt
Frank Lloyd Wright	Frank Lloyd Wright
Matsuo Bashō	Matsuo Basho
Castille a Leon	Castilla y León
Meka	Mekka
Gabriel García Márquez	Gabriel García Márquez
Johann Wolfgang von Goethe	Johann Wolfgang von Goethe
Māhele:Candidates for speedy deletion	Kategori:Sider som er foreslått raskt slettet
Homer	Homer
Hōʻole Akua	Ateisme
Kālaikaiaola	Økologi
Kālaiʻāina	Politikk
Aupuni	Regjering
Qin Shi Huang	Qin Shi Huangdi
Tolstoi	Leo Tolstoj
Moku‘āina	Stat
ʻŌlelo Lūkini	Russisk
‘Ōlelo Pākē	Kinesisk
Nelson Mandela	Nelson Mandela
Makani Pāhili	Tropisk syklon
Moʻokalaleo	Litteratur
Māhele:Palani	Kategori:Frankrike
Oboe	Obo
ʻOlumepika Kauwela ma 2008	Sommer-OL 2008
Granada	Granada
ʻĀtoma	Atom
Mohameka	Muhammed
Burgos	Burgos
Ronald Reagan	Ronald Reagan
‘Ōlelo Zaza	Zazaisk
Māhele:Palakila	Kategori:Brasil
Kumumea kemikala	Grunnstoff
‘Ohe kani	Fløyte
ʻAlea	Areal
Hulahula	Dans
Papa o nā ʻāina	Liste over stater
Miranda de Ebro (Burgos)	Miranda de Ebro
Kuli	Døvhet
Ponferrada	Ponferrada
Santander	Santander (by)
Helu piha	Heltall
‘Ōlelo ‘Alapia	Arabisk
Tiranosauru	Tyrannosaurus rex
Terikeratopa	Triceratops
Setegasauru	Stegosaurus
Barakiosauru	Brachiosaurus
Welokirapetoa	Velociraptor
Hae	Flagg
‘Ulu	Brødfrukt
Aupuni kiwikā	Kommune
Salamanca	Salamanca
Zamora (España)	Zamora (Spania)
Welemoneka	Vermont
Houston, Kekeka	Houston
Pēniki	Phoenix
Kakalameko	Sacramento
Honolulu, Hawaiʻi	Honolulu
Kauoha Hou	Det nye testamente
Rafael Correa	Rafael Correa
Louvre	Louvre
‘Ao‘ao Kū‘oko‘a Pokoliko	Partido Independentista Puertorriqueño
Kalikimaka	Jul
Mo‘ai	Moai
Hoʻolele hualono	Podkasting
Friedrich Schiller	Friedrich Schiller
Jean Auguste Dominique Ingres	Jean Auguste Dominique Ingres
Pule	Ukedager
Cervidae	Hjortedyr
Pule Alaka‘i A Ka Haku	Fader vår
Musée d'Orsay	Musée d'Orsay
Mokupuni	Øy
Moshchena	Mosjtsjena
ʻōhiʻa lomi	Tomat
Panalā‘au o Quảng Binh	Quang Binh (provins)
Bryan Cranston	Bryan Cranston
Felidae	Kattefamilien
Pichilemu	Pichilemu
Canidae	Hundefamilien
Karlstad	Karlstad
Mölnlycke	Mölnlycke
Bovidae	Okser
Phocidae	Selfamilien
ʻAnekelopa	Antiloper
‘Amelika	Amerika (andre betydninger)
Otariidae	Øreselfamilien
Pinnipedia	Seler
Zhengzhou	Zhengzhou
Mīkini helu	Kalkulator
Halakepoka	Hartford
‘Ōlelo Hawai‘i	Hawaiisk
Pea kina	Panda
Pae moku	Arkipel
Valparaíso	Valparaíso
‘Ōlelo Sāmoa	Samoansk
Marlon Brando	Marlon Brando
‘Ōlelo Kahiki	Tahitisk
Wailele ‘o Niakala	Niagarafallene
Mošovce	Mošovce
ʻAperodite	Afrodite
Nā mokuʻāina o ʻAmelika Hui	USAs delstater
Pauka niho	Tannkrem
Mineapoli	Minneapolis
Apia	Apia
Brigitte Bardot	Brigitte Bardot
Arancón	Arancón
'ōlelo toki pona	Toki pona
Paul Gauguin	Paul Gauguin
Teide	Teide
Kālaiʻelala	Entomologi
Ágreda	Ágreda
ʻAnekilosauru	Ankylosaurus
Waleluka	Hvalross
Johannes Vermeer	Johannes Vermeer
Teletubbies	Teletubbiene
Kahiki	Tahiti
Israel Kamakawiwoʻole	Israel Kamakawiwo'ole
Johnny Cash	Johnny Cash
Nanahana	Tempeltre
Hesioda	Hesiod
Josepa Samika	Joseph Smith
Pihemanu	Midwayøyene
Paris Hilton	Paris Hilton
Palapola	Parabel
Helu kumu	Primtall
Palencia	Palencia (provins)
ʻUkulele	Ukulele
Hawai‘i (mokupuni)	Hawaii (øy)
Georg Philipp Telemann	Georg Philipp Telemann
ʻUlano	Uranos
Coronel Fabriciano	Coronel Fabriciano
Pamela Anderson	Pamela Anderson
Gema	Edelsten
Puahōlani	Tulipanslekta
Nikolai Rimsky-Korsakov	Nikolaj Rimskij-Korsakov
Donald Sutherland	Donald Sutherland
Peter O'Toole	Peter O'Toole
Lili‘uokalani	Liliuokalani
Joey King	Joey King
X-Men	X-Men
Nika	Nyx
Mauna Kea	Mauna Kea
O‘ahu	Oahu
Sonata No. 8 no Piano (Beethoven)	Pianosonate nr. 8 (Beethoven)
ʻĀpana	Gu (forvaltningsenhet)
John Singer Sargent	John Singer Sargent
Sesame Street	Sesame Street
Aupuni Mōʻī o Hawaiʻi	Kongeriket Hawaii
Mauna Loa	Mauna Loa
Frans Hals	Frans Hals
Pō La‘i Ē	Glade jul
Nuʻuhiwa	Marquesasøyene
Edentata	Gomlere
Christopher Lee	Christopher Lee
Knoxville, Kenekī	Knoxville
Carl Larsson	Carl Larsson
Kīlauea	Kīlauea
Maui	Maui
Māmā	Tempo
Christopher Plummer	Christopher Plummer
Mokupuni o Hawai‘i	Hawaiiøyene
Ivan Shishkin	Ivan Sjisjkin
Moloka‘i	Molokai
Nancy Reagan	Nancy Reagan
Hakakā ‘ole	Ikke-drap
Kaua‘i	Kauai
Tigranes II	Tigranes I av Armenia
Georges de La Tour	Georges de la Tour
Ivan Kramskoi	Ivan Kramskoj
Roger Ebert	Roger Ebert
John Bauer	John Bauer
Adolfo Suárez	Adolfo Suárez
Thomas Eakins	Thomas Eakins
Kamehameha I	Kamehameha I
Hilo	Hilo
Anggun	Anggun
Kaho‘olawe	Kahoolawe
Kalo	Taro
Makua Kamiano	Damian de Veuster
Guadix	Guadix
Pete Seeger	Pete Seeger
Heleuī	Allehelgensaften
Waikīkī	Waikiki
Imelda Marcos	Imelda Marcos
Michael Gough	Michael Gough
Peterosauru	Pterodactylus
Richard Griffiths	Richard Griffiths
Donald Pleasence	Donald Pleasence
Andrew Wyeth	Andrew Wyeth
'Imi loa Dora	Dora utforskeren
Hua mele hapawalu	Åttedelsnote
Hua mele ‘oko‘a	Helnote
Hua mele hapahā	Firedelsnote
Maki a Ruby	Maks og Ruby
Jeddah	Jeddah
Hua mele hapa kanakolukūmālua	Trettitodelsnote
Kamehameha II	Kamehameha II
Hua mele hapalua	Halvnote
Anne Hathaway	Anne Hathaway (andre betydninger)
Kamehameha III	Kamehameha III
Buke a Moramona	Mormons bok
Carazo	Carazo (departement)
Pōmare IV	Pomare IV av Tahiti
Tan Son Nhat International Airport	Tan Son Nhat internasjonale lufthavn
Láchar	Láchar
Baza	Baza
San Vicente del Raspeig	San Vicente del Raspeig
Nā kiaʻāina o Hawaiʻi	Liste over guvernører i Hawaii
Ka'aahi Thomas	Lokomotivet Thomas og vennene hans
Likaono	Lykaon
Mauna kai	Undervannsfjell
Huahine	Huahine
Honolulu International Airport	Honolulu internasjonale lufthavn
Līhuʻe	Lihue
Viveiro	Viveiro
‘Ārue	Arue
Abejar	Abejar
Pōmare II	Pomare II av Tahiti
Pōmare I	Pomare I av Tahiti
Pōmare III	Pomare III av Tahiti
Hua mele hapa ‘umikūmāono	Sekstendelsnote
Covarrubias	Covarrubias
Pele	Pele (gudinne)
Aiga-i-le-Tai	Aiga-i-le-Tai
Wikipedia:Nohona kuhina	Wikipedia:Ambassade
Manuae	Manuae (Fransk Polynesia)
Māhele:Kelemānia	Kategori:Tyskland
Māhele:ʻAmelika Hui Pū ʻia	Kategori:USA
Māhele:Sepania	Kategori:Spania
Māhele:Mekiko	Kategori:Mexico
Māhele:Pōlani	Kategori:Polen
Māhele:Wiekanama	Kategori:Vietnam
Māhele:Hōʻike honua	Kategori:Geografi
Māhele:Akeakamai	Kategori:Vitenskap
Māhele:Disambig	Kategori:Pekere
Albert Küchler	Albert Küchler
Hua mele hapa hanelekūmāiwakāluakūmāwalu	Hundreogtjueåttedelsnote
Hua mele hapa kanaonokūmāhā	Sekstifiredelsnote
Bochotnica	Bochotnica
Sanna Nielsen	Sanna Nielsen
Conrad Bain	Conrad Bain
Māhele:Nā ‘āinapuni‘ole	Kategori:Kontinenter
Zoboomafoo	Zoboomafoo
Anakuhi:Nā hōkū hele o ke kahua o nā hōkū	Mal:Solsystem
Wikipedia:Nā kahu	Wikipedia:Administratorer
Wikipedia:Lopako	Wikipedia:Roboter
‘Aikupika	Egypt
Anakuhi:Lopako	Mal:Bot
Kanakā	Canada
Māhele:Hunakalia	Kategori:Ungarn
Māhele:Helene	Kategori:Hellas
Māhele:Solowakia	Kategori:Slovakia
Māhele:ʻEulopa	Kategori:Europa
Māhele:Wikipedians by language	Kategori:Wikipedia-brukere etter språk
Wikipedia:‘Ōmuku	Wikipedia:Stubb
Anakuhi:Softredirect	Mal:Softredirect
Anakuhi:Kāpae	Mal:Hurtigsletting
Māhele:‘Ōlelo	Kategori:Språk
Māhele:Wikipikia	Kategori:Wikipedia
Wikipedia:Nā a‘o ‘ana laulā	Wikipedia:Generelle forbehold
Wikipedia:Manuale Kaila	Wikipedia:Stilmanual
Anakuhi:Navbox	Mal:Navboks
Anakuhi:!	Mal:!
Anakuhi:Tnavbar	Mal:Tnavbar
Māhele:ʻApelika	Kategori:Afrika
Anakuhi:Papela	Mal:Babel
Anakuhi:Commons	Mal:Commons
Anakuhi:ʻŌmuku	Mal:Stubb
Anakuhi:User de	Mal:Bruker de
Anakuhi:User en	Mal:Bruker en
Anakuhi:User fr	Mal:Bruker fr
Māhele:ʻĀkia	Kategori:Asia
Māhele:21st century	Kategori:2000-tallet
Māhele:Castille a Leon	Kategori:Castilla y León
Anakuhi:Mod	Mal:Mod
Anakuhi:Aloha	Mal:Reg-velkommen
Anakuhi:Wikipediasister	Mal:Søsterprosjekt
Anakuhi:Wide image	Mal:Panoramabilde
Māhele:Palika	Kategori:Paris
Māhele:User en	Kategori:Bruker en
Anakuhi:User ru	Mal:Bruker ru
Anakuhi:Pule	Mal:Ukedager
Anakuhi:Huaʻōlelo puana like	Mal:Peker
Māhele:User fr	Kategori:Bruker fr
Māhele:Panalāʻau o Quảng Binh	Kategori:Quang Binh
Māhele:User de	Kategori:Bruker de
Māhele:User de-N	Kategori:Bruker de-N
Māhele:User en-N	Kategori:Bruker en-N
Anakuhi:ʻŌnaehana helu	Mal:Tallmengder
Māhele:Huli kanaka	Kategori:Samfunnsvitenskap
Māhele:Kahawai o Palani	Kategori:Elver i Frankrike
Māhele:User ru	Kategori:Bruker ru
Māhele:Kahaki‘i	Kategori:Malere
Māhele:Hawai‘i	Kategori:Hawaii
Māhele:Kanaka o Hawaiʻi	Kategori:Personer fra Hawaii
Māhele:Panalā‘au o Granada	Kategori:Byer i Granada
Māhele:Kelewikiona	Kategori:TV
Māhele:Nolewai	Kategori:Norge
Māhele:Kapikala	Kategori:Hovedsteder
Trojany	Trojany
Māhele:Haku mele (ho‘okani)	Kategori:Komponister
Module:Citation/CS1/Whitelist	Modul:Citation/CS1/Whitelist
Module:Yesno	Modul:Yesno
Module:Category handler	Modul:Category handler
Module:Arguments	Modul:Arguments
Papa nui:NāLoliHou	Spesial:Siste endringer
Module:Citation/CS1	Modul:Citation/CS1
Module:Citation/CS1/Configuration	Modul:Citation/CS1/Configuration
Module:Namespace detect	Modul:Namespace detect
Module:HtmlBuilder	Modul:HtmlBuilder
Module:Navbar	Modul:Navbar
Module:Navbox	Modul:Navbox
