អាហ្វ្រិក	Afrika
ជប៉ុន	Japan
អង់គ្លេស	England
ស្កុតឡែន	Skottland
វ៉ែល	Wales
អៀរឡង់ខាងជើង	Nord-Irland
សាធារណរដ្ឋអៀរឡង់	Irland
ប្រទេសហុងគ្រី	Ungarn
អេស្ប៉ាញ	Spania
សហរដ្ឋអាមេរិក	USA
ផែនដី	Jorden
ប៊ឺណឺស លី	Tim Berners-Lee
ស៊ុយអែត	Sverige
ប្រទេសប៉ូឡូញ	Polen
អ៊ីតាលី	Italia
ព័រទុយហ្គាល់	Portugal
អឺរ៉ុប	Europa
អាស៊ី	Asia
វិគីភីឌា	Wikipedia
ភីអេចភី	PHP
ទីក្រុងញូវយ៉ក	New York
កុំព្យូទ័រ	Datamaskin
អ៊ីនធើណេត	Internett
បារ៉ាក់ អូបាម៉ា	Barack Obama
ប៉ារីស	Paris
អាប្រាហាម លីនខូន	Abraham Lincoln
ប្រព័ន្ធប្រតិបត្តការ Android	Android
Google ស្វែងរក	Google
ម៉ិកស៊ិក	Mexico
មហាសមុទ្រអាត្លង់ទិក	Atlanterhavet
មហាសមុទ្រប៉ាស៊ីហ្វិក	Stillehavet
ថ្ងៃច័ន្ទ	Mandag
ខែមករា	Januar
ខែកុម្ភៈ	Februar
ខែមីនា	Mars (måned)
ភពអង្គារ	Mars (planet)
ខែមេសា	April
ខែឧសភា	Mai
ខែមិថុនា	Juni
ខែកក្កដា	Juli
ខែសីហា	August
ខែកញ្ញា	September
ខែតុលា	Oktober
ខែវិច្ឆិកា	November
ខែធ្នូ	Desember
អង្គារ	Tirsdag
ថ្ងៃពុធ	Onsdag
ថ្ងៃព្រហស្បតិ៍	Torsdag
ថ្ងៃសុក្រ	Fredag
ថ្ងៃសៅរ៍	Lørdag
ថ្ងៃអាទិត្យ	Søndag
សេះ (​អុក​)	Springer (sjakk)
បារាំង	Frankrike
សត្វឆ្កែ	Tamhund
រាជាណាចក្ររួម	Storbritannia
ឆ្មា	Tamkatt
ភាសាបារាំង	Fransk
ប្រេស៊ីល	Brasil
រុស្ស៊ី	Russland
ការ៉េ	Kvadrat
សមុទ្រ	Hav
អាល្លឺម៉ង់	Tyskland
ភាសាអាល្លឺម៉ង់	Tysk
ប្រទេសអាយឡែន	Island
ភពសៅរ៍	Saturn
១ (លេខ)	1 (tall)
២ (លេខ)	2 (tall)
៣ (លេខ)	3 (tall)
៥	5 (tall)
ចតុកោណកែង	Rektangel
មុំកែង	Rettvinklet
អ៊ុយក្រែន	Ukraina
ទីក្រុងរ៉ូម	Roma
អាល់បានី	Albania
អាស៊ែបៃហ្សង់	Aserbajdsjan
អង់ដូរ៉ា	Andorra
សាធារណរដ្ឋកាហ្សាក់ស្ថាន	Kasakhstan
បុរីវ៉ាទីកង់	Vatikanstaten
គុយបា	Cuba
ឥណ្ឌូនេស៊ី	Indonesia
អាហ្វ្រិកខាងត្បូង	Sør-Afrika
ប្រវត្តិសង្ខេប ក្រុមតន្រ្តី រ៉ុក linkin park	Linkin Park
ប្រទេសអាល់ហ្សេរី	Algerie
ស្រា	Vin
ទឹក	Vann
ទូរទស្សន៏	Fjernsyn
ភាសាអាយឡែន	Islandsk
ឈីលី	Chile
ព្រះយេស៊ូវ គ្រីស្ទ	Jesus Kristus
ភពពុធ	Merkur
ប្រវត្តិសាស្ត្រ	Historie
ភពសុក្រ	Venus
ភាសា	Språk
ភពព្រហស្បតិ៍	Jupiter
ភពអ៊ុយរ៉ានុស	Uranus
វិគីភីឌាភាសាអង់គ្លេស	Wikipedia på engelsk
ភពណិបទូន	Neptun (planet)
សិង្ហបុរី	Singapore
ភ្លុយតុង	Pluto
ហ្វេសប៊ុក	Facebook
សង្គ្រាមលោកលើកទីមួយ	Første verdenskrig
សង្គ្រាមលោកលើកទី២	Andre verdenskrig
ទំព័រគំរូ:Corruption	Korrupsjon
Ubuntu	Ubuntu (operativsystem)
គណិតវិទ្យា	Matematikk
បារ៉ែន	Bahrain
ព្រះចន្ទ	Månen
អូស្ត្រាលី	Australia
រូបវិទ្យា	Fysikk
ជីវវិទ្យា	Biologi
កូរ៉េខាងជើង	Nord-Korea
ព្រះរាជាណាចក្រកម្ពុជា	Kambodsja
ឌីណូស័រ	Dinosaurer
សាសនាឥស្លាម	Islam
សេរីភាព	Fred
សហភាពអឺរ៉ុប	Den europeiske union
ចេក	Bananer
ណាប៉ូលេអុងបូណាប៉ារត៍	Napoléon Bonaparte
ព្រះអាទិត្យ	Solen
ឆ្នាំពន្លឺ	Lysår
អូសេអានី	Oseania
ប្រព័ន្ធព្រះអាទិត្យ	Solsystemet
អុីដ្រូសែន	Hydrogen
ទីម័រខាងកើត	Øst-Timor
ម៉ុង ប្លុង	Mont Blanc
សឺរេស	Ceres (dvergplanet)
អៀរីស	Eris (dvergplanet)
ភព	Planet
តន្ត្រី	Musikk
ភាសាអ៊ីតាលី	Italiensk
អាលុយមីញ៉ូម	Aluminium
នូវែលសេឡង់	New Zealand
ឥណ្ឌា	India
អង់ដ្រេ ម៉ារី អំពែរ	André-Marie Ampère
វីលីម ហ្សេកស្ពែរ	William Shakespeare
ប៉ាឡាវ	Palau
ម៉ុងហ្គោលី	Mongolia
ជេនហ្គិស ខាន់	Djengis Khan
កូឡុំប៊ី	Colombia
ព្រះពុទ្ធសាសនា	Buddhisme
ហ្គាតេម៉ាឡា	Guatemala
មហាសមុទ្រអាកទិក	Nordishavet
អ៊ីរ៉ង់	Iran
ភាសាប៉ូឡូញ	Polsk
ហ្សកដង់	Jordan
កៀហ៊្សីស៊ីស្ថាន	Kirgisistan
គុយវ៉ែត	Kuwait
ឡាវ	Laos
លីបង់	Libanon
ទ្វីបអាមេរិក	Amerika
ម៉ាឡេស៊ី	Malaysia
មីយ៉ាន់ម៉ា	Myanmar
នេប៉ាល់	Nepal
ប៉ាគីស្ថាន	Pakistan
MySQL	MySQL
អារ៉ាប៊ីសាអូឌីត	Saudi-Arabia
ស្រីលង្កា	Sri Lanka
ផ្លាតូ	Platon
តាជីគីស្ថាន	Tadsjikistan
YouTube	YouTube
អារីស្តូត	Aristoteles
ថៃ	Thailand
វិទ្យុ	Radio
តួរមិនីស្ថាន	Turkmenistan
វៀតណាម	Vietnam
កូរ៉េខាងត្បូង	Sør-Korea
សាធារណរដ្ឋឥស្លាមអាហ្វហ្កានីស្ថាន	Afghanistan
ព្រែកជីកស៊ុយអែស	Suezkanalen
បង់ក្លាដែស្ស	Bangladesh
សូក្រាត	Sokrates
ធ្វិតថឺរ	Twitter
ប៊្រុយណេ	Brunei
ហ្វីលីពីន	Filippinene
អ៊ីសាក់ ញូតុន	Isaac Newton
OpenStreetMap	OpenStreetMap
អាល់បឺត អែងស្តែង	Albert Einstein
ប្រទេសហ្សំប៊ី	Zambia
ប៉េកាំង	Beijing
មហាត្មះគន្ធី	Mahatma Gandhi
ឆាលែស ដាវីន	Charles Darwin
ជូលីស៍ សេសារ	Julius Cæsar
ឥន្ទធនូ	Regnbue
អង្គការសហប្រជាជាតិ	De forente nasjoner
ភូមិវិទ្យា	Geografi
ទីក្រុងប្រាក	Praha
បន្ទុកអគ្គីសនី	Elektrisk ladning
ខេត្តជើងភ្នំ (ប្រទេសអ៊ីតាលី)	Piemonte
មហាសមុទ្រឥណ្ឌា	Indiahavet
អូសាម៉ា ប៊ីន ឡាឌែន	Osama bin Laden
ភាសាអេស្ប៉ាញ	Spansk
ភីឡាដេលផ្យា	Philadelphia
ញូវយ៉ក	New York (delstat)
វ្លាឌីមៀរ អ៊ីលីច លេនីន	Vladimir Lenin
អូហ្គុសទុស	Augustus
លោកកៃយុសសេសារ	Caligula
ត្រាហ្សាន	Trajan
Kde	KDE Software Compilation
កូរ៉ាស៊ូន អាគីណូ	Corazón Aquino
ទីក្រុងតូខ្យូ	Tokyo
ហ្វឺឌីណាន់ដ៏ ម៉ាហ្សេឡង់	Ferdinand Magellan
ស៊ីសេរ៉ូ	Marcus Tullius Cicero
ភ្នំពេញ	Phnom Penh
ទីក្រុងព្រៃនគរ	Ho Chi Minh-byen
ទីក្រុងហានូយ	Hanoi
ភាសាអង់គ្លេស	Engelsk
គូឡាឡាំពួ	Kuala Lumpur
២០០១	2001
JavaScript	JavaScript
ល្បឿនពន្លឺ	Lysets hastighet
JPEG	JPEG
អេឡិចត្រុង	Elektron
ចក្រភព រ៉ូម	Det romerske keiserriket
Microsoft	Microsoft
គីមីវិទ្យា	Kjemi
ស៊ីទ្រុងជ្រូក	C Sharp
បេណេឌីកទី១៦	Benedikt XVI
៧ កក្កដា	7. juli
បាល់ទាត់	Fotball
ទីក្រុងបូកូតា	Bogotá
ថ្ងៃទី៣១ខែធ្នូ	31. desember
រិសថា	4 Vesta
ស៊ីដនីយ៏	Sydney
ភ្លើង	Ild
ខ្យល់	Jordens atmosfære
កោះស៊ូម៉ាត្រា	Sumatra
ចាការតា	Jakarta
ចំណាត់ថ្នាក់ក្រុម:Wikipedia templates	Kategori:Maler
កោះជ្វា	Java (øy)
ចំណាត់ថ្នាក់ក្រុម:ចំណាត់ថ្នាក់ក្រុមនៃទំព័រគំរូវិគីភីឌា	Kategori:Maler etter tema
កាលីម៉ាន់តាន់	Kalimantan
ខេត្តបន្ទាយមានជ័យ	Banteay Meancheay
វិគីភីឌា:ប្រអប់ខ្សាច់	Wikipedia:Sandkasse
អាកាសយានដ្ឋាន ដុង ហ៊យ	Dong Hoi lufthavn
អាន់ ហ្វ្រែង	Anne Frank
ខុង ជឺ	Konfucius
ម៉ារីលីន ម៉ុនរ៉ូ	Marilyn Monroe
ចំណាត់ថ្នាក់ក្រុម:គណិតវិទ្យា	Kategori:Matematikk
ចំណាត់ថ្នាក់ក្រុម:ប្រវត្តិសាស្ត្រខ្មែរ	Kategori:Kambodsjas historie
ចំណាត់ថ្នាក់ក្រុម:ប្រវត្តិសាស្រ្តសិង្ហបុរី	Kategori:Singapores historie
សមុទ្រ មេឌីទែរ៉ានេ	Middelhavet
វីនដូអេច	Windows 8
ទំព័រគំរូ:Agree	Mal:For
ទន្លេហ្គារ៉ូន	Garonne
ស៊ីតថល	Seattle
ជញ្ជាំង ប៊ែរឡាំង	Berlinmuren
ស្រូវ	Ris
ទំព័រគំរូ:ផតថល	Mal:Portal
ប៊ីល ហ្គេត	Bill Gates
ភាសាជប៉ុន	Japansk
ប្រជុំវីជ្ជា	Encyklopedi
ឌីវីឌី	DVD
ទំព័រដើម	Portal:Forside
Central processing unit	CPU
រេស៊ីស្ទ័រ	Motstand (resistor)
កីឡាអូឡាំពិក	Olympiske leker
សមុទ្រ កាសព្យែន	Det kaspiske hav
ឈី ហ្គីវ៉ារ៉ា	Che Guevara
ទីក្រុងកាបូល	Kabul
ហ្គ្រាប្រីអ៊ែល ហ្រ្គារ៉ាស្សៀ ម៉ារ៉ាហ្គេស	Gabriel García Márquez
ទស្សនវិជ្ជា	Filosofi
ចំណាត់ថ្នាក់ក្រុម:លុប	Kategori:Sider som er foreslått raskt slettet
លិទ្ធិកុម្មុយនិស្ត	Kommunisme
ហ៊ីលឡារី រូដហេម គ្លីនតុន	Hillary Clinton
Boeing 737	Boeing 737
អាហារនៅប្រទេសបារំាង និង របៀបធ្វើ	Det franske kjøkken
មណ្ឌលម៉ាញេតូ	Magnetosfære
UTC+7	UTC+07.00
ភាសាកាតាឡាន	Katalansk
បណ្ណាល័យ	Bibliotek
នីល ហេនរីក ដេវីដ ប៊័រ	Niels Bohr
និវេសនវិទ្យា	Økologi
ក្លឹបបាល់ទាត់បារសេឡូណា	FC Barcelona
នយោបាយ	Politikk
ធនាគារពិភពលោក	Verdensbanken
ប្រជាធិបតេយ្យ	Demokrati
អង្គការសន្ធិសញ្ញាអាត្លង់ទិកខាងជើង	NATO
ម៉ារី ស្កូដូស្កា គុយរី	Marie Curie
រង្វាន់ណូបែល	Nobelprisen
មជ្ឈិមបូព៌ា	Midtøsten
រាជវង្សហាន	Han-dynastiet
ប្រទេស	Stat
គ្រឹស្តុបផើ កូឡំបូស (Christopher Columbus)	Christofer Columbus
ព្រែកជីកប៉ាណាម៉ា	Panamakanalen
មហាសមុទ្រខាងត្បូង	Sørishavet
ក្មេង	Barn
លេអុនហាដ អយល័រ	Leonhard Euler
ណាប៉ូលេអុងទី៣	Napoleon III av Frankrike
ភាសារុស្ស៊ី	Russisk
ល្វី ដ៏អស្ចារ្យ	Ludvig XIV av Frankrike
សមាគមប្រជាជាតិអាស៊ីអាគ្នេយ៍	Association of Southeast Asian Nations
ប្រវត្តិសាស្ត្របារាំង	Frankrikes historie
តុលាការយុត្តិធម៌អន្តរជាតិ	Den internasjonale domstolen
យូណេស្កូ	UNESCO
អង្គការសុខភាពពិភពលោក	Verdens helseorganisasjon
អង្គការពាណិជ្ជកម្មពិភពលោក	Verdens handelsorganisasjon
ភាសាចិន	Kinesisk
ធម្មជាតិ	Natur
ឈាម	Blod
រញ្ជួយផែនដី	Jordskjelv
សមុទ្រឡាប់តែវ	Laptevhavet
ភ្លើងចរាចរ	Trafikklys
ម៉ាទីន ឡូតធឺរ ឃីង	Martin Luther King jr.
ត្រីកោណមាត្រ	Trigonometri
ធរណីមាត្រ	Geometri
វេយ្យាករណ៍	Grammatikk
សេដ្ឋកិច្ច	Samfunnsøkonomi
អក្សរក្រិច	Det greske alfabetet
អក្សរឡាតាំង	Det latinske alfabetet
រឿងមហាភារតយុទ្ធ	Mahabharata
ការិយាល័យសហព័ន្ធស៊ើបអង្កេត	Federal Bureau of Investigation
វីយោឡុង	Fiolin
ឃឹម	Cimbalom
អេឡិចសាន់ដឺ ដឹ ហ្គារ៉ែត	Aleksander den store
សង្គម	Samfunn
ការអប់រំ	Utdannelse
មនុស្សប្រុស	Mann
សិទ្ធិមនុស្ស	Menneskerettigheter
ទាសភាព	Slaveri
សង្គ្រាមស៊ីវិល	Borgerkrig
ភ្នំ	Fjell
ហុងកុង	Hongkong
សង្គ្រាមត្រជាក់	Den kalde krigen
សេអ៊ូល	Seoul
សង្គ្រាមវៀតណាម	Vietnamkrigen
ម៉ៃឃើល ហ្វារ៉ាដេយ	Michael Faraday
អង់រីកូ ហ្វែរមី	Enrico Fermi
ភាសាអ៊ុយក្រែន	Ukrainsk
HTML	HTML
ច្យូហានេស គូទេនបឺគ	Johann Gutenberg
ភាសាដាណឺម៉ាក	Dansk
ភាសាអេស្តូនី	Estisk
ហិណ្ឌូសាសនា	Hinduisme
ភាសាពែក	Persisk
សាសនា	Religion
ភាសាកូរ៉េ	Koreansk
ភាសាខ្មែរ	Khmer (språk)
ហ្រ្គេតស៊ីងមួន	Sigmund Freud
ភាសាថៃ	Thai
ភាសាម៉ាឡេ	Malayisk
ភាសាឥណ្ឌូនេស៊ី	Indonesisk
ភាសាហេប្រ៊ូ	Hebraisk
ចន ឡុក	John Locke
ថ្លើម	Lever
ចិត្តវិទ្យា	Psykologi
មហាសមុទ្រ	Verdenshav
ពុទ្ធប្រវត្តិសង្ខេប	Buddha
ចរិយាមារយាទ	Etikk
សារជីវកម្មផ្សព្វផ្សាយព័ត៌មានរបស់ចក្រភពអង់គ្លេស(BBC)	BBC
ក្លិបបាល់ទាត់ឆេលស៊ី	Chelsea FC
ក (អវយវៈ)	Hals
រាជវង្សថាង	Tang-dynastiet
John F. Kennedy	John F. Kennedy
LibreOffice	LibreOffice
ផ្លូវរូងដីក្រោមសមុទ្រ	Kanaltunnelen
តារាងខួបនៃធាតុគីមី	Periodesystemet
ប្រូម៉ាស	Ost
ទំពាំងបាយជូរ	Druer
បន្លែ	Grønnsak
បច្ចេកវិទ្យា	Teknologi
វិស្វកម្ម	Ingeniørvitenskap
ទំនាក់ទំនង	Kommunikasjon
វិជ្ជាជីវៈខាងសារព័ត៌មាន	Journalistikk
កាសែត	Avis
ទូរស័ព្ទ	Telefon
វប្បធម៌	Kultur
សំស្ក្រឹត	Sanskrit
ប្រដាប់របត់ឈាម	Sirkulasjonssystem
The Guardian	The Guardian
សមីការឌីផេរ៉ង់ស្យែល	Differensialligning
មៃក្រូសូហ្វអ៊ិសេល	Microsoft Office Excel
មុំ	Vinkel
សំទុះ	Akselerasjon
ព្រះសិវៈ	Shiva
ព្រះវិស្ណុ	Vishnu
Local Area Network	Lokalnett
Wide Area Network	Vidstrakt datanett
ព្រះព្រហ្ម	Brahma
កម្លាំង	Kraft
អេឡិចត្រូម៉ាញ៉េទិច	Elektromagnetisme
កសិកម្ម	Landbruk
សំលៀកបំពាក់	Klær
ល្បឿន	Hastighet
ក្រដាស	Papir
សុញ្ញកាស	Vakuum
ស៊ីនេម៉ាទិច	Kinematikk
ក្រលាផ្ទៃ	Areal
ទ្រឹស្តីបទពីតាករ	Pythagoras’ læresetning
ចំនួនកុំផ្លិច	Komplekst tall
Cristiano Ronaldo	Cristiano Ronaldo
អ្នកថតរូប	Fotografi
ល្ខោន	Teater
គ្រឿងអេឡិចត្រូនិច	Elektrisk komponent
ព័ត៌មានវិទ្យា	Informasjons- og kommunikasjonsteknologi
អាស៊ីអាគ្នេយ៍	Sørøst-Asia
ក្រុងសៀមរាប	Siem Reap
បញ្ជីរាយនាម ប្រទេស	Liste over stater
ប្រដាប់រំលាយអាហារ	Fordøyelse
កីឡាចាក់សាប	Fekting
រោគផ្ដាសាយធម្មតា	Forkjølelse
រោគសរសៃប្រសាទ	Psykisk lidelse
ប្រតិទិន ក្រេកូរី	Gregoriansk kalender
សុខភាព	Helse
ជម្ងឺរលាកទងសួត	Lungebetennelse
ជំងឺអេដស៍	Aids
កូដ QR	QR-kode
ជំងឺទឹកនោមផ្អែម	Diabetes
ទំព័រគំរូ:Location map Belgium	Mal:Kartposisjon Belgia
ទំព័រគំរូ:Location map Croatia	Mal:Kartposisjon Kroatia
ទំព័រគំរូ:Location map Ukraine	Mal:Kartposisjon Ukraina
ទំព័រគំរូ:Location map Burma	Mal:Kartposisjon Myanmar
ទំព័រគំរូ:Location map Philippines	Mal:Kartposisjon Filippinene
ទំព័រគំរូ:Location map Vietnam	Mal:Kartposisjon Vietnam
ទំព័រគំរូ:Location map Cambodia	Mal:Kartposisjon Kambodsja
ទំព័រគំរូ:Location map Thailand	Mal:Kartposisjon Thailand
ទំព័រគំរូ:Location map Indonesia	Mal:Kartposisjon Indonesia
ទំព័រគំរូ:Location map Australia	Mal:Kartposisjon Australia
ញូតុន	Newton (enhet)
ចក្រភព អូតូម៉ង់	Det osmanske rike
ម៉ាស៊ីនចំហេះក្នុង	Forbrenningsmotor
ក្បាច់គិតលេខ	Abakus (kuleramme)
វឺតប្រែស	WordPress
Joomla!	Joomla!
ដើមដូង	Kokospalme
ភាសាណាវ៉ាថ្ល៍	Nahuatl
ភាសាម៉ាយ៉ាយូកាតិក	Yukatansk maya
អែនជេលីណា ចូលី	Angelina Jolie
អ៊ីលដឺហ្រ្វែន	Île-de-France
ភាសាអារ៉ាប់	Arabisk
Thanksgiving	Thanksgiving
តំបន់ឃ្ជឺស្សឺ	Kyushu
តំបន់ស៊ីកុគឹ	Shikoku
នាយករដ្ឋមន្ត្រី	Premierminister
ទង់ជាតិ	Flagg
ខ្មៅដៃ	Blyant
សហភាពសូវៀត	Sovjetunionen
ចំណុចរលាយ	Smeltepunkt
កាមេរ៉ា	Kamera
កម្មវិធីទូរទស្សន៍	TV-program
ខេត្តខាហ្គុស៊ីម៉ា	Kagoshima (prefektur)
ភាសាស៊ី	C (programmeringsspråk)
ម៉ង់តេរីយើ	Charles Montesquieu
វិគីភីឌា:អត្ថបទពិសេស	Wikipedia:Utmerkede artikler
ឈូក	Lotusrot
ឡងប៊ិច (កាលីផ្វនញ៉ា)	Long Beach
រង្វង់	Sirkel
ប្លង់	Plan (matematikk)
វិគីភីឌាភាសាកូរ៉េ	Wikipedia på koreansk
ទៀបកោះម៉ាឡេ	Malayahalvøya
អេប៉ុងហ្ស៍ (ពពុះទឹក)	Svamper
World Cup	Verdensmesterskapet i fotball
សម្ដេចប៉ាប	Pave
IATA	International Air Transport Association
បុណ្យណូអែល	Jul
ត្រីកោណ	Trekant
អ្នកប្រើប្រាស់:អេង ឡុង/សង្គមវិទ្យាមូលដ្ឋាន	Sosiologi
សញ្ញាសំលេងអន្តរជាតិ	Det internasjonale fonetiske alfabetet
តៃវ៉ាន់	Taiwan
Friedrich Schiller	Friedrich Schiller
ជំនឿបាហៃ	Bahá'í
១	1
អាប្រាហាម ម៉ាស្លូ	Abraham Maslow
ខ្ទឹមស	Hvitløk
អ៊ូលេនបាធរ	Ulan Bator
កោះ	Øy
ភាសាផ្លូវការ	Offisielt språk
ខ្សែអេក្វាទ័រ	Ekvator
ទិស	Himmelretning
លេខអាតូម	Atomnummer
អាល់ហ្វ្រិដ ណូបែល	Alfred Nobel
សម្ដេចប៉ាប យូហាន ទី២៣	Johannes XXIII
កិរិយាសព្ទ	Verb
ទីតានិច	RMS «Titanic»
សត្វឆ្អឹងកង	Virveldyr
បាគូ	Hærfugl
អំពែរ	Ampere
ISO 3166-1	ISO 3166-1
១ មុនគ.ស	1 f.Kr.
ម៉ែត្រការ៉េ	Kvadratmeter
ជំនួយ:Interlanguage links	Plankton
ទ្រឹស្តីបទទ្វេធា	Binomialformelen
សមុទ្រជប៉ុន	Japanhavet
អាស៊ីខាងកើត	Øst-Asia
អាមេរិក កណ្ដាល	Mellom-Amerika
គ្រីស្ទអឌែលហ្វៀន	Kristadelfianere
បរិមាត្រ	Omkrets
ចក្រភព អូទ្រីស-ហុងគ្រី	Østerrike-Ungarn
បណ្ណាល័យជាតិ	Folkebibliotek
ផាយថុន	Python
អាស៊ីហ្គេមឆ្នាំ១៩៥១	Asialekene 1951
ចិន	Kina
សំទុះទំនាញដី	Tyngdeakselerasjon
ច្បាប់ធម្មតា	Common law
អ្នកម្តាយ តេរេសា​ (Mother Teresa)	Moder Teresa
ប្លូក	Blogg
រោគគ្រុនចាញ់	Dengue
ដុល្លារហុងកុង	Hongkongdollar
ខេត្តទឹកខ្មៅ	Ca Mau (provins)
សមុទ្រខារ៉ា	Karahavet
ផ្លេតបន្ទោរ	Lyn
កំរងកោះ	Arkipel
តួប្រុស	Skuespiller
អំបូរភាសាយូតូអាហ្សតិក	Uto-aztekiske språk
ចាស្ទីន ពីពេ្រ	Justin Bieber
ក្រុម​ភាសា​ថៃកៈដៃ	Tai-kadai-språk
ចក្រភព រុស្ស៊ី	Det russiske keiserdømmet
មឞវជ	Mošovce
បេណាហ្សៀរ ប៊ូតូ	Benazir Bhutto
ស៊ីឌី	CD
ឧទ្ធម្ភាគចក្រ	Helikopter
គុណនាម	Adjektiv
វីតាមីន	Vitamin
វែបសាយ	Nettsted
តំបន់ហុកកៃដូ	Hokkaido
រូបមន្តសមមូលម៉ាស់-ថាមពល	Masseenergiloven
សមុទ្រ អារ៉ាល់	Aralsjøen
ហូ ជីមិញ	Hồ Chí Minh
ម៉ាក ហ្សុកឃឺបឺក	Mark Zuckerberg
ប្រតិកម្មគីមី	Kjemisk reaksjon
ខេត្តរោងដំរី	Tay Ninh (provins)
ខេត្តពលលាវ	Bac Lieu (provins)
វ៉ែសបែង	Vestbredden
ភាសាបាលី	Pali
គេហទំព័រ	Nettside
ចតុកោណ	Firkant
ឈិន ឡុង	Jackie Chan
Yahoo!	Yahoo!
បន្ទាត់	Linje
ហ្មរិឩពឡ	Mariupol
G8	G8
អង្កត់ផ្ចិត	Diameter
គ្រូបង្រៀន	Lærer
ស្នាដៃនៃបុព្វបុរសខ្មែរ	Skriving
ស្ដេចប៉ាប យ៉ូហាន ប៉ូលទី១	Johannes Paul I
ណៃពិដោ	Naypyidaw
ISO 4217	ISO 4217
ព្យែរ គុយរី	Pierre Curie
ក្រុមប្រឹក្សាសន្តិសុខ អង្គការសហប្រជាជាតិ	FNs sikkerhetsråd
ពហុកោណ	Polygon
ទិវានៃក្ដីស្រលាញ់	Valentinsdagen
ហ្គូហ្គល	Marked
សមុទ្រចិនខាងត្បូង	Sørkinahavet
និវេសនប្រព័ន្ធ	Økosystem
សមុទ្រលឿង	Gulehavet
យ៉ាំងហ្គូន	Yangôn
សូរព្យញ្ជនៈ	Konsonant
ច្បាប់ចលនារបស់ញូតុន	Newtons bevegelseslover
ឈូងសមុទ្របេងហ្គាល់	Bengalbukta
ទិវានារីអន្តរជាតិ	Den internasjonale kvinnedagen
.jp	.jp
ភ្នំហ្វឹជី	Fuji-san
ប៉ុលពត	Pol Pot
Chengdu J-7	Chengdu J-7
ភ្នំភ្លើង អ៊ីស៊ាឡឺក	Eyjafjallajökull
ម៉ាក្រូសេដ្ឋកិច្ច	Makroøkonomi
Harbin SH-5	Harbin PS-5
ដីជ្រោយហ្គាស្សា	Gazastripen
​វិទ្យុ​ស្ទូឌីយោ 54 បណ្តាញ	Radio Studio 54 Network
អេលីប	Ellipse
សមាគមន៍សារព័ត៌មាន	Associated Press
អធិដ្ឋាន	Bønn
គណៈកម្មាធិការអូឡាំពិកអន្តរជាតិ	Den internasjonale olympiske komité
Skype	Skype
.kh	.kh
ចតុកោណស្មើ	Rombe
ទន្លេមេគង្គ	Mekong
មេកានិច	Mekanikk
ហែងរីហ ហឺត	Heinrich Rudolf Hertz
អង់រី បិកកឺរ៉ែល	Henri Becquerel
ទស្សនាវដ្ដី	Tidsskrift
សមីការដឺក្រេទី២	Andregradsligning
រូពីឥណ្ឌូនេស៊ី	Indonesisk rupiah
សមុទ្រអុកហុតស្គ៍	Okhotskhavet
ចិត្តវិភាគ	Psykoanalyse
ខ្មែរម៉ាស្ទើ	Webmaster
.kr	.kr
URL	Uniform Resource Locator
ក្រុមបាល់ទាត់ជម្រើសជាតិ អេស្ប៉ាញ	Spanias herrelandslag i fotball
Google Earth	Google Earth
ប៊ែនហាដ រីម៉ាន	Bernhard Riemann
កោន	Kjegle
អាតុល	Atoll
ខ្លែង	Drage (leketøy)
ស្ថាបត្យករ	Arkitekt
មហាអំណាច អាប់ស៊ីស	Aksemaktene
វិគីភីឌា:FAQ	Wikipedia:OSS
.th	.th
ចក្រភព អាល្លឺម៉ង់	Tysklands historie (1871–1918)
ក្រុមបាល់ទាត់ជម្រើសជាតិ អាល្លឺម៉ង់	Tysklands herrelandslag i fotball
ហេរី ផោតធ័រ និង សិលាទេព	Harry Potter og de vises stein
អង្គការ Creative Commons	Creative Commons
ឥណ្ឌូចិន	Indokina
ប្រាសាទអង្គរវត្ត	Angkor Vat
ទ្រឹស្ដីរ៉ឺឡាទីវីតេ	Relativitetsteorien
ប្រុស	Han (kjønn)
Toulon	Toulon
ប៉ាស្កាល់	Pascal (enhet)
ទ្រឹស្ដីល្បែង	Spillteori
សមុទ្រចិនខាងកើត	Østkinahavet
ខ្នុរ	Jackfrukt
ប្រលេឡូក្រាម	Parallellogram
ចតុកោណព្នាយ	Trapes (geometri)
ស៊ូស៊ី	Sushi
រូប៊ិក ខ្យូប	Rubiks kube
កាល	Plautus
ចង្រិត	Ekte sirisser
ទិវាពលកម្មអន្ដរជាតិ	Arbeidernes internasjonale kampdag
ស្ទឹង	Bekk
សមុទ្រអង់ដាម៉ង់	Andamanhavet
ប៉ិបស៊ី	Pepsi
ក្រុមបាល់ទាត់ជម្រើសជាតិ អង់គ្លេស	Englands herrelandslag i fotball
ក្រុមបាល់ទាត់ជម្រើសជាតិ បារាំង	Frankrikes herrelandslag i fotball
ទំព័រគំរូ:Commonscat	Mal:Commonscat
វិគីភីឌាភាសាអាល្លឺម៉ង់	Wikipedia på tysk
អាស៊ីខាងលិច	Det nære østen
យេនឌ័រ	Kjønnsidentitet
អង្គការសហភាពអន្តរជាតិដើម្បីអភិរក្សធម្មជាតិ	Verdens naturvernunion
ទីក្រុងមេឌេយីណ	Medellín
ប៉ារ៉ាបូល	Parabel
ខេត្តអ៊ីវ៉ាតិ	Iwate (prefektur)
ទ្វារសមុទ្រមលក្កា	Malakkastredet
មហាយាន	Mahayana
ប្រព័ន្ធប្រតិបត្តការ iOS	IOS
ចំនួនបឋម	Primtall
សង្គ្រាម ប្រាំមួយ ថ្ងៃ	Seksdagerskrigen
ក្រុងឡូវែល រដ្ឋម៉ាស្សាឈូស៊ែត	Lowell
សមុទ្រជ្វា	Javasjøen
សិប្បកម្មខ្ញុំ	Minecraft
ច្រកសមុទ្រធ្ងន់ធ្ងរ	Dire Straits
វីហ្សួលបេហ៊្សិក.ណេត	Visual Basic .NET
ច្រកកូរ៉េ	Koreastredet
ឆកសមុទ្រកូរ៉េ	Koreabukten
កង្កែប	Springpadder
ខ្សែទឹកឃឹរ៉ុស៊ីអុ	Kuroshiostrømmen
ចំណាត់ថ្នាក់ក្រុម:ព្រះមហាក្សត្រ	Kategori:Monarker
ចំណាត់ថ្នាក់ក្រុម:រដ្ឋាភិបាល	Kategori:Myndigheter
ទំព័រគំរូ:Infobox legislature	Mal:Infoboks politisk forsamling
ទន្លេយ៉ាលូ	Yalu
ទំព័រគំរូ:ប្រវត្តិសាស្ត្រចិន	Mal:Kinas historie
មីហ្គេល អ៊ីដាលហ្គោ អ៊ី កុស្ទីយ៉ា	Miguel Hidalgo
នរោត្តម សីហមុនី	Norodom Sihamoni av Kambodsja
ហ៊ុន សែន	Hun Sen
តូក្យូស្កាយទ្រី	Tokyo Sky Tree
ភាសាប៉ាស្តូ	Pashto
កំណែទម្រង់រូបិយវត្ថុ	Valutareform
ធនាគារកណ្ដាល	Sentralbank
Pidgin	Pidgin (programvare)
​វិលហែម វុឌ	Wilhelm Wundt
មនុស្សពីងពាង	Spider-Man
សារធាតុគីមី	Kjemisk substans
ចលនានៅក្នុងរូបវិទ្យា	Bevegelse (fysikk)
ជម្ងឺកញ្ជ្រឹល	Meslinger
ក្រុមបាល់ទាត់ជម្រើសជាតិ អាហ្សង់ទីន	Argentinas herrelandslag i fotball
ខ្យល់ព្រះអាទិត្យ	Solvind
បាល់ទាត់ពិភពលោក ២០១៤	VM i fotball 2014
ម៉ូបាល (អាល់ឡាបាម៉ា)	Mobile
កុំព្យូទ័រផ្រូក្រាមមីង(Computer programming)	Programmering
ខេត្តឈីបា	Chiba (prefektur)
អាំងតេក្រាល	Integral (matematikk)
ខេត្តអៃឈិ	Aichi (prefektur)
វិបត្តិសេដ្ឋកិច្ចឆ្នាំ ១៩៩៧	Asiakrisen
ខ្មែរ	Voksen
សិល្បៈប្រើវោហារបង្ហូរគំនិត	Retorikk
ឃីមីហ្គាយ៉ុ	Kimi Ga Yo
សាល អូហ្គុស្ទីន ដឺ គូឡុំ	Charles Augustin Coulomb
ខេត្តអាគីតា	Akita (prefektur)
ថ្នាក់ពាក្យ	Ordklasse
កាន់ជិ	Kanji
នាម	Navn
ប្រវត្តិសាស្ត្រចិន	Kinas historie
អវតារ	Avatar
ច្បាប់គូឡុំ	Coulombs lov
រឿង រ៉ូមេអូ និង ហ្ស៊ុយលីយេ	Romeo og Julie
សាលីណា កូមាស់	Selena Gomez
ក្រុម (តារាងខួបនៃធាតុគីមី)	Periodesystemets grupper
ក្រុមបាល់ទាត់ជម្រើសជាតិ ប្រេស៊ីល	Brasils herrelandslag i fotball
កាល ឡែមស្ដែនណឺ	Karl Landsteiner
បាល់ប៉ូឡូញ	Polenball
ឯកសារភាពយន្ត	Dokumentarfilm
អនុគមន៍ត្រីកោណមាត្រ	Trigonometriske funksjoner
ហ្រាន្ដកូស ហ្វីឡុន	François Fillon
ខួប (តារាងខួបនៃធាតុគីមី)	Periodesystemets perioder
ល្បែងទាញព្រ័ត្រ	Tautrekking
Article (grammar)	Artikkel (ordklasse)
មេដ្យានទ័រ	Passer
Rfid	Radiofrekvensidentifikasjon
អ៊ីប៉ូតេនុស	Hypotenus
ហិចហ្វាន់	Hedgefond
ISO 3166	ISO 3166
សញ្ញាជាតិកូរ៉េខាងជើង	Nord-Koreas riksvåpen
មេហ្គា	Mega
គីឡូ	Kilo
ការតាំងសមាធិ	Meditasjon
ប៉េតា	Peta
យ៉ុតតា	Yotta
សង់ទី	Centi
ហ្គីហ្គា	Giga
តេរ៉ា	Tera
ហ្វង់តូ	Femto
ហ្សិតតា	Zetta
ច្រកតារតារី	Tartarstredet
ហ្សិបតូ	Zepto
កាតែត	Katet
អាត់តូ	Atto
យ៉ុកតូ	Yokto
ដេស៊ី	Desi
ម៉ាស៊ីនស្វែងរក	Metasøkemotor
អាំងតេក្រាលមិនកំនត់	Primitiv funksjon
គណបក្សហ៊្វុនស៊ិនប៉ិច	FUNCINPEC
ខេត្តក្យូតុ	Kyoto (prefektur)
តំលៃដាច់ខាត	Absoluttverdi
ហេដ្ឋារចនាសម្ព័ន្ធ	Infrastruktur
សាស្ត្រាចារ្យ	Professor
តេគីឡា	Tequila (brennevin)
សន្ធិសញ្ញាប្រេស្ត-លីតូវស្ក	Freden i Brest-Litovsk
William Thomson, 1st Baron Kelvin	William Thomson Kelvin
អាណាខេត្តអូសាកា	Osaka (prefektur)
ខេត្តអិហ៊ីមិ	Ehime (prefektur)
វាំងននដែក	Jernteppet
Kara (band)	Kara (band)
វីលៀម ជែម	William James
ខេត្តយ៉ាម៉ាកាតា	Yamagata (prefektur)
ច្រកតៃវ៉ាន់	Taiwanstredet
គំរោងម៉ាន់ហាត់ថាន់	Manhattanprosjektet
ខេត្តយ៉ាម៉ាហ្គឹឈិ	Yamaguchi (prefektur)
ខេត្តខាន់ណាហ្គាវ៉ា	Kanagawa (prefektur)
បញ្ចកោណ	Pentagon
តំបន់ជឺហ្គុកឹ	Chūgokuregionen
ខេត្តណាហ្គាណុ	Nagano (prefektur)
ខេត្តសៃតាម៉ា	Saitama (prefektur)
ខេត្តមីអិ	Mie (prefektur)
ណុត	Knop (mål)
តំបន់តុហុកកឹ	Tōhokuregionen
ខេត្តហ្គឺនម៉ា	Gunma (prefektur)
ជ្រូកទឹក	Dugong
ខ្សែទឹកមហាសមុទ្រ	Havstrøm
ខេត្តមីយ៉ាសាគី	Miyazaki (prefektur)
ខេត្តឃឹម៉ាម៉ុតុ	Kumamoto (prefektur)
Mikoyan MiG-29	Mikojan-Gurevitsj MiG-29
សប្ដាហ៏ពិសិដ្ឋ	Den stille uke
ឈូងសមុទ្រថៃ	Siambukten
អ៊ីមម៉ាជីន និងផូស៊ី	IMMAGINE&POESIA
លី ក្វាន់យូ	Lee Kuan Yew
កម្មសិទ្ធិបញ្ញា	Immaterialrett
អាណាខេត្តណារ៉ា	Nara (prefektur)
បុព្វបទនៅក្នុងប្រព័ន្ធខ្នាតអន្តរជាតិ	SI-prefiks
យន្តហោះប៉ូឡូញកំទេចឆ្នាំ២០១០	Smolensk-ulykken
ជនភៀសខ្លួន	Flyktning
ហង់រី កាវិនឌីស	Henry Cavendish
បុណ្យចូលឆ្នាំចិន	Kinesisk nyttår
ថេរវាទ	Theravada
តំបន់ខាន់តូ	Kantōregionen
ខេត្តនីហ្គាតាក់	Niigata (prefektur)
ខេត្តយ៉ាម៉ាណាស៊ី	Yamanashi (prefektur)
ខេត្តស៊ីម៉ាណិ	Shimane (prefektur)
ខេត្តតុយ៉ាម៉ា	Toyama (prefektur)
ខេត្តអូកាយ៉ាម៉ា	Okayama (prefektur)
ISO 3166-2	ISO 3166-2
ខេត្តអយតាក់	Ōita (prefektur)
ខេត្តខូឈិ	Kōchi (prefektur)
អង្គការអន្តរជាតិនៃនយោបាយរបស់បារាំង	La Francophonie
ភ្នំមេរ៉ាពី	Merapi
ព្រះធម៌	Dharma
តំបន់ឈឺប៊ឹ	Chūburegionen
វ៉ាក់សាំង	Vaksine
រោគក្អកមាន់	Kikhoste
គន្ថនិទ្ទេស	Bibliografi
កម្ពុជា នៅកីឡាអូឡាំពិករដូវក្ដៅ ២០០៨	Kambodsja under Sommer-OL 2008
គីមឈី	Kimchi
ខេត្តកំពង់ចាម	Kampong Cham (provins)
ខ្សែទឹកហ្គ្រីនលែនខាងកើត	Østre Grønlandstrømmen
ជ័រទឹក	Harpiks
ដុនបូស្កូ	Johannes Bosco
ធ្នូរង្វង់	Bue (geometri)
អប្សរា	Apsara
ស្រុក	Gu (forvaltningsenhet)
រាជវង្សចោឡា	Chola-dynastiet
ខ្លារខិន ២ (រថក្រោះ)	Leopard 2
មហាអំណាច កណ្ដាល	Sentralmaktene
អិចសា	Exa
ហិកតូ	Hekto
ដេកា	Deka
រ៉ូបឺតកាប៉ា	Robert Capa
មីល្លី	Milli
មីក្រូ	Mikro
ពីកូ	Pico
ណាណូ	Nano
លីប៉ូល ស៊ីដាស៊ាងហ័រ	Léopold Sédar Senghor
ទន្ដគោម	Agave
ប្រវតិ្តBoney M	Boney M
អំពើអនិត្យានុកូល	Vold i nære relasjoner
ហង់រី ការចេរ ប្រេស្សុង	Henri Cartier-Bresson
ត្រីកោណសម័ង្ស	Likesidet trekant
ម៉ាក់ណូលា	Magnoliaslekten
ចូសេហ្វ ហិនរី	Joseph Henry
មន ស	Hvitmorbær
ពិធីបញ្ជាប់ពាក្យ	Forlovelse
ត្រីកោណកែង	Rettvinklet trekant
សមុទ្រហ្វីលីពីន	Filippinerhavet
ប្រព័ន្ធកូអ័រដោណេភូមិសាស្ត្រ	Geopolitikk
Eurocopter Tiger	Eurocopter Tiger
តេត្រាអែត	Tetraeder
ម៉ោងផែនដី	Earth Hour
នរោត្ដម សីហនុ	Norodom Sihanouk
ទន្លេរីយ៉ូហ្គ្រែនដេ	Rio Grande
សំព័រ	Brødfruktslekten
កម្មវិធីអភិវឌ្ឍន៍សហប្រជាជាតិ	FNs utviklingsprogram
មេគុណជីនី	Gini-koeffisient
នីត្រូគ្លីសេរីន	Glyserolnitrat
វណ្ណយុត្តិ	Diakritisk tegn
ទង់ជាតិកម្ពុជា	Kambodsjas flagg
ក្រុងអង្គរ	Angkor
ក្រពេញទីមុស	Brissel
ទ្រឹស្តីបទកូស៊ីនុស	Cosinussetningen
ទក្សិណ ជិនវ័ត្រ	Thaksin Shinawatra
ប្រធាន	Subjekt (grammatikk)
អ៊ែង​ហ្គ្រី បឺដ	Angry Birds
អ៊ីពែបូល	Hyperbel
ប៊ិច	Penn
ចេក​	Kokebanan
XHTML	XHTML
គ្រោះទុរ្ភិក្ស	Hungersnød
អរិយសច្ច៤	De fire edle sannheter
ស្តាទិច	Statikk
ខេត្តណាហ្គាសាគី	Nagasaki (prefektur)
វិគីភីឌាភាសាស្វីស	Wikipedia på svensk
ភ្លើងឆេះព្រៃ	Skogbrann
ទ្រឹស្តីបទស៊ីនុស	Sinussetningen
ច្បាប់ហ៊ូក	Hookes lov
ក្រុមបាល់ទាត់ជម្រើសជាតិ ជប៉ុន	Japans herrelandslag i fotball
រោគឈឺចាប់ក្នុងសន្លាក់ឆ្អឹង	Artritt
ប្លុកហ្គឺ (Blogger)	Blogger
ធម្មនុញ្ញនៃអង្គការសហប្រជាជាតិ	De forente nasjoners pakt
Boeing AH-64 Apache	Boeing AH-64 Apache
រោគហើមសួត	Bronkitt
អេមីល្យូ ហ្គីណូ សេហ្គ្រែ	Emilio Segrè
Sukhoi Su-27	Sukhoj Su-27
ម៉ាស៊ីនត្រជាក់	Klimaanlegg
កាំ	Radius
អភិសិទ្ធិ វេជ្ជាជីវៈ	Abhisit Vejjajiva
HAL Tejas	HAL Tejas
លីមីត	Grenseverdi
អ៊ីដ្រូស្តាទិច	Hydrostatikk
គោលនយោបាយរូបិយវត្ថុ	Pengepolitikk
យានដឹកជញ្ជូនសាធារណៈ	Kollektivtrafikk
ការសំភាសន៏	Intervju
ពាណិជ្ជកម្មអន្តរជាតិ	Internasjonal handel
ចក្រភពអាណានិគមបារាំង	Det franske koloniriket
ពន្ធលើប្រាក់ចំណូល	Inntektsskatt
រូបចំលាក់	Statue
នាឡិកាខ្សាច់	Timeglass (tidsmåler)
ពុយមីស	Pimpstein
FM	Frekvensmodulasjon
សង្គមស៊ីវិល	Sivilt samfunn
សមុទ្របូហៃ	Bo Hai
ការិយាល័យ	Kontor
ការបង្រៀនដែនដីបរិសុទ្ធ	E-læring
ម៉ែត្រក្នុងមួយវិនាទី	Meter per sekund
រូបមន្តហេរុង	Herons formel
ទន្សោង	Bantengfe
វីតាមីន B	Vitamin B
គណៈកម្មាធិការជាតិអូឡាំពិក	Nasjonal olympisk komité
ប៉មតូក្យូ	Tokyo Tower
ទិវាទឹកអន្តរជាតិ	Verdens vanndag
រូបមន្តអយល័រ	Eulers formel
ស៊ីយ៉ាញួរ	Cyanid
អរិយដ្ឋង្គិកមគ្គ	Den edle åttedelte veien
សហភាពឥណ្ឌូចិន	Fransk Indokina
ចន្ទគតិ	Månekalender
សំទុះមុំ	Vinkelakselerasjon
អាស៊ីហ្គេមឆ្នាំ១៩៧០	Asialekene 1970
គោលនយោបាយសារពើពន្ធ	Finanspolitikk
ឡាហ្គូន	Lagune
Mathew Brady	Mathew Brady
អប់សិន (ហិរញ្ញវត្ថុ)	Opsjon
អង្កត់ធ្នូ	Korde
អាយុសង្ឃឹម	Forventet levealder
ខុទ្ទកាល័យ	Styre
ធនាគារអភិវឌ្ឍន៍អាស៊ី	Den asiatiske utviklingsbanken
បញ្ជីរដ្ឋមានអាវុធនុយក្លេអ៊ែរ	Atommakt
ទីផ្សារអ៊ីធើណែត	Internettmarkedsføring
សៀវភៅ	Jungelboken
បារីអេឡិចត្រូនិច	Elektronisk sigarett
Eagles (ក្រុមភ្លេង)	Eagles
អាឌាម លេមបឺត	Adam Lambert
អនុគមន៍ហ្គាំម៉ា	Gammafunksjonen
សញ្ញាជាតិបង់ក្លាដែស្ស	Bangladeshs riksvåpen
នាង​សីតា	Sita
សូរ (​ភាសាសាស្ត្រ​)	Tonespråk
ខ្មែរក្រហម	Røde Khmer
ម៉ូឌុល​យ៉ាំង	Elastisitetsmodul
យុន ជីមិ-ហូ	Yun Chi-ho
កែវម៉ាស៊ីនថត	Objektiv
ទីភ្នាក់ងារសារព័ត៌មាន	Nyhetsbyrå
ថេរហ្វារ៉ាដេយ	Faradays konstant
ខូប្រា	Kopra
អត្ថបទ(ប្រើបា្រស់ភាសា)	Kontekst
ជូគ័រលាង	Zhuge Liang
បំលែងឡាប្លាស	Laplacetransformasjon
សញ្ញាជាតិតួរគី	Tyrkias riksvåpen
បឹងទន្លេសាប	Tonlé Sap
Dassault Mirage 2000	Dassault Mirage 2000
ចំនួនអវិជ្ជមាន	Negative tall
សញ្ញាជាតិវៀតណាម	Vietnams riksvåpen
ខ្មែរ (ជនជាតិ)	Khmerfolket
សញ្ញាជាតិកូរ៉េខាងត្បូង	Sør-Koreas riksvåpen
សញ្ញាជាតិឡាវ	Laos' riksvåpen
សញ្ញាជាតិប៉ាគីស្ថាន	Pakistans riksvåpen
Tigranes the Great	Tigranes I av Armenia
អាណាចក្រខ្មែរ	Khmerriket
សម្ដេចព្រះមហាឃោសនន្ន	Preah Maha Ghosananda
កោះក្នុងទ្វីប	Innlandsøy
ត្រីពណ៌	Trikolor
សញ្ញាជាតិប៊្រុយណេ	Bruneis riksvåpen
រង្វង់ត្រីកោណមាត្រ	Enhetssirkelen
ចំរៀករង្វង់	Sirkulær sektor
អនុគមន៍អ៊ីពែបូលីក	Hyperbolske funksjoner
ឆាវ ឆាវ	Cao Cao
Sukhoi Su-30	Sukhoj Su-30
កម្មវិធីស្បៀងអាហារពិភពលោក	Verdens matvareprogram
រៀល	Kambodsjansk riel
សមុទ្រស្ទើរបិទ	Randhav
ច្រកសិង្ហបុរី	Singaporestredet
សញ្ញាជាតិអូម៉ង់	Omans riksvåpen
ភាសាកម្មវិធី Lua	Lua
សញ្ញាជាតិប៊ូតាន	Bhutans riksvåpen
ភ្លេងជាតិថៃ	Phleng Chat
ព្រះរតនត្រ័យ	De tre juveler
អាហារនៅប្រទេសម៉ិចស៊ិក	Meksikansk mat
ច្រកឡាប៉េរូស	La Pérouse-stredet
ញ៉ែ	Kurtisering
ព្រះឆាយាល័ក្ខកម្ពុជា	Kambodsjas riksvåpen
ទិវាអង្គការសហប្រជាជាតិ	FN-dagen
ប្រវត្តិសាស្ត្រវៀតណាម	Vietnams historie
ខ្សែទឹកខាណារី	Kanaristrømmen
ទ្រឹស្តីបទឆិវ៉ា	Cevas setning
LinkedIn	LinkedIn
ព្រះត្រៃបិដក	Palikanonen
បុណ្យវិសាខបូជា	Vesak
ទីក្រុងព្រែកឫស្សី	Can Tho
ជនជាតិចាម	Champa
រីស្ស៉ាត កាពុសស៊ីនស្គី	Ryszard Kapuściński
ស៊ាន ឃីងស្តន	Sean Kingston
កងទ័ពជើងទឹកបារាំង	Marine Nationale
លោក អាប់ឌូ ឌីអោហ្វ	Abdou Diouf
ច្បាប់អគ្គីសនីវិភាគរបស់ហ្វារ៉ាដេយ	Faradays elektrolyselov
ខេត្តព្រះសីហនុ	Sihanoukville
មានប្រ	Anggun
ដុនបូស្កូសាឡេស៊ាន្ត	Salesianerne av Don Bosco
អង្គរធំ	Angkor Thom
Kara	Kara
១៤១	141 (tall)
វិទ្យុសម្លេងសហរដ្ឋអាមេរិក	Voice of America
ជេឃ្វីរី	JQuery
ទិវាពិភពលោកគ្មានថ្នាំជក់	Verdens tobakksfrie dag
គម្ពីរបញ្ចតន្ត្រ	Panchatantra
ផ្លាយ អាស់	Flyveaske
T-80	T-80
សញ្ញាជាតិកាតារ	Qatars riksvåpen
សត្វព្រៃ	Vilt
មីហ៊្គោ	MeeGo
វិភាគចិត្តវិទ្យា	Analytisk psykologi
លីវ ប៉ី	Liu Bei
សង្គ្រាមគ្រីមៀ	Krimkrigen
នាវាចរណ៏	Navigatør
Pinterest	Pinterest
អាស៊ីហ្គេមឆ្នាំ១៩៦២	Asialekene 1962
ភ្នំសេមេរូ	Semeru
កោះសមុយ	Ko Samui
ថវិការដ្ឋាភិបាល	Statsbudsjett
កប៉ាល់ ជួង	Skipsklokke
សាលាសំណាក់	Paviljong
ជយវម៌្មទី១	Jayavarman I
ប្រាសាទក្រោលគោ	Krol Ko
ខ្សែទឹកកាលីហ្វរនៀ	Californiastrømmen
១៤៨	148 (tall)
ធនាគារជាតិនៃកម្ពុជា	Kambodsjas nasjonalbank
នគរឆាវ	Cao (stat)
AIDC F-CK-1 Ching-kuo	AIDC Ching-Kuo
ខេត្តសាឡៈវ៉ាន់	Saravane (provins)
ប្រាសាទមេបុណ្យខាងកើត	Østre Mebon
ទិន ហ្វី	Stephen Chow
ហាំង ង៉ោ	Haing S. Ngor
ព្រះបាទសូរ្យវរ្ម័នទី២	Suryavarman II
ហ្គោស ចុកតុង	Goh Chok Tong
ហិនរី វីលសុន	Henry Wilson
ស៊ុន ឈាន	Sun Quan
ឆាវ ភី	Cao Pi
ព្រះសារីបុត្រ	Shariputra
ទ្រឹស្តីបទគ្រីន	Greens teorem
VCD	Video CD
ថ្ងៃបាស់ស្ទីល	Frankrikes nasjonaldag
កម្ពុជាប្រជាធិបតេយ្យ	Demokratisk Kampuchea
សាលាក្ដីខ្មែរក្រហម	Røde Khmer-tribunalet
ណាសសែរ អាល់ មូហាមមេដ អាល់ អាហ៍មេដ អាល់ អាបាហ៍	Nāṣir al-Muḥammad al-ʼAḥmad al-Ṣabāh
ខេត្តផុងសាលី	Phongsali (provins)
ខេត្តបកែវ	Bokeo (provins)
ខេត្តចំប៉ាសក្តិ	Champasack (provins)
កិលេស	Lidenskap
កាំង ហ្កិច អ៊ាវ	Khang Khek Ieu
ស៊ឺ ម៉ាអ៉ី	Sima Yi
ក្រុមហ៊ុនអាកាសចរណ៍ជាតិ កម្ពុជាអង្គរអ៊ែរ	Cambodia Angkor Air
ហេង សំរិន	Heng Samrin
ខៀវ សំផន	Khieu Samphan
ព្យែរ វ៉ារីញ៉ុង	Pierre Varignon
នួន ជា	Nuon Chea
អៀង សារី	Ieng Sary
ជយវម៌្មទី៣	Jayavarman II
ប្រវត្តិសាស្ត្រថៃ	Thailands historie
បុណ្យសែនព្រះខែ	Månefesten
គុណកិរិយា	Adverb
នូហាក់ ភូមសៈវ៉ាន់	Nouhak Phoumsavanh
កុំផ្លិចឆ្លាស់	Kompleks konjugasjon
ការកើនឡើងនៃចំនួនប្រជាជននៅលើពិភពលោក	Befolkningsvekst
ប្រាសាទអកយំ	Prasat Ak Yum
ហង់រី មូហូ	Henri Mouhot
ព្រះបរមរាជវាំង	Det kongelige palasset i Phnom Penh
បន្ទាត់សេកង់	Sekant
ប្រាសាទតាកែវ	Ta Keo
សម្ដេចប៉ាបហ្វ្រង់សូ័រ	Frans (pave)
Regional Internet registry	Regional Internet Registry
គុណវិបត្តិនៃការជក់បារី	Helsefarer ved tobakksrøyking
ខ្វែងជ័យបុរី	Sainyabuli (provins)
ខ្វែងជើងខ្វែង	Xieng Khouang
ខេត្តឧត្តមជ័យ	Udomxai (provins)
ខេត្តកោះកុង	Koh Kong (provins)
ខេត្តកណ្ដាល	Kandal
ទ្រឹស្តីបទតង់សង់	Tangenssetningen
ឌិត ប្រន	Dith Pran
អាស៊ីហ្គេមឆ្នាំ១៩៧៤	Asialekene 1974
អាកាសយានដ្ឋានអន្តរជាតិតានសូនណាត្ត	Tan Son Nhat internasjonale lufthavn
ឧបទ្វីបកូរ៉េ	Koreahalvøya
វីគីប្រជុំ	Wikimania
អាស៊ីហ្គេម	Asialekene
ទង់ជាតិសិង្ហបុរី	Singapores flagg
បង្អួចឆ្នាំ 2000	Windows 2000
សញ្ញាជាតិអាហ្វហ្គានីស្ថាន	Afghanistans riksvåpen
Sukhoi Superjet 100	Sukhoj Superjet 100
គណកម្មាធិការអូឡាំពិកកូរ៉េ	Koreas olympiske komité
អាស៊ីហ្គេមឆ្នាំ២០០២	Asialekene 2002
ឆកសមុទ្របូហៃ	Bohaibukten
អាស៊ីហ្គេមឆ្នាំ១៩៨៦	Asialekene 1986
អាណាស្រុកម៉ូបាល (អាល់ឡាបាម៉ា)	Mobile County
ខេត្តកំពង់ធំ	Kampong Thom (provins)
ខេត្តព្រះវិហារ	Preah Vihear
ខេត្ត ហួ ផាន់	Hua Phan (provins)
ខ្វែងអាចម៍ក្រពើ	Attapeu (provins)
ខេត្តខាំមួន	Khammuan (provins)
ខេត្តប៉ៃលិន	Pailin
ឆាយាលក្សសារព័ត៌មាន	Fotojournalistikk
ក្រុមបាល់ទាត់ជម្រើសជាតិ កូរ៉េខាងត្បូង	Sør-Koreas herrelandslag i fotball
គោលនយោបាយសាធារណៈ	Offentlig politikk
ឆកសមុទ្រចាការតា	Jakartabukta
ភូមិសាស្រ្ដនៃប្រទេសកម្ពុជា	Kambodsjas geografi
ស្រុកអន្លង់វែង	Anlong Veng
កស្ថានីយភ្នំបូកគោ	Bokor Hill Station
នរោត្តម	Norodom av Kambodsja
ព្រះបាទយសោវរ្ម័នទី១	Yasovarman
ព្រះបាទឥន្រ្ទវរ្ម័នទី១	Indravarman I
ប្រាសាទភ្នំបាខែង	Phnom Bakheng
ប្រាសាទភិមានអាកាស	Phimeanakas
Baskin​-Robbins បាន	Baskin-Robbins
ប្រាសាទតាព្រហ្ម	Ta Prohm
អាជ្ញាធរអន្តរកាលសហប្រជាជាតិនៅកម្ពុជា	UNTAC
ប្រាសាទធម្មនន្ទ	Thommanon
ប្រាសាទមេបុណ្យខាងលិច	Vestre Mebon
ប្រាសាទបន្ទាយក្តី	Banteay Kdei
ប្រាសាទបន្ទាយសំរែ	Banteay Samré
មជ្ឈិមនិកាយ	Majjhimanikaya
ស្រះស្រង់	Srah Srang
ខេត្តតាកែវ	Takeo (provins)
លានស្តេចគំលង់	Den spedalske konges terrasse
ខេត្តហ៊ីរ៉ូស៊ីម៉ា	Hiroshima (prefektur)
ជំរំជនភៀសខ្លួន	Flyktningleir
ខេត្តឧត្ដរមានជ័យ	Oddar Meancheay
ប្រភេទស្រាទំពាំងបាយជូរពីប្រទេសបារាំង	Fransk vin
បទនគររាជ	Nokoreach
នគររាជសីមា	Nakhon Ratchasima
សង្គ្រាមកម្ពុជា-វៀតណាម	Den kambodsjansk-vietnamesiske krig
បញ្ជីរាយនាម ជ័យលាភីរង្វាន់ណូបែលសន្តិភាព	Liste over mottakere av Nobels fredspris
១៥០	150 (tall)
ស្ទឹងស៊ីលីវូង	Ciliwung
ISO 3166-2:KH	ISO 3166-2:KH
ខេត្តសៀមរាប	Siem Reap (provins)
ខេត្តមណ្ឌលគិរី	Mondulkiri
ខេត្តកំពង់ស្ពឺ	Kampong Spoe (provins)
ប្រាសាទបាយ័ន	Bayon
ឧត្តមស្នងការអង្គការសហប្រជាជាតិទទួលបន្ទុកសិទ្ធិមនុស្ស	FNs høykommissær for menneskerettigheter
អនុគមន៍ត្រីកោណមាត្រច្រាស់	Inverse trigonometriske funksjoner
ប្រវត្តិសាស្ត្រខ្មែរ	Kambodsjas historie
ម៉ាជូ ពីជូ	Machu Picchu
គណនីធនាគារ	Bankkonto
ក្រុមអសនិក (អាកាសចរណ៍)	Skvadron
Pilatus PC-7	Pilatus PC-7 Turbo Trainer
១៣៨	138 (tall)
គីឡូម៉ែត្រការ៉េ	Kvadratkilometer
១៤៤	144 (tall)
១៤០	140 (tall)
១៤៣	143 (tall)
១៤៧	147 (tall)
១៤៦	146 (tall)
១៤៩	149 (tall)
១៤២	142 (tall)
១៣៩	139 (tall)
១៤៥	145 (tall)
ប្រទេសមួយ ប្រព័ន្ធពីរ	Ett land, to systemer
ត្រកៀត	Vannhyasintfamilien
អាស៊ីហ្គេមឆ្នាំ១៩៥៤	Asialekene 1954
អាស៊ីហ្គេមឆ្នាំ១៩៥៨	Asialekene 1958
អាស៊ីហ្គេមឆ្នាំ១៩៦៦	Asialekene 1966
អាស៊ីហ្គេមឆ្នាំ១៩៧៨	Asialekene 1978
អាស៊ីហ្គេមឆ្នាំ១៩៨២	Asialekene 1982
អាស៊ីហ្គេមឆ្នាំ១៩៩០	Asialekene 1990
អាស៊ីហ្គេមឆ្នាំ១៩៩៤	Asialekene 1994
អាស៊ីហ្គេមឆ្នាំ១៩៩៨	Asialekene 1998
ច្រកចូហរ	Johorestredet
ព្រះសង្ឃ	Munk
នគរលូ	Lu (stat)
ត្រីរាជ	Mekongkjempemalle
ភាពលំអៀង	Bias
ខេត្តរតនគិរី	Ratanakiri
Gloomy Sunday	Gloomy Sunday
ខេត្តហ្លួងព្រះបាង	Luang Prabang (provins)
ខេត្តកំពត	Kampot (provins)
សង្គ្រាមឥណ្ឌូចិនលើកទី១	Den første indokinesiske krig
ខេត្តស្វាយរៀង	Svay Rieng (provins)
ប៉ាកាយ៉ា	Pacaya
សុត្តន្តបិដក	Sutta pitaka
ខេត្តអូគីណាវ៉ា	Okinawa (prefektur)
លានជល់ដំរី	Elefantterrassen
គណបក្សប្រជាជនកម្ពុជា	Det kambodsjanske folkepartiet
អាស៊ីខាងត្បូង	Sør-Asia
កំណាត់រង្វង់	Sirkelsegment
ខេត្តក្រចេះ	Kratie (provins)
ប្រាសាទបាគង	Bakong
ប្រាសាទបក្សីចាំក្រុង	Baksei Chamkrong
ប្រាសាទបន្ទាយស្រី	Banteay Srei
ប្រាសាទបាពួន	Baphuon
ឃុំបន្ទាយឆ្មារ	Banteay Chhmar
ខេត្តបាត់ដំបង	Battambang (provins)
ប្រាសាទបឹងមាលា	Beng Mealea
សង្គ្រាមផ្ទៃក្នុងកម្ពុជា	Den første borgerkrigen i Kambodsja
អាស៊ីហ្គេមរដូវរងារ	Asiatiske vinterleker
KM	Kilometer
បញ្ជីព្រះមហាក្សត្រកម្ពុជា	Liste over Kambodsjas statsoverhoder
ជម្រើសអ្នកប្រើប្រាស់	Konsumentteori
ខេត្តពោធិ៍សាត់	Pursat (provins)
ខេត្តស្ទឹងត្រែង	Stung Treng (provins)
ប្រព័ន្ធគោល	Grunntall
ក្រុមប្រឹក្សាអូឡាំពិកអាស៊ី	Asias olympiske råd
McDonnell Douglas F-15E Strike Eagle	Boeing F-15 Strike Eagle
២៤២	242 (tall)
តារាងអាំងតេក្រាលនៃអនុគមន៍ត្រីកោណមាត្រ	Liste over integraler av trigonometriske funksjoner
ច្រកកាលីម៉ាតា	Karimatastredet
សារមន្ទីរទួលស្លែង	Folkemordsmuseet Tuol Sleng
ខេត្តកែប	Kep
បញ្ជីអ្នកទទួលបានជ័យលាភីណូបែលខាងរូបវិទ្យា	Liste over nobelprisvinnere i fysikk
VietJet Air	VietJet Air
ភវវម៌្មទី១	Bhavavarman I
ក្រុងសិរីសោភ័ណ	Sisophon
ក្រុងកំពង់ចាម	Kampong Cham
សាកលវិទ្យាល័យ ចុឡាលុងករណ៍	Chulalongkornuniversitetet
ខេត្តព្រៃវែង	Prey Veng (provins)
ខ្សែទឹកអេក្វាទ័រខាងជើង	Ekvatorialstrømmen
សាធារណរដ្ឋប្រជាមានិតកម្ពុជា	Folkerepublikken Kampuchea
នគរវ្នំ	Funan (kongedømme)
ក្រុងកំពត	Kampot
ខេត្តកំពង់ឆ្នាំង	Kampong Chhnang (provins)
ISO 3166-3	ISO 3166-3
ព្រះបាទជ័យវរ្ម័នទី៣	Jayavarman III
បាល់ទាត់កញ្ចុំផ្កាយ	Galactik Football
ជំនួយ:មាតិកា	Hjelp:Portal
ច្បាប់ប្រលេឡូក្រាម	Parallellogramloven
ភ្នំភ្លើងអ៊ីស៊ាឡឺកធ្វើអោយខកខានការហោះហើរនៅអឺរ៉ុប	Luftfartsproblemene etter Eyjafjallajökulls vulkanutbrudd 2010
ជួរភ្នំដងរែក	Dângrêkfjellene
ប្រាសាទព្រះខ័ន	Preah Khan
កបិលវត្ថុ	Kapilvastu
ប្រាសាទភ្នំក្រោម	Phnom Krom
ចំណុចរំពុះ	Kokepunkt
ក្រុងប៉ោយប៉ែត	Poipet
ក្រុងកំពង់ឆ្នាំង	Kampong Chhnang
តារាងអាំងតេក្រាលនៃអនុគមន៍ច្រាស់ត្រីកោណមាត្រ	Liste over integraler av inverse trigonometriske funksjoner
អាកាសយានដ្ឋានអន្តរជាតិភ្នំពេញ	Phnom Penh internasjonale lufthavn
ព្រះនិព្វាន៤ថ្នាក់	Fire trinn av opplyshet
អក្សរខ្មែរ	Khmer-skrift
អាកាសយានដ្ឋានអន្តរជាតិសៀមរាបអង្គរ	Siem Reap internasjonale lufthavn
ចេនឡា	Chenla
តថាគត	Tathagata
ប្រាសាទនាគព័ន្ធ	Neak Pean
នគរឆឹន	Chen (stat)
កម្មវីធីសូនីវីហ្គាស	Sony Vegas Pro
កងទ័ពអេហ្ស៊ីប	Egypts forsvar
ប្រាសាទប្រែរូប	Pre Rup
ប្រាសាទក្រវាន់	Prasat Kravan
ប្រាសាទព្រះគោ	Preah Ko
ប្រាសាទលលៃ	Lolei
ក្បាលស្ពាន	Kbal Spean
ប្រាសាទតាសោម	Ta Som
ស្ពានថ្ម	Spean Thma
ISO 3166-1 alpha-2	ISO 3166-1 alfa-2
សហរដ្ឋ	Politisk union
អាស៊ីហ្គេមលើឆ្នេរខ្សាច់	Asian Beach Games
សម្រែកនៃដុលោរ៉េស៏	Grito de Dolores
ស្ពានខាន់ម៉ុងក្យូ	Kanmonkyo-broen
វិគីភីឌា:ស្ថានទូតខ្មែរ	Wikipedia:Ambassade
Bottleneck	Flaskehals
ទីឃនិកាយ	Dighanikaya
ខ្សែទឹករង្វល់របស់មហាសមុទ្រ	Havstrømsvirvelområder
វិទ្យុតាមអ៊ីនធើណែត	Digital radio
ខ្សែទឹកហ្គ្រីនលែនខាងលិច	Vestgrønlandstrømmen
ខ្សែទឹកកោះបាហ្វហ្វីន	Baffinstrømmen
ខ្មែរលើ	Khmer Loeu
មួយម៉ូនីកា	Agnes Monica
Candies	Candies
ប្រាសាទព្រះប៉ាលីឡៃ	Preah Palilay
ចំណាត់ថ្នាក់ក្រុម:ប្រទេសជប៉ុន	Kategori:Japan
ចំណាត់ថ្នាក់ក្រុម:ម៉ិកសិច	Kategori:Mexico
វិធីសាស្រ្តក្នុងការទំនាក់ទំនង	Kommunikasjonsmodell
ចេមនិងផ្លែប៉ែសយក្ស	Verdens største fersken
ចំណាត់ថ្នាក់ក្រុម:ឥណ្ឌូនេស៊ី	Kategori:Indonesia
ចំណាត់ថ្នាក់ក្រុម:សិង្ហបុរី	Kategori:Singapore
ចំណាត់ថ្នាក់ក្រុម:រូបវិទ្យា	Kategori:Fysikk
ចំណាត់ថ្នាក់ក្រុម:វិទ្យាសាស្រ្តធម្មជាតិ	Kategori:Naturvitenskap
ចំណាត់ថ្នាក់ក្រុម:ជីវវិទ្យា	Kategori:Biologi
ចំណាត់ថ្នាក់ក្រុម:សាសនា	Kategori:Religion
ចំណាត់ថ្នាក់ក្រុម:កីឡា	Kategori:Sport
ចំណាត់ថ្នាក់ក្រុម:វិទ្យាសាស្ត្រ	Kategori:Vitenskap
ប្រជាមតិទាក់ទងនឹងឯករាជភាពរបស់ស្កុតឡែនឆ្នំា២០១៤	Folkeavstemningen om skotsk uavhengighet 2014
សំយុត្តនិកាយ	Samyuttanikaya
សំយោជនៈ	Gjenfødelse
ប្រវត្តិវិទ្យុ	Radiohistorie
ខុទ្ទកនិកាយ	Khuddakanikaya
ទំព័រគំរូ:Dts	Mal:Sorterbar dato
ទីក្រុងរ៉ូមបុរាណ	Romerriket
រឹសគូប	Kubikkrot
ប្រាសាទកោះកេរ	Koh Ker
នរោត្ដម សុរាម្រិត	Norodom Suramarit
Airbus A318	Airbus A318
ការវាយប្រហារដែនអាកាសនៅទីក្រុងបេកដាត ថ្ងៃទី ១២ កក្តដា ២០០៧	Luftangrepet i Bagdad den 12. juli 2007
សញ្ញាណលោការីត	Liste over logaritmeidentiteter
វត្តភ្នំ	Wat Phnom
ប្រាសាទសំបូរព្រៃគុក	Sambor Prei Kuk
គណបក្សសិទ្ធិមនុស្ស	Menneskerettspartiet (Kambodsja)
អាគីតា	Akita
ទ្រឹស្ដីបទវ៉ារីញ៉ុង	Varignons teorem
អ្នកសារពត័មាន	Journalist
ក្រុងតាខ្មៅ	Ta Khmau
ចំណាត់ថ្នាក់ក្រុម:អូឡាំពិក	Kategori:Olympiske leker
ចំណាត់ថ្នាក់ក្រុម:ព្រះពុទ្ធសាសនា	Kategori:Buddhisme
កម្ពុជាសម័យលង្វែក	Lovek
អាកាសយានដ្ឋានអន្តរជាតិក្រុងព្រះសីហនុ	Sihanoukville internasjonale lufthavn
ការដឹងគ្រប់គ្រាន់នៃវិធីដកដង្ហើម១៦យ៉ាង	Anapanasati
ប្រាសាទព្រះពិធូរ	Preah Pithu
ខេត្តបលិខាំសៃ	Bolikhamsai (provins)
សោតទស្សន៏	Audio-visuell
ស្ថាបត្យករខ្មែរ	Arkitektur i Angkor
ប្រាសាទតានៃ	Ta Nei
ចំនួនថេរត្រីកោណមាត្រពិត	Eksakte trigonometriske konstanter
ខ្មែរឥស្សរៈ	Khmer Issarak
មហេន្ទ្រវម៌្មទី១	Mahendravarman
WNBT	WNBC
ទំព័រគំរូ:Location map USA2	Mal:Kartposisjon USA
ចំណាត់ថ្នាក់ក្រុម:អត្ថបទខ្លីមិនពេញលេញ	Kategori:Stubber
ចំណាត់ថ្នាក់ក្រុម:ទ្វីប	Kategori:Kontinenter
ចំណាត់ថ្នាក់ក្រុម:ភូមិវិទ្យា	Kategori:Geologi
ចំណាត់ថ្នាក់ក្រុម:យន្តហោះ	Kategori:Luftfartøyer
យុទ្ធនាការកម្ពុជា	Innmarsjen i Kambodsja
ទំព័រគំរូ:ប្រព័ន្ធព្រះអាទិត្យ	Mal:Solsystem
ដេរីវេនៃអនុគមន៍ត្រីកោណមាត្រ	Derivasjon av trigonometriske funksjoner
ពីរ៉ាមីត	Pyramide
មង្គលសូត្រ	Mangala sutta
និតិភូមិ នវរ័ត្ន	Nitiphoom Naowarat
ពន្ធតែមប្រិ៍	Dokumentavgift
ជំនួយ:ការកត់ឈ្មោះចូល	Hjelp:Logge inn
គ្រោះមហន្តរាយ	Katastrofe
វិគីភីឌា:Reference desk	Wikipedia:Orakelet
ទំព័រគំរូ:Authority control	Mal:Autoritetsdata
ទំព័រគំរូ:Quote	Mal:Sitat
ទំព័រគំរូ:Location map Scotland	Mal:Kartposisjon Skottland
ទំព័រគំរូ:Location map England	Mal:Kartposisjon England
ចំណាត់ថ្នាក់ក្រុម:សេដ្ឋកិច្ច	Kategori:Nasjonaløkonomi
វិគីភីឌា:សុំប្តូរអត្តនាម	Wikipedia:Endring av brukernavn
ចំណាត់ថ្នាក់ក្រុម:ជនជាតិ ភាគតិច ក្នុង ប្រទេស កម្ពុជា	Kategori:Folkegrupper i Kambodsja
វិគីភីឌា:រូបយន្ត	Wikipedia:Roboter
ចំណាត់ថ្នាក់ក្រុម:Hidden categories	Kategori:Skjulte kategorier
អេហ៊្សីប	Egypt
ជំនួយ:ទំព័រគំរូ	Hjelp:Maler
ឦសានវម៌្មទី១	Isanavarman I
វិគីភីឌា:វិគីគម្រោង	Wikipedia:Underprosjekter
ទំព័រគំរូ:Bot	Mal:Bot
វិគីភីឌា:អ្វីៗដែលវិគីភីឌាមិនអនុញ្ញាត	Wikipedia:Hva Wikipedia ikke er
កាណាដា	Canada
ចំណាត់ថ្នាក់ក្រុម:ប្រទេសអាយឡែន	Kategori:Island
វិគីភីឌា:អំពីវិគីភីឌា	Wikipedia:Om
ចំណាត់ថ្នាក់ក្រុម:ខ្នាតក្រលាផ្ទៃ	Kategori:Flateenheter
ជំនួយ:ពាក្យទិព្វ	Hjelp:Magiske ord
ទំព័រគំរូ:Flagicon	Mal:Flagicon
ចំណាត់ថ្នាក់ក្រុម:អឺរ៉ុប	Kategori:Europa
ចំណាត់ថ្នាក់ក្រុម:ជំនួយក្នុងវិគីភីឌា	Kategori:Hjelp
វិគីភីឌា:ទំព័រអ្នកប្រើប្រាស់	Wikipedia:Brukersider
ទំព័រគំរូ:Documentation	Mal:Dokumentasjon
វិគីភីឌា:អ្នកប្រើប្រាស់	Wikipedia:Brukertyper
ចំណាត់ថ្នាក់ក្រុម:Wikipedia pages with incorrect protection templates	Kategori:Sider med feilaktige beskyttelsesmaler
វិគីភីឌា:Protection policy	Wikipedia:Denne siden er beskyttet
អាជ្ញាធរអប្សរា	APSARA
វិគីភីឌា:WikiLove	Wikipedia:Wikikjærlighet
វិគីភីឌា:Userboxes	Wikipedia:Brukerbokser
វិគីភីឌា:ហត្ថលេខា	Hjelp:Signatur
វិគីភីឌា:អត្ថបទខ្លីមិនពេញលេញ	Wikipedia:Stubb
វិគីភីឌា:Most wanted articles	Wikipedia:Ønskelisten
ស្រាបៀរ អង្គរ	Angkor (øl)
វិគីភីឌា:Huggle	Wikipedia:Huggle
ទំព័រគំរូ:Softredirect	Mal:Softredirect
ទំព័រគំរូ:លុបជាបន្ទាន់	Mal:Hurtigsletting
ចំណាត់ថ្នាក់ក្រុម:ភាសា	Kategori:Språk
ចំណាត់ថ្នាក់ក្រុម:វេយ្យាករណ៍	Kategori:Grammatikk
ចំណាត់ថ្នាក់ក្រុម:វិគីភីឌា	Kategori:Wikipedia
វិគីភីឌា:ការបដិសេធ ទូទៅ	Wikipedia:Generelle forbehold
ជំនួយ:ចំណាត់ថ្នាក់ក្រុម	Hjelp:Kategorier
វិគីភីឌា:អសង្ស័យកម្ម	Wikipedia:Stilmanual
Portal:Contents/Portals	Portal:Portaler
ទំព័រគំរូ:Navbox	Mal:Navboks
ជំនួយ:រូបមន្ត	Hjelp:Vise en formel
ទំព័រគំរូ:Coat of arms	Mal:Våpenskjold
ទំព័រគំរូ:Citation needed	Mal:Trenger referanse
តំបន់ពាណិជ្ជកម្មសេរី	Frihandelsområde
ទំព័រគំរូ:Error	Mal:Feil
ទំព័រគំរូ:!	Mal:!
ចំណាត់ថ្នាក់ក្រុម:Flag templates	Kategori:Flaggmaler
ទំព័រគំរូ:((	Mal:((
ទំព័រគំរូ:))	Mal:))
ទំព័រគំរូ:=	Mal:=
ទំព័រគំរូ:Navbar	Mal:Tnavbar
ទំព័រគំរូ:Loop	Mal:Loop
ទំព័រគំរូ:Void	Mal:Void
ទំព័រគំរូ:Key press	Mal:Tastekombo
ទំព័រគំរូ:Small	Mal:Small
ទំព័រគំរូ:Clear	Mal:Clear
ទំព័រគំរូ:Col-break	Mal:Col-break
ទំព័រគំរូ:Col-begin	Mal:Col-begin
ទំព័រគំរូ:Col-end	Mal:Col-end
ទំព័រគំរូ:Trim	Mal:Trim
ទំព័រគំរូ:Color	Mal:Farve
ទំព័រគំរូ:Nowrap	Mal:Nowrap
ទំព័រគំរូ:Bots	Mal:Bots
ទំព័រគំរូ:Abbr	Mal:Abbr
វិគីភីឌា:វិគីគម្រោង ទំព័រគំរូ	Wikipedia:Underprosjekter/malstandardisering
ចំណាត់ថ្នាក់ក្រុម:ខ្សែកោង	Kategori:Kurver
ទំព័រគំរូ:Babel-3	Mal:Babel-3
ទំព័រគំរូ:Babel	Mal:Babel
ទំព័រគំរូ:Commons	Mal:Commons
ទំព័រគំរូ:Reflist	Mal:Referanser
វិគីភីឌា:Citing sources	Wikipedia:Bruk av kilder
ទំព័រគំរូ:អត្ថបទខ្លីមិនពេញលេញ	Mal:Stubb
ទំព័រគំរូ:User af-1	Mal:Bruker af-1
ទំព័រគំរូ:User als-1	Mal:Bruker als-1
ទំព័រគំរូ:User az	Mal:Bruker az
ទំព័រគំរូ:User bar-1	Mal:Bruker bar-1
ទំព័រគំរូ:See also	Mal:Se også
ទំព័រគំរូ:User de	Mal:Bruker de
ទំព័រគំរូ:User de-1	Mal:Bruker de-1
ទំព័រគំរូ:User et-1	Mal:Bruker et-1
ទំព័រគំរូ:User el	Mal:Bruker el
ទំព័រគំរូ:User es	Mal:Bruker es
ទំព័រគំរូ:User de-3	Mal:Bruker de-3
ទំព័រគំរូ:User en-3	Mal:Bruker en-3
ទំព័រគំរូ:User en-1	Mal:Bruker en-1
ទំព័រគំរូ:User en-2	Mal:Bruker en-2
ទំព័រគំរូ:User en-4	Mal:Bruker en-4
ទំព័រគំរូ:User fi	Mal:Bruker fi
ទំព័រគំរូ:User en-0	Mal:Bruker en-0
ទំព័រគំរូ:User es-4	Mal:Bruker es-4
ទំព័រគំរូ:User en	Mal:Bruker en
ទំព័រគំរូ:User de-2	Mal:Bruker de-2
ទំព័រគំរូ:User es-1	Mal:Bruker es-1
ទំព័រគំរូ:User fa	Mal:Bruker fa
ទំព័រគំរូ:User fr-1	Mal:Bruker fr-1
ទំព័រគំរូ:User id-3	Mal:Bruker id-3
ទំព័រគំរូ:User it-3	Mal:Bruker it-3
ទំព័រគំរូ:User tr-2	Mal:Bruker tr-2
ទំព័រគំរូ:User fr-2	Mal:Bruker fr-2
ទំព័រគំរូ:User tr	Mal:Bruker tr
ទំព័រគំរូ:User ja	Mal:Bruker ja
ទំព័រគំរូ:User ja-1	Mal:Bruker ja-1
ទំព័រគំរូ:User it-1	Mal:Bruker it-1
ទំព័រគំរូ:User fr	Mal:Bruker fr
ទំព័រគំរូ:Location map/Info	Mal:Kartposisjon/Info
ចំណាត់ថ្នាក់ក្រុម:Navigational boxes	Kategori:Navigasjonsmaler
ចំណាត់ថ្នាក់ក្រុម:អាស៊ី	Kategori:Asia
ចំណាត់ថ្នាក់ក្រុម:User uk-N	Kategori:Bruker uk-N
ទំព័រគំរូ:Intricate template	Mal:Komplisert mal
ទំព័រគំរូ:Football squad player	Mal:Fs player
ទំព័រគំរូ:Mod	Mal:Mod
ទំព័រគំរូ:Now Commons	Mal:NowCommons
ទំព័រគំរូ:User it	Mal:Bruker it
ទំព័រគំរូ:User uk	Mal:Bruker uk
ទំព័រគំរូ:User es-2	Mal:Bruker es-2
ទំព័រគំរូ:ស្វាគមន៍	Mal:Reg-velkommen
ទំព័រគំរូ:គម្រោងវិគីជាបងប្អូន	Mal:Søsterprosjekt
ចំណាត់ថ្នាក់ក្រុម:External link templates	Kategori:Maler for eksterne lenker
ចំណាត់ថ្នាក់ក្រុម:ទំព័រគំរូសំរាប់កូអរដោនេ	Kategori:Koordinatmaler
ចំណាត់ថ្នាក់ក្រុម:User ms	Kategori:Bruker ms
ចំណាត់ថ្នាក់ក្រុម:User fr-1	Kategori:Bruker fr-1
ទំព័រគំរូ:Wikiquote	Mal:Wikiquote
ទំព័រគំរូ:Country showdata	Mal:Country showdata
ទំព័រគំរូ:Image label	Mal:Image label
ទំព័រគំរូ:Cat handler	Mal:Category handler
ទំព័រគំរូ:ប្រអប់ព័ត៌មាន អ្នកនិពន្ធ	Mal:Infoboks forfatter
ទំព័រគំរូ:Ja icon	Mal:Ja icon
ទំព័រគំរូ:Infobox television	Mal:Infobox Television
ទំព័រគំរូ:Geographic location	Mal:Geografisk plassering
ទំព័រគំរូ:Infobox musical artist	Mal:Infoboks musiker
ទំព័រគំរូ:Collapsible list	Mal:Sammenleggbar liste
ទំព័រគំរូ:Es icon	Mal:Es icon
ទំព័រគំរូ:Ambox	Mal:Amboks
ទំព័រគំរូ:Update	Mal:Trenger oppdatering
ទំព័រគំរូ:ប្រអប់ព័ត៌មាន ទស្សនាវដ្ដី	Mal:Infoboks forskningstidsskrift
ទំព័រគំរូ:Image requested	Mal:Trenger bilde
ទំព័រគំរូ:ប្រអប់ព័ត៌មាន ភ្លេងជាតិ	Mal:Infoboks hymne
ទំព័រគំរូ:Navigation templates	Mal:Navigational templates
ទំព័រគំរូ:ប្រអប់ព័ត៌មាន សាលារៀន	Mal:Infoboks skole
ទំព័រគំរូ:Userboxbottom	Mal:Brukerboksbunn
ទំព័រគំរូ:Rnd	Mal:Rnd
ទំព័រគំរូ:ចំណាត់ថ្នាក់ក្រុមនៃទំព័រគំរូ	Mal:Malkategori
ទំព័រគំរូ:ប្រអប់ព័ត៌មាន ប្រទេស	Mal:Infoboks land2
ទំព័រគំរូ:Max	Mal:Max
ទំព័រគំរូ:Infobox software	Mal:Infoboks programvare
ទំព័រគំរូ:Commons&cat	Mal:Commons og kategori
ទំព័រគំរូ:Infobox airline	Mal:Infoboks flyselskap
ទំព័រគំរូ:Wide image	Mal:Panoramabilde
ទំព័រគំរូ:Collapsible option	Mal:Collapsible option
វិគីភីឌា:សំណួរ	Wikipedia:Spørsmål
ទំព័រគំរូ:Redirect4	Mal:Str left
ទំព័រគំរូ:Cat more	Mal:Hovedartikkel2
ទំព័រគំរូ:Px	Mal:Px
ទំព័រគំរូ:Str sub long	Mal:Str sub
ទំព័រគំរូ:Flatlist	Mal:Flatlist
ទំព័រគំរូ:ប្រអប់ព័ត៌មាន គណបក្សនយោបាយ	Mal:Infoboks parti
ទំព័រគំរូ:Used in system	Mal:Brukes av systemet
ទំព័រគំរូ:Expand section	Mal:Seksjonstubb
ទំព័រគំរូ:Tmbox	Mal:Tmbox
ទំព័រគំរូ:ប្រអប់ព័ត៌មាន ល្បែងវីដេអូ	Mal:Infoboks videospill
ទំព័រគំរូ:S-start	Mal:S-start
ទំព័រគំរូ:Age in years and days	Mal:Tid i år og dager
ទំព័រគំរូ:Facebook	Mal:Facebook
ទំព័រគំរូ:Cleanup	Mal:Opprydning
ទំព័រគំរូ:ប្រអប់ព័ត៌មាន សាកលវិទ្យាល័យ	Mal:Infoboks universitet
ទំព័រគំរូ:វិគីសៀវភៅ	Mal:Wikibøker
ទំព័រគំរូ:Hatnote	Mal:Dablink
ទំព័រគំរូ:Xpd	Mal:Xpd
ទំព័រគំរូ:Familytree	Mal:Stamtre
ទំព័រគំរូ:Redirect3	Mal:Omdirigering3
ទំព័រគំរូ:Featured article	Mal:Utmerket
ទំព័រគំរូ:Infobox monarch	Mal:Infoboks monark
ចំណាត់ថ្នាក់ក្រុម:User en-4	Kategori:Bruker en-4
ចំណាត់ថ្នាក់ក្រុម:User en	Kategori:Bruker en
ចំណាត់ថ្នាក់ក្រុម:User zh	Kategori:Bruker zh
ចំណាត់ថ្នាក់ក្រុម:User zh-N	Kategori:Bruker zh-N
ចំណាត់ថ្នាក់ក្រុម:User en-2	Kategori:Bruker en-2
ទំព័រគំរូ:ប្រអប់ព័ត៌មាន	Mal:Infoboks
ទំព័រគំរូ:Infobox instrument	Mal:Infoboks instrument
ទំព័រគំរូ:TOC right	Mal:TOC right
ទំព័រគំរូ:Main other	Mal:Main other
ទំព័រគំរូ:RankedMedalTable	Mal:Medaljestatistikk
ទំព័រគំរូ:User zh	Mal:Bruker zh
ទំព័រគំរូ:Documentation/start box	Mal:Dokumentasjon/start boks
ទំព័រគំរូ:Documentation/end box2	Mal:Dokumentasjon/end boks 2
ទំព័រគំរូ:Documentation/start box2	Mal:Dokumentasjon/start boks 2
ទំព័រគំរូ:Legend	Mal:Legend
ទំព័រគំរូ:Cite web	Mal:Kilde www
ទំព័រគំរូ:YouTube	Mal:YouTube
ទំព័រគំរូ:Current	Mal:Pågående
ទំព័រគំរូ:Ombox	Mal:Pmboks
ទំព័រគំរូ:Won	Mal:Vant
ទំព័រគំរូ:Tnavbar-collapsible	Mal:Navbar-collapsible
ទំព័រគំរូ:Coor URL	Mal:Koor URL
ទំព័រគំរូ:Pp-template	Mal:Beskyttet side
ទំព័រគំរូ:Min	Mal:Min
ទំព័រគំរូ:Wiktionary	Mal:Wiktionary
ទំព័រគំរូ:Mbox templates	Mal:Mboks-maler
ទំព័រគំរូ:Multi-listen start	Mal:Multi-listen start
ទំព័រគំរូ:Bar box	Mal:Stolpediagram
ទំព័រគំរូ:Chem	Mal:Kjemi
ទំព័រគំរូ:Language icon	Mal:Språkikon
ទំព័រគំរូ:Babel-4	Mal:Babel-4
ទំព័រគំរូ:Babel-5	Mal:Babel-5
ទំព័រគំរូ:Babel-2	Mal:Babel-2
ទំព័រគំរូ:Babel-6	Mal:Babel-6
ទំព័រគំរូ:User ru	Mal:Bruker ru
ទំព័រគំរូ:Admin	Mal:Admin
ទំព័រគំរូ:IPA	Mal:IPA
ទំព័រគំរូ:អត្ថន័យដទៃទៀត	Mal:Andrebetydninger
ទំព័រគំរូ:Language with name	Mal:Language with name
ទំព័រគំរូ:Birth year and age	Mal:Fødselsdato og alder
ទំព័រគំរូ:List of African capitals	Mal:Hovedsteder i Afrika
ទំព័រគំរូ:ប្រអប់ព័ត៌មាន ក្រុមជនជាតិ	Mal:Infoboks folk
ទំព័រគំរូ:Archive box	Mal:Arkiv
ទំព័រគំរូ:MONTHNAME	Mal:MONTHNAME
វិគីភីឌា:Text of GNU Free Documentation License	Wikipedia:GNU FDL
ទំព័រគំរូ:រង្វាន់ណូបែល	Mal:Nobelprisen
ទំព័រគំរូ:Sisterlinks	Mal:Søsterlenker
ទំព័រគំរូ:Border	Mal:Border
ទំព័រគំរូ:Death date and age	Mal:Dødsdato og alder
ចំណាត់ថ្នាក់ក្រុម:People stubs	Kategori:Biografistubber
ទំព័រគំរូ:Top icon	Mal:Toppikon
ទំព័រគំរូ:Icon	Mal:Ikon
ទំព័រគំរូ:Namespace detect	Mal:Namespace detect
ចំណាត់ថ្នាក់ក្រុម:ជ័យលាភីរង្វាន់ណូបែល ផ្នែករូបវិទ្យា	Kategori:Nobelprisvinnere (fysikk)
ចំណាត់ថ្នាក់ក្រុម:ជ័យលាភីរង្វាន់ណូបែល ផ្នែកគីមីវិទ្យា	Kategori:Nobelprisvinnere (kjemi)
ទំព័រគំរូ:Fmbox	Mal:Fmbox
ទំព័រគំរូ:GeoGroup	Mal:Alle koordinater
ទំព័រគំរូ:Wikify	Mal:Wikifisering
ទំព័រគំរូ:ប្រអប់ព័ត៌មាន សៀវភៅ	Mal:Infoboks bok
ទំព័រគំរូ:Tlc	Mal:Tlc
ទំព័រគំរូ:ប្រអប់ព័ត៌មាន ភព	Mal:Infoboks planet
ទំព័រគំរូ:Compact periodic table	Mal:Periodesystemet
ទំព័រគំរូ:Lang-fa	Mal:Lang-fa
ទំព័រគំរូ:ICD10	Mal:ICD10
ទំព័រគំរូ:Infobox website	Mal:Infoboks nettsted
ទំព័រគំរូ:Globalize	Mal:Geografisk omfang
ទំព័រគំរូ:Babel-7	Mal:Babel-7
ទំព័រគំរូ:Navboxes	Mal:Navbokser
ទំព័រគំរូ:Documentation subpage	Mal:Dokumentasjonsunderside
ទំព័រគំរូ:Uncategorized	Mal:Ukategorisert
ទំព័រគំរូ:Talk header for guidelines	Mal:Diskusjonsside
ទំព័រគំរូ:Quote box	Mal:Sitatboks
ទំព័រគំរូ:CcTLD	Mal:CcTLD
ទំព័រគំរូ:ប្រអប់ព័ត៌មានទីកន្លែងកេរដំណែលពិភពលោក	Mal:Infoboks verdensarven
ទំព័រគំរូ:Str len	Mal:Str len
ទំព័រគំរូ:Purge	Mal:Oppdater
ទំព័រគំរូ:Empty category	Mal:Tom kategori
ទំព័រគំរូ:Pre2	Mal:Pre2
ទំព័រគំរូ:ប្រអប់ព័ត៌មាន អាគារ	Mal:Infoboks bygning
ទំព័រគំរូ:'	Mal:'
ទំព័រគំរូ:Chessgames player	Mal:Chessgames spiller
ទំព័រគំរូ:User page	Mal:Brukerside
ទំព័រគំរូ:ប្រអប់ព័ត៌មាន ព្រះវិហារគ្រិស្ដសាសនា	Mal:Infoboks kirke
ទំព័រគំរូ:Infobox Christian leader	Mal:Infoboks pave
ទំព័រគំរូ:User	Mal:Bruker
ទំព័រគំរូ:Clarify	Mal:Klargjør
ទំព័រគំរូ:Refimprove	Mal:Kildeløs
ទំព័រគំរូ:Lorem ipsum	Mal:Lorem ipsum
ទំព័រគំរូ:ស្នើសុំប្ដូរឈ្មោះ	Mal:Forandre brukernavn
ទំព័រគំរូ:CIA World Factbook link	Mal:World Factbook
ទំព័រគំរូ:Image label small	Mal:Image label small
ទំព័រគំរូ:Nihongo	Mal:Nihongo
ទំព័រគំរូ:User fr-3	Mal:Bruker fr-3
ទំព័រគំរូ:PD-because	Mal:PD
ទំព័រគំរូ:Failed verification	Mal:Ikke i angitt kilde
ទំព័រគំរូ:Tag	Mal:Tag
ទំព័រគំរូ:Notelist	Mal:Notater
ទំព័រគំរូ:Infobox former country	Mal:Infoboks tidligere land2
ទំព័រគំរូ:ភូមិភាគទាំង៩របស់ជប៉ុន	Mal:Japans regioner og prefekturer
ទំព័រគំរូ:Merge from	Mal:Flett fra
ទំព័រគំរូ:Cmbox	Mal:Kmboks
ទំព័រគំរូ:ASIN	Mal:ASIN
ជំនួយ:តារាង	Hjelp:Tabeller
ទំព័រគំរូ:Age in days nts	Mal:Alder i dager
ទំព័រគំរូ:S-bef	Mal:S-bef
ទំព័រគំរូ:Nations at the 2008 Summer Olympics	Mal:OL 2008 nasjoner
ទំព័រគំរូ:JULIANDAY	Mal:JULIANDAY
ទំព័រគំរូ:Mbox	Mal:Mbox
ទំព័រគំរូ:Disagree	Mal:Imot
ទំព័រគំរូ:DNB portal	Mal:DNB-Portal
ទំព័រគំរូ:Talkarchive	Mal:Arkivert
ទំព័រគំរូ:Pagetype	Mal:Pagetype
ទំព័រគំរូ:Bibleverse	Mal:Bibelvers
ទំព័រគំរូ:Infobox historical event	Mal:Infoboks historisk hendelse
ទំព័រគំរូ:Date	Mal:ISOtilNorskdato
ទំព័រគំរូ:សបា្ដហ៍	Mal:Ukedager
ទំព័រគំរូ:To do	Mal:Huskeliste
ទំព័រគំរូ:CURRENTJULIANDAY	Mal:CURRENTJULIANDAY
ទំព័រគំរូ:Nobold	Mal:Nobold
ចំណាត់ថ្នាក់ក្រុម:User ja-N	Kategori:Bruker ja-N
ទំព័រគំរូ:PDFlink	Mal:PDFlink
ទំព័រគំរូ:Ca icon	Mal:Ca icon
ទំព័រគំរូ:Lang-ru	Mal:Lang-ru
ទំព័រគំរូ:Infobox saint	Mal:Infoboks helgen
ទំព័រគំរូ:URL	Mal:URL
ទំព័រគំរូ:ណែនាំ	Mal:Peker
ទំព័រគំរូ:Tlsp	Mal:Malsp
ទំព័រគំរូ:DEFAULTSORT	Mal:DEFAULTSORT
ទំព័រគំរូ:Tick	Mal:Hake
ចំណាត់ថ្នាក់ក្រុម:ទំព័រគំរូ ប្រអប់ព័ត៌មាន	Kategori:Infobokser
ចំណាត់ថ្នាក់ក្រុម:Lists of flags	Kategori:Flagglister
ទំព័រគំរូ:Select skin	Mal:Select skin
ទំព័រគំរូ:Plainlist	Mal:Plainlist
ចំណាត់ថ្នាក់ក្រុម:អ្នកថតរូប	Kategori:Fotografi
ទំព័រគំរូ:Para	Mal:Para
ចំណាត់ថ្នាក់ក្រុម:យន្តហោះយោធា	Kategori:Militære fly
ទំព័រគំរូ:Death year and age	Mal:Dødsår og alder
ទំព័រគំរូ:States of Austria	Mal:Østerrikes delstater
ទំព័រគំរូ:Order of magnitude	Mal:Ordomag
ទំព័រគំរូ:Tlf	Mal:Tlf
ទំព័រគំរូ:Ifsubst	Mal:Ifsubst
ទំព័រគំរូ:Lower	Mal:Senke
ទំព័រគំរូ:Caution	Mal:Viktig
ទំព័រគំរូ:ISOCALENDAR	Mal:Calendar
ចំណាត់ថ្នាក់ក្រុម:អង្គការមិនរកប្រាក់កំរៃ	Kategori:Ideelle organisasjoner
ទំព័រគំរូ:Lang-uk	Mal:Lang-uk
ទំព័រគំរូ:Contains Chinese text	Mal:Inneholder kinesisk
ទំព័រគំរូ:ប្រអប់ព័ត៌មាន អង្គការ	Mal:Infoboks organisasjon
ទំព័រគំរូ:Category TOC	Mal:KategoriTOC
ទំព័រគំរូ:IPA-fr	Mal:IPA-fr
ទំព័រគំរូ:Fix	Mal:Fix
ទំព័រគំរូ:EMedicine2	Mal:EMedicine2
ទំព័រគំរូ:លំហឈ្មោះ	Mal:Navnerom
ចំណាត់ថ្នាក់ក្រុម:User gsw-1	Kategori:Bruker gsw-1
ទំព័រគំរូ:User it-2	Mal:Bruker it-2
ទំព័រគំរូ:Superimpose	Mal:Bilde med markering
ទំព័រគំរូ:Age	Mal:Alder
ទំព័រគំរូ:Pending	Mal:Pending
ទំព័រគំរូ:Infobox person	Mal:Infoboks biografi
ទំព័រគំរូ:Number table sorting	Mal:Sorterbart tall
ទំព័រគំរូ:List of European capitals by region	Mal:Hovedsteder i Europa
ទំព័រគំរូ:Legend-line	Mal:Legend linje
ចំណាត់ថ្នាក់ក្រុម:ព្រះមហាក្សត្រខ្មែរ	Kategori:Kambodsjanske monarker
ទំព័រគំរូ:Election table	Mal:Valgtabell
ទំព័រគំរូ:World Trade Organization	Mal:WTO
ទំព័រគំរូ:UF-coord-classes	Mal:UF-coord-classes
ទំព័រគំរូ:Coord	Mal:Koord
ទំព័រគំរូ:POV	Mal:Objektivitet
ចំណាត់ថ្នាក់ក្រុម:20th-century births	Kategori:Fødsler på 1900-tallet
ទំព័រគំរូ:Dmoz	Mal:Dmoz
ចំណាត់ថ្នាក់ក្រុម:ពហុកោណ	Kategori:Polygoner
ទំព័រគំរូ:User lb-1	Mal:Bruker lb-1
ទំព័រគំរូ:User fr-4	Mal:Bruker fr-4
ទំព័រគំរូ:User la-1	Mal:Bruker la-1
ទំព័រគំរូ:ព្រះពុទ្ធសាសនា	Mal:Buddhisme
ទំព័រគំរូ:Biology-stub	Mal:Biologistubb
ចំណាត់ថ្នាក់ក្រុម:ឯកសារអំពី ទំព័រគំរូ	Kategori:Maldokumentasjonssider
ចំណាត់ថ្នាក់ក្រុម:User pdc	Kategori:Bruker pdc
ចំណាត់ថ្នាក់ក្រុម:User et	Kategori:Bruker et
ចំណាត់ថ្នាក់ក្រុម:User fr	Kategori:Bruker fr
ចំណាត់ថ្នាក់ក្រុម:User id	Kategori:Bruker id
ចំណាត់ថ្នាក់ក្រុម:User ja	Kategori:Bruker ja
ចំណាត់ថ្នាក់ក្រុម:User km	Kategori:Bruker km
ចំណាត់ថ្នាក់ក្រុម:User la	Kategori:Bruker la
ចំណាត់ថ្នាក់ក្រុម:User li	Kategori:Bruker li
ចំណាត់ថ្នាក់ក្រុម:User sv	Kategori:Bruker sv
ចំណាត់ថ្នាក់ក្រុម:User th	Kategori:Bruker th
ចំណាត់ថ្នាក់ក្រុម:User fr-3	Kategori:Bruker fr-3
ចំណាត់ថ្នាក់ក្រុម:User it-3	Kategori:Bruker it-3
ចំណាត់ថ្នាក់ក្រុម:User ja-3	Kategori:Bruker ja-3
ចំណាត់ថ្នាក់ក្រុម:User tr-3	Kategori:Bruker tr-3
ចំណាត់ថ្នាក់ក្រុម:User pdc-1	Kategori:Bruker pdc-1
ចំណាត់ថ្នាក់ក្រុម:User et-1	Kategori:Bruker et-1
ចំណាត់ថ្នាក់ក្រុម:User li-1	Kategori:Bruker li-1
ចំណាត់ថ្នាក់ក្រុម:User nl-1	Kategori:Bruker nl-1
ចំណាត់ថ្នាក់ក្រុម:User tr-1	Kategori:Bruker tr-1
ចំណាត់ថ្នាក់ក្រុម:User fr-4	Kategori:Bruker fr-4
ចំណាត់ថ្នាក់ក្រុម:User it-4	Kategori:Bruker it-4
ចំណាត់ថ្នាក់ក្រុម:User fr-2	Kategori:Bruker fr-2
ចំណាត់ថ្នាក់ក្រុម:User it-2	Kategori:Bruker it-2
ចំណាត់ថ្នាក់ក្រុម:User ja-2	Kategori:Bruker ja-2
ចំណាត់ថ្នាក់ក្រុម:User la-2	Kategori:Bruker la-2
ចំណាត់ថ្នាក់ក្រុម:User tr-2	Kategori:Bruker tr-2
ចំណាត់ថ្នាក់ក្រុម:User fr-N	Kategori:Bruker fr-N
ចំណាត់ថ្នាក់ក្រុម:User it-N	Kategori:Bruker it-N
ចំណាត់ថ្នាក់ក្រុម:User nl-N	Kategori:Bruker nl-N
ចំណាត់ថ្នាក់ក្រុម:User ru-N	Kategori:Bruker ru-N
ចំណាត់ថ្នាក់ក្រុម:កំសាន្ត	Kategori:Underholdning
ចំណាត់ថ្នាក់ក្រុម:Image insertion templates	Kategori:Bildeinnsettingsmaler
ចំណាត់ថ្នាក់ក្រុម:User af	Kategori:Bruker af
ចំណាត់ថ្នាក់ក្រុម:User af-1	Kategori:Bruker af-1
ចំណាត់ថ្នាក់ក្រុម:User bar	Kategori:Bruker bar
ចំណាត់ថ្នាក់ក្រុម:User bar-1	Kategori:Bruker bar-1
ចំណាត់ថ្នាក់ក្រុម:កោះ	Kategori:Øyer
ចំណាត់ថ្នាក់ក្រុម:User de	Kategori:Bruker de
ចំណាត់ថ្នាក់ក្រុម:User de-2	Kategori:Bruker de-2
ចំណាត់ថ្នាក់ក្រុម:User de-3	Kategori:Bruker de-3
ចំណាត់ថ្នាក់ក្រុម:User de-4	Kategori:Bruker de-4
ចំណាត់ថ្នាក់ក្រុម:User de-N	Kategori:Bruker de-N
ចំណាត់ថ្នាក់ក្រុម:User el	Kategori:Bruker el
ចំណាត់ថ្នាក់ក្រុម:User en-3	Kategori:Bruker en-3
ចំណាត់ថ្នាក់ក្រុម:User en-N	Kategori:Bruker en-N
ចំណាត់ថ្នាក់ក្រុម:User es	Kategori:Bruker es
ចំណាត់ថ្នាក់ក្រុម:User es-1	Kategori:Bruker es-1
ចំណាត់ថ្នាក់ក្រុម:User es-2	Kategori:Bruker es-2
ចំណាត់ថ្នាក់ក្រុម:User es-4	Kategori:Bruker es-4
ចំណាត់ថ្នាក់ក្រុម:User es-N	Kategori:Bruker es-N
ចំណាត់ថ្នាក់ក្រុម:User fi	Kategori:Bruker fi
ចំណាត់ថ្នាក់ក្រុម:User fi-N	Kategori:Bruker fi-N
ចំណាត់ថ្នាក់ក្រុម:User gsw	Kategori:Bruker gsw
ទំព័រគំរូ:N/a	Mal:N/a
ចំណាត់ថ្នាក់ក្រុម:User id-1	Kategori:Bruker id-1
ចំណាត់ថ្នាក់ក្រុម:User id-2	Kategori:Bruker id-2
ចំណាត់ថ្នាក់ក្រុម:User id-3	Kategori:Bruker id-3
ទំព័រគំរូ:Multiple image	Mal:Flere bilder
ចំណាត់ថ្នាក់ក្រុម:ធរណីមាត្រ	Kategori:Geometri
ទំព័រគំរូ:អង្គការសហប្រជាជាតិ	Mal:FN
ទំព័រគំរូ:ប្រអប់ព័ត៌មាន រោគ-ជំងឺ	Mal:Infoboks sykdom
ទំព័រគំរូ:User wikipedia/Administrator	Mal:Administrator
ទំព័រគំរូ:Weather box	Mal:Klimatabell
ចំណាត់ថ្នាក់ក្រុម:User it	Kategori:Bruker it
ចំណាត់ថ្នាក់ក្រុម:User it-1	Kategori:Bruker it-1
ចំណាត់ថ្នាក់ក្រុម:User ja-1	Kategori:Bruker ja-1
ចំណាត់ថ្នាក់ក្រុម:User km-1	Kategori:Bruker km-1
ចំណាត់ថ្នាក់ក្រុម:User km-2	Kategori:Bruker km-2
ចំណាត់ថ្នាក់ក្រុម:User km-3	Kategori:Bruker km-3
ចំណាត់ថ្នាក់ក្រុម:User km-N	Kategori:Bruker km-N
ចំណាត់ថ្នាក់ក្រុម:User ko	Kategori:Bruker ko
ចំណាត់ថ្នាក់ក្រុម:User ko-1	Kategori:Bruker ko-1
ចំណាត់ថ្នាក់ក្រុម:User ko-2	Kategori:Bruker ko-2
ចំណាត់ថ្នាក់ក្រុម:User ko-3	Kategori:Bruker ko-3
ចំណាត់ថ្នាក់ក្រុម:User ksh	Kategori:Bruker ksh
ចំណាត់ថ្នាក់ក្រុម:User ksh-N	Kategori:Bruker ksh-N
ចំណាត់ថ្នាក់ក្រុម:User la-1	Kategori:Bruker la-1
ចំណាត់ថ្នាក់ក្រុម:User lb	Kategori:Bruker lb
ចំណាត់ថ្នាក់ក្រុម:User lb-1	Kategori:Bruker lb-1
ទំព័រគំរូ:Economics sidebar	Mal:Samfunnsøkonomi
ទំព័រគំរូ:Cite doi	Mal:Kilde doi
ទំព័រគំរូ:ប្រអប់ព័ត៌មាន រូបិយវត្ថុ	Mal:Infoboks valuta
ទំព័រគំរូ:Sup	Mal:Sup
ទំព័រគំរូ:Current U.S. Senators	Mal:Nåværende amerikanske senatorer
ទំព័រគំរូ:Distinguish	Mal:Forveksles
ទំព័រគំរូ:Infobox programming language	Mal:Infoboks programmeringsspråk
បញ្ជីរាយនាម ជ័យលាភីរង្វាន់ណូបែល ផ្នែកអក្សរសាស្ត្រ	Liste over nobelprisvinnere i litteratur
ចំណាត់ថ្នាក់ក្រុម:User ru-1	Kategori:Bruker ru-1
ទំព័រគំរូ:TOC limit	Mal:TOClimit
វិគីភីឌា:បាបេល	Wikipedia:Babel
ទំព័រគំរូ:Hilite	Mal:Markeringspenn
ទំព័រគំរូ:ភាសាជាផ្លូវការប្រើនៅអសប	Mal:FNs offisielle språk
ទំព័រគំរូ:High-use	Mal:Mye brukt mal
ទំព័រគំរូ:Expand list	Mal:Ufullstendig liste
ទំព័រគំរូ:Tdeprecated	Mal:Utdatert mal
ទំព័រគំរូ:Help pages header	Mal:Hjelpesider
ទំព័រគំរូ:Wikipedia how to	Mal:Wikipedia how to
ទំព័រគំរូ:UN Security Council	Mal:Sikkerhetsrådet
ទំព័រគំរូ:Sidebar with collapsible lists	Mal:Sideboks med sammenklappbare lister
ទំព័រគំរូ:Talk other	Mal:Diskusjon annen
ចំណាត់ថ្នាក់ក្រុម:User ms-2	Kategori:Bruker ms-2
ទំព័រគំរូ:Redirect2	Mal:Omdirigering2
ចំណាត់ថ្នាក់ក្រុម:សមុទ្រ	Kategori:Hav
ទំព័រគំរូ:User WikiProject Templates	Wikipedia:Underprosjekter/malstandardisering/brukerboks
ទំព័រគំរូ:User2	Mal:Bruker2
ទំព័រគំរូ:FishBase family	Mal:FishBase-familie
ទំព័រគំរូ:IPA-all	Mal:IPA2
ចំណាត់ថ្នាក់ក្រុម:User nds	Kategori:Bruker nds
ទំព័រគំរូ:Sect1911	Mal:1911
ចំណាត់ថ្នាក់ក្រុម:User nds-1	Kategori:Bruker nds-1
ជំនួយ:Archiving a talk page	Hjelp:Arkivering
ចំណាត់ថ្នាក់ក្រុម:អង្គការអន្តរជាតិ	Kategori:Internasjonale organisasjoner
ទំព័រគំរូ:Sfn	Mal:Sfn
ជំនួយ:សៀវភៅ	Hjelp:Bøker
ចំណាត់ថ្នាក់ក្រុម:ខេត្តក្រុងខ្មែរ	Kategori:Kambodsjas provinser
ចំណាត់ថ្នាក់ក្រុម:User zh-min-nan	Kategori:Bruker zh-min-nan
ទំព័រគំរូ:Release date and age	Mal:Startdato og alder
ចំណាត់ថ្នាក់ក្រុម:ឧទ្ធម្ភាគចក្រ	Kategori:Helikoptre
ចំណាត់ថ្នាក់ក្រុម:វិទ្យាសាស្ត្រសង្គម	Kategori:Samfunnsvitenskap
ទំព័រគំរូ:User zh-0	Mal:Bruker zh-0
ចំណាត់ថ្នាក់ក្រុម:ឆ្នាំកំណើត ១៩៥១	Kategori:Fødsler i 1951
ទំព័រគំរូ:Advert	Mal:Reklame
ទំព័រគំរូ:Infobox government agency	Mal:Infoboks myndighet
ទំព័រគំរូ:User ru-2	Mal:Bruker ru-2
ចំណាត់ថ្នាក់ក្រុម:User ru	Kategori:Bruker ru
ចំណាត់ថ្នាក់ក្រុម:User ru-2	Kategori:Bruker ru-2
ចំណាត់ថ្នាក់ក្រុម:User ru-3	Kategori:Bruker ru-3
ចំណាត់ថ្នាក់ក្រុម:វត្តអារាមព្រះពុទ្ធសាសនា	Kategori:Buddhistiske templer
ចំណាត់ថ្នាក់ក្រុម:User sxu	Kategori:Bruker sxu
ចំណាត់ថ្នាក់ក្រុម:User sxu-1	Kategori:Bruker sxu-1
ចំណាត់ថ្នាក់ក្រុម:User th-1	Kategori:Bruker th-1
ចំណាត់ថ្នាក់ក្រុម:User th-N	Kategori:Bruker th-N
ចំណាត់ថ្នាក់ក្រុម:User tr	Kategori:Bruker tr
ចំណាត់ថ្នាក់ក្រុម:User tr-0	Kategori:Bruker tr-0
ចំណាត់ថ្នាក់ក្រុម:User tr-4	Kategori:Bruker tr-4
ចំណាត់ថ្នាក់ក្រុម:User tr-N	Kategori:Bruker tr-N
ចំណាត់ថ្នាក់ក្រុម:User vls	Kategori:Bruker vls
ចំណាត់ថ្នាក់ក្រុម:User vls-1	Kategori:Bruker vls-1
ទំព័រគំរូ:Nay	Mal:Ikke ok
ទំព័រគំរូ:ISOWEEKDAY	Mal:ISOWEEKDAY
ទំព័រគំរូ:Spaces	Mal:Mellomrom
ទំព័រគំរូ:ប្រអប់ភាសា	Mal:Språk
ទំព័រគំរូ:FishBase species alt	Mal:FishBase-art
ទំព័រគំរូ:Country flag IOC alias GBR	Mal:FlagIOCathlete/flagg/GBR
ទំព័រគំរូ:In-universe	Mal:I fiksjonen
ទំព័រគំរូ:Infobox Olympics Cambodia	Mal:Infoboks Kambodsja under OL
ទំព័រគំរូ:Str index	Mal:Str index
ទំព័រគំរូ:Alabama	Mal:Alabama
ទំព័រគំរូ:Angkorian sites	Mal:Angkor
ទំព័រគំរូ:Archive list long	Mal:Arkivliste lang
ទំព័រគំរូ:កាលពី	Mal:As of
ទំព័រគំរូ:Auxiliary template common notice	Mal:Auxiliary template common notice
ទំព័រគំរូ:Aye	Mal:Ok
ទំព័រគំរូ:BLP	Mal:Blp
ទំព័រគំរូ:Bar percent	Mal:Prosentstolpe
ទំព័រគំរូ:Str find	Mal:Str find
ទំព័រគំរូ:Fr icon	Mal:Fr icon
ទំព័រគំរូ:Twitter	Mal:Twitter
ទំព័រគំរូ:សារ ទំព័រគំរូ វិគីភីឌា	Mal:Maler
ទំព័រគំរូ:Convert/tsubo	Mal:Konverter/tsubo
ទំព័រគំរូ:Coord/dec2dms/dm	Mal:Koord/dec2dms/dm
ទំព័រគំរូ:Country flag IOC alias ZZX	Mal:FlagIOCathlete/flagg/ZZX
ទំព័រគំរូ:Football squad end	Mal:Fs end
ទំព័រគំរូ:IUCNlink	Mal:IUCNlink
ទំព័រគំរូ:Weather box/cold	Mal:Klimatabell/cold
ទំព័រគំរូ:Event	Mal:Event
ទំព័រគំរូ:ICD9	Mal:ICD9
ទំព័រគំរូ:Campaign	Mal:Kampanje2
ទំព័រគំរូ:Category handler/blacklist	Mal:Category handler/blacklist
ទំព័រគំរូ:Category handler/numbered	Mal:Category handler/numbered
ទំព័រគំរូ:Familytree/step2	Mal:Stamtre/step2
ទំព័រគំរូ:Toolbar	Mal:Toolbar
ទំព័រគំរូ:Yesno	Mal:Janei
ទំព័រគំរូ:Side box	Mal:Sideboks
ទំព័រគំរូ:Citation	Mal:Citation
ទំព័រគំរូ:Citation/core	Mal:Citation/core
ចំណាត់ថ្នាក់ក្រុម:ប្រទេសជាកោះ	Kategori:Øystater
ទំព័រគំរូ:User la-2	Mal:Bruker la-2
ទំព័រគំរូ:User ru-1	Mal:Bruker ru-1
ទំព័រគំរូ:User zh-1	Mal:Bruker zh-1
ទំព័រគំរូ:User zh-2	Mal:Bruker zh-2
ចំណាត់ថ្នាក់ក្រុម:គមនាគមន៍នៅប្រទេសជប៉ុន	Kategori:Transport i Japan
ចំណាត់ថ្នាក់ក្រុម:ប្រទេសហ្សំប៊ី	Kategori:Zambia
ទំព័រគំរូ:Multi-listen end	Mal:Multi-listen end
ចំណាត់ថ្នាក់ក្រុម:Disambiguation and redirection templates	Kategori:Maler for omdirigering og flertydighet
ចំណាត់ថ្នាក់ក្រុម:User ja-0	Kategori:Bruker ja-0
ចំណាត់ថ្នាក់ក្រុម:User nl	Kategori:Bruker nl
ទំព័រគំរូ:Unbulleted list	Mal:Unbulleted list
ចំណាត់ថ្នាក់ក្រុម:User zh-1	Kategori:Bruker zh-1
ចំណាត់ថ្នាក់ក្រុម:User zh-4	Kategori:Bruker zh-4
ចំណាត់ថ្នាក់ក្រុម:User zh-3	Kategori:Bruker zh-3
ចំណាត់ថ្នាក់ក្រុម:User zh-2	Kategori:Bruker zh-2
ចំណាត់ថ្នាក់ក្រុម:មេកានិច	Kategori:Mekanikk
ចំណាត់ថ្នាក់ក្រុម:រូបវិទូអាល្លឺម៉ង់	Kategori:Tyske fysikere
ចំណាត់ថ្នាក់ក្រុម:រូបវិទូអ៊ីតាលី	Kategori:Italienske fysikere
ចំណាត់ថ្នាក់ក្រុម:រូបវិទូបារាំង	Kategori:Franske fysikere
ទំព័រគំរូ:Tnavbar-header	Mal:Tnavbar-header
ចំណាត់ថ្នាក់ក្រុម:ព្រឹត្តិការណ៍កីឡាចំរុះ	Kategori:Multisportkonkurranser
ចំណាត់ថ្នាក់ក្រុម:គណិតវិទូអាល្លឺម៉ង់	Kategori:Tyske matematikere
ចំណាត់ថ្នាក់ក្រុម:ត្រីកោណមាត្រ	Kategori:Trigonometri
ចំណាត់ថ្នាក់ក្រុម:ទ្រឹស្តីបទគណិតវិទ្យា	Kategori:Teorem
ចំណាត់ថ្នាក់ក្រុម:អាកាសយានដ្ឋាន	Kategori:Flyplasser
ចំណាត់ថ្នាក់ក្រុម:រូបវិទូអាមេរិក	Kategori:Fysikere fra USA
ចំណាត់ថ្នាក់ក្រុម:រូបវិទូអង់គ្លេស	Kategori:Engelske fysikere
ចំណាត់ថ្នាក់ក្រុម:រង្វាន់ណូបែល	Kategori:Nobelprisen
ចំណាត់ថ្នាក់ក្រុម:ប្រទេសកម្ពុជា	Kategori:Kambodsja
ចំណាត់ថ្នាក់ក្រុម:អ្នកនយោបាយប៉ាគីស្ថាន	Kategori:Pakistanske politikere
ចំណាត់ថ្នាក់ក្រុម:អ្នកនយោបាយខ្មែរ	Kategori:Kambodsjanske politikere
ចំណាត់ថ្នាក់ក្រុម:អ្នករុករកជនជាតិបារាំង	Kategori:Franske oppdagere
ចំណាត់ថ្នាក់ក្រុម:ស្រីលង្កា	Kategori:Sri Lanka
ចំណាត់ថ្នាក់ក្រុម:ទំព័រគំរូក្នុងរូបវិទ្យា	Kategori:Fysikkmaler
វិគីភីឌា:ត្រូវការអំណះអំណាង	Hjelp:Trenger referanse
ចំណាត់ថ្នាក់ក្រុម:ពិជគណិតថ្នាក់ដំបូង	Kategori:Elementær algebra
ចំណាត់ថ្នាក់ក្រុម:អនុគមន៍	Kategori:Funksjoner
ចំណាត់ថ្នាក់ក្រុម:ភាសាជប៉ុន	Kategori:Japansk
ចំណាត់ថ្នាក់ក្រុម:សំភារៈ​សំណង់	Kategori:Bygningsmaterialer
ចំណាត់ថ្នាក់ក្រុម:សមីការ	Kategori:Ligninger
ពន្ធលើប្រាក់បៀវត្ស	Arbeidsgiveravgift
ចំណាត់ថ្នាក់ក្រុម:ស្ពាននៅប្រទេសជប៉ុន	Kategori:Broer i Japan
ចំណាត់ថ្នាក់ក្រុម:សិទ្ធិ	Kategori:Rettighet
ចំណាត់ថ្នាក់ក្រុម:User pfl-1	Kategori:Bruker pfl-1
ទំព័រគំរូ:Raise	Mal:Heve
ចំណាត់ថ្នាក់ក្រុម:វិភាគគណិតវិទ្យា	Kategori:Matematisk analyse
ចំណាត់ថ្នាក់ក្រុម:ឧទ្យានជាតិ	Kategori:Nasjonalparker
ចំណាត់ថ្នាក់ក្រុម:កោះស៊ូម៉ាត្រា	Kategori:Sumatra
ចំណាត់ថ្នាក់ក្រុម:មីក្រូសេដ្ឋកិច្ច	Kategori:Mikroøkonomi
ចំណាត់ថ្នាក់ក្រុម:អាស៊ីហ្គេម	Kategori:Asialekene
ចំណាត់ថ្នាក់ក្រុម:អេឡិចត្រូស្តាទិច	Kategori:Elektrostatikk
ចំណាត់ថ្នាក់ក្រុម:អាកាសចរណ៍	Kategori:Transport
ចំណាត់ថ្នាក់ក្រុម:ទ្រឹស្តីបទលេខ	Kategori:Tallteori
ទំព័រគំរូ:ប្រអប់ព័ត៌មាន ភាសា	Mal:Infoboks språk
ទំព័រគំរូ:អត្ថបទខ្លី អំពីកូរ៉េខាងត្បូង	Mal:Sør-Koreastubb
ទំព័រគំរូ:Statistics	Mal:Statistikk
ចំណាត់ថ្នាក់ក្រុម:ភាសាអ៊ីតាលី	Kategori:Italiensk
ចំណាត់ថ្នាក់ក្រុម:ភាសាអេស្ប៉ាញ	Kategori:Spansk
ចំណាត់ថ្នាក់ក្រុម:រថក្រោះ	Kategori:Stridsvogner
ខេត្តនៃកម្ពុជា	Kambodsjas provinser
ចំណាត់ថ្នាក់ក្រុម:កោះរបស់ឥណ្ឌូនេស៊ី	Kategori:Øyer i Indonesia
ទំព័រគំរូ:Update after	Mal:Best før
ទំព័រគំរូ:Cross	Mal:Kryss
ទំព័រគំរូ:Navbox hatnote templates	Mal:Hattnotismaler
ចំណាត់ថ្នាក់ក្រុម:ភ្នំពេញ	Kategori:Phnom Penh
ទំព័រគំរូ:រូបវិទ្យា	Mal:Fysikk
វិគីភីឌា:ឯកសារកម្មទំព័រគំរូ	Wikipedia:Maldokumentasjon
ទំព័រគំរូ:CompactTOC8	Mal:KompaktTOC
ទំព័រគំរូ:Template sandbox notice	Mal:Template sandbox notice
ទំព័រគំរូ:Ti	Mal:Ti
ទំព័រគំរូ:Sec link	Mal:Sikker lenke
ទំព័រគំរូ:Infobox broadcasting network	Mal:Infoboks radiostasjon
ចំណាត់ថ្នាក់ក្រុម:លោការីត	Kategori:Logaritmer
ទំព័រគំរូ:CURRENTMINUTE	Mal:CURRENTMINUTE
បញ្ជីរាយនាម ជ័យលាភីរង្វាន់ណូបែល ផ្នែកគីមីវិទ្យា	Liste over nobelprisvinnere i kjemi
ទំព័រគំរូ:ខេត្ត-រាជធានីកម្ពុជា	Mal:Kambodsjas provinser
ទំព័រគំរូ:Pad	Mal:Pad
ទំព័រគំរូ:If pagename	Mal:If pagename
ទំព័រគំរូ:Connected contributor	Mal:Wikipedianer
ទំព័រគំរូ:Convert/C-change	Mal:Konverter/C-endring
ទំព័រគំរូ:Convert/list of units	Mal:Konverter/liste over enheter
ទំព័រគំរូ:Convert/list of units/item2	Mal:Konverter/liste over enheter/item2
ទំព័រគំរូ:Convert/list of units/foot note	Mal:Konverter/Liste over navn/fotnote
ទំព័រគំរូ:Convert/list of units/facdisp	Mal:Konverter/liste over enheter/facdisp
ទំព័រគំរូ:Convert/list of units/itemnontable2	Mal:Konverter/liste over enheter/itemnontable2
ទំព័រគំរូ:Convert/list of units/length/SI	Mal:Konverter/liste over enheter/lengde/SI
ទំព័រគំរូ:Convert/list of units/length/metric	Mal:Konverter/liste over enheter/lengde/metrisk
ទំព័រគំរូ:Convert/list of units/rowNa	Mal:Konverter/liste over enheter/rowNa
ទំព័រគំរូ:Convert/list of units/row	Mal:Konverter/liste over enheter/row
ទំព័រគំរូ:Convert/list of units/rowbr	Mal:Konverter/liste over enheter/rowbr
ទំព័រគំរូ:Cookbook	Mal:Cookbook
ទំព័រគំរូ:Coord/prec dec	Mal:Koord/prec dec
ទំព័រគំរូ:Council of Europe	Mal:Europarådet
ទំព័រគំរូ:Str right	Mal:Str right
ចំណាត់ថ្នាក់ក្រុម:ភាសាអង់គ្លេស	Kategori:Engelsk
ទំព័រគំរូ:Time Persons of the Year 2001–2025	Mal:Årets person Time 2001–2025
ទំព័រគំរូ:Burmese script	Mal:Inneholder burmesisk
ទំព័រគំរូ:Infobox country Olympics	Mal:Infoboks OL-land
ទំព័រគំរូ:ជ័យលាភីរង្វាន់ណូបែល ផ្នែកគីមីវិទ្យា ឆ្នាំ ១៩០១-១៩២៥	Mal:Nobelprisvinnere i kjemi 1901–1925
ចំណាត់ថ្នាក់ក្រុម:Wikipedia documentation pages	Kategori:Wikipediadokumentasjonssider
ទំព័រគំរូ:UF-hcard-geo	Mal:UF-hcard-geo
ទំព័រគំរូ:Template shortcut	Mal:Malsnarvei
ទំព័រគំរូ:OMIM2	Mal:OMIM2
ទំព័រគំរូ:ISO 3166	Mal:ISO 3166
ទំព័រគំរូ:Country flag IOC alias CAM	Mal:FlagIOCathlete/flagg/CAM
ទំព័រគំរូ:CURRENTWEEKDATE	Mal:CURRENTWEEKDATE
ទំព័រគំរូ:CURRENTISOWEEKDAY	Mal:CURRENTISOWEEKDAY
ទំព័រគំរូ:CURRENTISODATE	Mal:CURRENTISODATE
ចំណាត់ថ្នាក់ក្រុម:ក្រុមហ៊ុនអាកាសចរណ៍	Kategori:Passasjerfly
ចំណាត់ថ្នាក់ក្រុម:ពិជគណិត	Kategori:Algebra
ចំណាត់ថ្នាក់ក្រុម:នព្វន្ធ	Kategori:Aritmetikk
ទំព័រគំរូ:Multicol	Mal:Kolonner
សិទ្ធិកុមារ	Barnerett
ចំណាត់ថ្នាក់ក្រុម:អេឡិចត្រូម៉ាញ៉េទិច	Kategori:Elektromagnetisme
ទំព័រគំរូ:Lang-sv	Mal:Lang-sv
ចំណាត់ថ្នាក់ក្រុម:បណ្ណាល័យ	Kategori:Biblioteker
ជំនួយ:មាតិកា/សេចក្តីផ្តើម	Hjelp:Komme i gang
ចំណាត់ថ្នាក់ក្រុម:User pfl	Kategori:Bruker pfl
ចំណាត់ថ្នាក់ក្រុម:ទំព័រគំរូTOC	Kategori:Maler for innholdsfortegnelse (TOC)
ទំព័រគំរូ:Image label begin	Mal:Image label begin
ចំណាត់ថ្នាក់ក្រុម:កងកម្លាំងអាកាស	Kategori:Flyvåpen
ចំណាត់ថ្នាក់ក្រុម:សាកលវិទ្យាល័យនៅប្រទេសជប៉ុន	Kategori:Universiteter i Japan
វិគីភីឌា:សារ ទំព័រគំរូ/បោសសំអាត	Wikipedia:Maler/Vedlikehold og opprydning
ទំព័រគំរូ:Resources for collaboration	Mal:Resources for collaboration
ទំព័រគំរូ:GUAM countries	Mal:GUAM
ចំណាត់ថ្នាក់ក្រុម:User es-0	Kategori:Bruker es-0
ចំណាត់ថ្នាក់ក្រុម:វប្បធម៌ខ្មែរ	Kategori:Kambodsjansk kultur
ចំណាត់ថ្នាក់ក្រុម:User en-1	Kategori:Bruker en-1
ចំណាត់ថ្នាក់ក្រុម:User de-1	Kategori:Bruker de-1
ចំណាត់ថ្នាក់ក្រុម:Wikipedia protected templates	Kategori:Wikipedia beskyttede maler
ទំព័រគំរូ:Nowrap begin	Mal:Nowrap begin
ទំព័រគំរូ:Marriage	Mal:Ekteskap
ទំព័រគំរូ:ែដលកំពុងរឺកចំេរីន	Mal:Arbeid pågår
ទំព័រគំរូ:Thank you	Mal:Takk
ទំព័រគំរូ:សង្គ្រាមត្រជាក់	Mal:Den kalde krigen
ទំព័រគំរូ:Organisation of Islamic Cooperation	Mal:OIC
ចំណាត់ថ្នាក់ក្រុម:កោះជ្វា	Kategori:Java
ទំព័រគំរូ:Frac	Mal:Brøk
ទំព័រគំរូ:Ntsh	Mal:Sorterbart tall skjult
ជំនួយ:របារឧបករណ៍កែប្រែ	Hjelp:Redigeringsverktøylinje
ទំព័រគំរូ:CURRENTISOWEEK	Mal:CURRENTISOWEEK
ទំព័រគំរូ:Evalp	Mal:Evalp
ទំព័រគំរូ:Start date	Mal:Startdato
វិគីភីឌា:Contributing to Wikipedia	Wikipedia:Bidra til Wikipedia
ទំព័រគំរូ:Bio-stub	Mal:Biografistubb
វិគីភីឌា:Owl	Mal:Ugglan
ទំព័រគំរូ:Redirect6	Mal:Omdirigering4
ទំព័រគំរូ:Isfdb name	Mal:Isfdb name
ទំព័រគំរូ:Tim	Mal:Tim
ទំព័រគំរូ:ISOYEAR	Mal:ISOYEAR
ទំព័រគំរូ:La Francophonie	Mal:La Francophonie
វិគីភីឌា:Hatnotes	Wikipedia:Maler/Hattnotis
ទំព័រគំរូ:Big	Mal:Larger
ទំព័រគំរូ:Infobox file format	Mal:Infoboks filformat
វិគីភីឌា:Version 1.0 Editorial Team	Wikipedia:Wikipedia 1.0
ទំព័រគំរូ:WEEKDATE2M	Mal:WEEKDATE2M
ទំព័រគំរូ:UN document	Mal:FN-dokument
ទំព័រគំរូ:ISOWEEK	Mal:ISOWEEK
ទំព័រគំរូ:WEEKDATE2D	Mal:WEEKDATE2D
ទំព័រគំរូ:The Sun	Mal:Solen
វិគីភីឌា:Tutorial/TabsHeader	Wikipedia:Veiledning/Faner
ទំព័រគំរូ:Efn	Mal:Efn
ទំព័រគំរូ:Location map/decdeg	Mal:Kartposisjon/decdeg
ចំណាត់ថ្នាក់ក្រុម:យន្តហោះប្រដេញ	Kategori:Jagerfly
ទំព័រគំរូ:Ombox/shortcut	Mal:Ombox/Shortcut
ទំព័រគំរូ:Weather box/colh	Mal:Klimatabell/colh
ទំព័រគំរូ:Weather box/colpastel	Mal:Klimatabell/colpastel
ទំព័រគំរូ:Convert/list of units/item	Mal:Konverter/liste over enheter/item
ទំព័រគំរូ:Convert/list of units/rowtop	Mal:Konverter/liste over enheter/rowtop
ទំព័រគំរូ:Convert/list of units/area/short list	Mal:Konverter/liste over enheter/areal/kortliste
ទំព័រគំរូ:Str len/core	Mal:Str len/core
ទំព័រគំរូ:Harvard citation/core	Mal:Harvard citation/core
ទំព័រគំរូ:Sun	Mal:Stjerneinfo/Solen
ទំព័រគំរូ:\	Mal:\
ទំព័រគំរូ:Multi-listen item	Mal:Multi-listen item
ទំព័រគំរូ:Hidden sort key	Mal:Skjulsorter
ទំព័រគំរូ:Infobox អាកាសធាតុ/line	Mal:Infoboks vær/linje
ទំព័រគំរូ:Weather box/colp	Mal:Infoboks vær/kolp
ទំព័រគំរូ:Weather box/colt	Mal:Infoboks vær/kolt
ទំព័រគំរូ:Refimprove section	Mal:Refforbedreavsnitt
ជំនួយ:ការប្តូរទីតាំងទំព័រ	Hjelp:Omdirigeringsside
ទំព័រគំរូ:Markup	Mal:Markup
ទំព័រគំរូ:Convert/list of units/itemnontable	Mal:Konverter/liste over enheter/itemnontable
ទំព័រគំរូ:Convert/list of units/length	Mal:Konverter/liste over enheter/lengde
ទំព័រគំរូ:Convert/list of units/length/impus	Mal:Konverter/liste over enheter/lengde/impus
ទំព័រគំរូ:Convert/list of units/length/maritime	Mal:Konverter/liste over enheter/lengde/maritime
ទំព័រគំរូ:Convert/list of units/length/other	Mal:Konverter/liste over enheter/lengde/andre
ទំព័រគំរូ:Convert/list of units/length/short list	Mal:Konverter/liste over enheter/lengde/kortliste
ទំព័រគំរូ:Convert/list of units/rowaltab	Mal:Konverter/liste over enheter/rowaltab
ទំព័រគំរូ:Convert/list of units/rowaltname	Mal:Konverter/liste over enheter/rowaltname
ទំព័រគំរូ:Convert/list of units/rowbrtop	Mal:Konverter/liste over enheter/rowbrtop
ទំព័រគំរូ:Convert/list of units/rowkelvinT	Mal:Konverter/liste over enheter/rowkelvinT
ទំព័រគំរូ:Convert/list of units/rowtopNa	Mal:Konverter/liste over enheter/rowtopNa
ទំព័រគំរូ:Convert/list of units/rowuninotetopwaltab	Mal:Konverter/liste over enheter/rowuninotetopwaltab
ទំព័រគំរូ:Convert/list of units/speed/short list	Mal:Konverter/liste over enheter/hastighet/kortliste
ទំព័រគំរូ:Convert/list of units/temperature/short list	Mal:Konverter/liste over enheter/temperatur/kortliste
ទំព័រគំរូ:Convert/list of units/triple	Mal:Konverter/liste over enheter/trippel
ទំព័រគំរូ:Convert/list of units/volume/short list	Mal:Konverter/liste over enheter/volum/kortliste
ទំព័រគំរូ:CURRENTCALENDAR	Mal:CURRENTCALENDAR
ទំព័រគំរូ:WEEKDATE2Y	Mal:WEEKDATE2Y
ទំព័រគំរូ:Style/IPA	Mal:Style/IPA
ទំព័រគំរូ:Style/yid	Mal:Style/yid
ទំព័រគំរូ:Page tabs	Mal:Tab
Module:Convert	Modul:Convert
ទំព័រគំរូ:Ambox/core	Mal:Amboks/core
ទំព័រគំរូ:ISOCALENDAR/1	Mal:Calendar/1
ទំព័រគំរូ:ISOWEEKDATE2D	Mal:ISOWEEKDATE2D
ទំព័រគំរូ:ISOWEEKDATE2M	Mal:ISOWEEKDATE2M
ទំព័រគំរូ:ISOWEEKDATE2YMD	Mal:ISOWEEKDATE2YMD
ទំព័រគំរូ:Policy shortcut	Mal:Retningslinjesnarvei
ទំព័រគំរូ:Tmbox/core	Mal:Tmbox/core
ទំព័រគំរូ:Scinote/e	Mal:Scinote/e
ទំព័រគំរូ:ទិន្នន័យប្រទេស កាមេរូន	Mal:Flagg/Kamerun
ព្យុះហៃយ៉ាន	Tyfonen Haiyan (Yolanda)
ពិសេស:បំលាស់ប្ដូរថ្មីៗ	Spesial:Siste endringer
Module:Citation/CS1	Modul:Citation/CS1
Module:HtmlBuilder	Modul:HtmlBuilder
Module:Coordinates	Modul:Coordinates
Module:Navbox	Modul:Navbox
