Afrika	Afrika
Ġappun	Japan
Norveġja	Norge
Ingilterra	England
Skozja	Skottland
Irlanda ta' Fuq	Nord-Irland
Repubblika tal-Irlanda	Irland
Ungerija	Ungarn
Spanja	Spania
Stati Uniti	USA
Belġju	Belgia
Lussemburgu	Luxembourg
Art	Jorden
Mewt	Død
Bniedem	Menneske
Tim Berners-Lee	Tim Berners-Lee
Finlandja	Finland
Żvezja	Sverige
Danimarka	Danmark
Polonja	Polen
Litwanja	Litauen
Italja	Italia
Żvizzera	Sveits
Awstrija	Østerrike
Greċja	Hellas
Turkija	Tyrkia
Portugall	Portugal
Ewropa	Europa
Asja	Asia
Wikipedija	Wikipedia
Pajjiżi l-Baxxi	Nederland
Berlin	Berlin
Kompjuter	Datamaskin
Barack Obama	Barack Obama
Urugwaj	Uruguay
Londra	London
Messiku	Mexico
Oċean Atlantiku	Atlanterhavet
Oċean Paċifiku	Stillehavet
Jannar	Januar
Frar	Februar
Marzu	Mars (måned)
Marte (pjaneta)	Mars (planet)
Kenja	Kenya
Etjopja	Etiopia
Gana	Ghana
April	April
Mejju	Mai
Ġunju	Juni
Lulju	Juli
Awwissu	August
Settembru	September
Ottubru	Oktober
Novembru	November
Diċembru	Desember
Iljun	Løve
Franza	Frankrike
Kelb	Tamhund
Renju Unit	Storbritannia
Qattus	Tamkatt
Ċina	Folkerepublikken Kina
Wikizzjunarju	Wiktionary
Brażil	Brasil
François Hollande	François Hollande
Russja	Russland
Wiki	Wiki
Fondazzjoni Wikimedia	Wikimedia Foundation
Jimmy Wales	Jimmy Wales
Ġermanja	Tyskland
Bjelorussja	Hviterussland
Il Canto degli italiani	Fratelli d'Italia
Iżlanda	Island
Estonja	Estland
Saturnu (pjaneta)	Saturn
Latvja	Latvia
Ukraina	Ukraina
Ċekja	Tsjekkia
Slovakkja	Slovakia
Slovenja	Slovenia
Vilnius	Vilnius
Moldova	Moldova
Rumanija	Romania
Bulgarija	Bulgaria
Ruma	Roma
Repubblika tal-Maċedonja	Republikken Makedonia
Albanija	Albania
Kroazja	Kroatia
Bożnija u Ħerżegovina	Bosnia-Hercegovina
Ażerbajġan	Aserbajdsjan
Andorra	Andorra
Ċipru	Republikken Kypros
Ġeorġja	Georgia
Każakistan	Kasakhstan
Malta	Malta
Monako	Monaco
Montenegro	Montenegro
Belt tal-Vatikan	Vatikanstaten
San Marino	San Marino
Kuba	Cuba
Beliże	Belize
Torri Eiffel	Eiffeltårnet
Barbados	Barbados
Volkswagen	Volkswagen
Indoneżja	Indonesia
Wolfgang Amadeus Mozart	Wolfgang Amadeus Mozart
Ludwig van Beethoven	Ludwig van Beethoven
Afrika t'Isfel	Sør-Afrika
Alġerija	Algerie
Wikisors	Wikikilden
Varsavja	Warszawa
Festival tal-Eurovision	Eurovision Song Contest
Injam	Treverk
Pornografija	Pornografi
Ċili	Chile
Ġesù	Jesus Kristus
Galileo Galilei	Galileo Galilei
Merkurju (pjaneta)	Merkur
Storja	Historie
Venere (pjaneta)	Venus
Imħabba	Kjærlighet
Ġove (pjaneta)	Jupiter
Triq ta' Sant'Anna	Melkeveien
Uranu (pjaneta)	Uranus
Nettunu (pjaneta)	Neptun (planet)
Astronomija	Astronomi
Singapor	Singapore
Xjenza	Vitenskap
Liechtenstein	Liechtenstein
Sport	Sport
Adolf Hitler	Adolf Hitler
Facebook	Facebook
L-Ewwel Gwerra Dinjija	Første verdenskrig
It-Tieni Gwerra Dinjija	Andre verdenskrig
Wikotba	Wikibøker
Wikikwota	Wikiquote
Wikiversità	Wikiversity
Skopje	Skopje
Szczecin	Szczecin
Matematika	Matematikk
Lingwa Latina	Latin
Baħrejn	Bahrain
Armenja	Armenia
Serbja	Serbia
Qamar	Månen
Awstralja	Australia
Arġentina	Argentina
Perù	Peru
Bijoloġija	Biologi
Kambodja	Kambodsja
Faxxa ta' Kuiper	Kuiperbeltet
Koran	Koranen
Dinosawru	Dinosaurer
Iżlam	Islam
Ljubljana	Ljubljana
Unjoni Ewropea	Den europeiske union
Plovdiv	Plovdiv
Mara	Kvinne
Poeżija	Poesi
Lumija	Sitron
Émile Zola	Émile Zola
Napuljun I ta' Franza	Napoléon Bonaparte
Vesuvju	Vesuv
Xemx	Solen
Sena dawl	Lysår
Oċeanja	Oseania
Sistema Solari	Solsystemet
Idroġenu	Hydrogen
Wikimedia Commons	Wikimedia Commons
Lejl	Natt
Oslo	Oslo
Katowice	Katowice
Toqba sewda	Sort hull
Lionel Messi	Lionel Messi
Karbonju	Karbon
Ażotu	Nitrogen
Ossiġenu	Oksygen
Inter Milan	Inter
Pjaneta	Planet
Kleopatra VII	Kleopatra VII av Egypt
Mużika	Musikk
Moska	Moskva
Lingwa Taljana	Italiensk
Ċad	Tsjad
New Zealand	New Zealand
Indja	India
Tuvalu	Tuvalu
Ħadid	Jern
Tonga	Tonga
Samoa	Samoa
Gżejjer Solomon	Salomonøyene
Vanwatu	Vanuatu
Molière	Molière
Papwa Gwinea l-Ġdida	Papua Ny-Guinea
William Shakespeare	William Shakespeare
Nawru	Nauru
Kiribati	Kiribati
Fiġi	Fiji
Veneżwela	Venezuela
Genghis Khan	Djengis Khan
Żiemel	Hest
Annimal	Dyr
Surinam	Surinam
Paragwaj	Paraguay
Gujana	Guyana
Arti	Kunst
Ekwador	Ecuador
Kolombja	Colombia
Buddiżmu	Buddhisme
Bolivja	Bolivia
Trinidad u Tobago	Trinidad og Tobago
Saint Vincent u l-Grenadini	Saint Vincent og Grenadinene
Santa Luċija	Saint Lucia
Leonardo da Vinci	Leonardo da Vinci
Saint Kitts u Nevis	Saint Kitts og Nevis
Ġamajka	Jamaica
Grenada	Grenada
Gwatemala	Guatemala
Baħamas	Bahamas
Antigwa u Barbuda	Antigua og Barbuda
Ħonduras	Honduras
Dominika	Dominica
Repubblika Dominikana	Den dominikanske republikk
Ħaiti	Haiti
El Salvador	El Salvador
Iran	Iran
Iraq	Irak
Kosta Rika	Costa Rica
Iżrael	Israel
Panama	Panama
Jemen	Jemen
Lingwa pollakka	Polsk
Ġordan	Jordan
Nikaragwa	Nicaragua
Libanu	Libanon
Maldive	Maldivene
Malażja	Malaysia
Burma	Myanmar
Pakistan	Pakistan
Qatar	Qatar
Arabja Sawdija	Saudi-Arabia
Sri Lanka	Sri Lanka
Josif Stalin	Josef Stalin
YouTube	YouTube
Aristotli	Aristoteles
Emirati Għarab Magħquda	De forente arabiske emirater
Vjetnam	Vietnam
Korea t'Isfel	Sør-Korea
Afganistan	Afghanistan
Bangladexx	Bangladesh
Mali	Mali
Angola	Angola
Butan	Bhutan
Brunej	Brunei
Tanżanija	Tanzania
Repubblika Ċentru-Afrikana	Den sentralafrikanske republikk
Isaac Newton	Isaac Newton
Isfar	Gul
Mekkanika kwantistika	Kvantemekanikk
Togo	Togo
Tuneżija	Tunisia
Żambja	Zambia
Żimbabwe	Zimbabwe
Sudan t'Isfel	Sør-Sudan
Benin	Benin
Botswana	Botswana
Wikiħbarijiet	Wikinytt
Burkina Faso	Burkina Faso
Burundi	Burundi
Komoros	Komorene
Repubblika tal-Kongo	Republikken Kongo
Repubblika Demokratika tal-Kongo	Den demokratiske republikken Kongo
Ġibuti	Djibouti
Bavarja	Bayern
Ginea Ekwatorjali	Ekvatorial-Guinea
Eritrea	Eritrea
Papa Ġwanni Pawlu II	Johannes Paul II
Gabon	Gabon
Mahatma Gandhi	Mahatma Gandhi
Gambja	Gambia
Ginea	Guinea
Ginea Bissaw	Guinea-Bissau
Kosta tal-Avorju	Elfenbenskysten
Kamerun	Kamerun
Kap Verde	Kapp Verde
Lesoto	Lesotho
Liberja	Liberia
Libja	Libya
Madagaskar	Madagaskar
Malawi	Malawi
Mawritanja	Mauritania
Mawrizju	Mauritius
Marokk	Marokko
Możambik	Mosambik
Namibja	Namibia
Niġer	Niger
Niġerja	Nigeria
Charles Darwin	Charles Darwin
Uganda	Uganda
Rwanda	Rwanda
São Tomé u Príncipe	São Tomé og Príncipe
Senegal	Senegal
Seychelles	Seychellene
Sierra Leone	Sierra Leone
Somalja	Somalia
Sudan	Sudan
Sważiland	Swaziland
Amburgu	Hamburg
Evoluzzjoni	Evolusjon
Ġnus Magħquda	De forente nasjoner
Dante Alighieri	Dante Alighieri
Ġeografija	Geografi
Qalb	Hjerte
Praga	Praha
Ikħal	Blå
Limburgu (Belġju)	Limburg (Belgia)
Fjandri tal-Punent	Vest-Flandern
Fjandri tal-Lvant	Øst-Flandern
Antwerp (provinċja)	Antwerpen (provins)
Brabant Fjamming	Flamsk Brabant
Merkurju (mitoloġija)	Merkur (gud)
Hector Berlioz	Hector Berlioz
Giorgio Napolitano	Giorgio Napolitano
Francesco Cossiga	Francesco Cossiga
Oċean Indjan	Indiahavet
Kosovo	Kosovo
Frédéric Chopin	Frédéric Chopin
Kategorija:Prinċipali	Kategori:Kategorier
Dortmund	Dortmund
The Beatles	The Beatles
Osama Bin Laden	Osama bin Laden
Lingwa Spanjola	Spansk
Montevideo	Montevideo
Johann Sebastian Bach	Johann Sebastian Bach
Brimba	Edderkopper
Virġilju	Vergil
Uetersen	Uetersen
Karozza	Bil
Żagreb	Zagreb
Sqallija	Sicilia
Maurits Cornelis Escher	Maurits Cornelis Escher
Buenos Aires	Buenos Aires
Belt tal-Messiku	Mexico by
Tokjo	Tokyo
Barċellona	Barcelona
Ateni	Athen
AC Milan	AC Milan
Ħavana	Havanna
Édith Piaf	Édith Piaf
Kopenħagen	København
Stokkolma	Stockholm
Ħelsinki	Helsingfors
Dublin	Dublin
Rejkjavik	Reykjavík
Tallinn	Tallinn
Riga	Riga
Bratislava	Bratislava
Gdańsk	Gdańsk
Lussemburgu (belt)	Luxembourg (by)
Bibbja	Bibelen
Ho Chi Minh (belt)	Ho Chi Minh-byen
Dong Hoi	Dong Hoi
Concepción (Ċili)	Concepción
Atalanta BC	Atalanta BC
Bolonja	Bologna
Bologna FC 1909	Bologna FC 1909
Cagliari	Cagliari
Kiev	Kiev
Cagliari Calcio	Cagliari Calcio
Karim Benzema	Karim Benzema
Patrice Evra	Patrice Evra
Końskowola	Końskowola
2014	2014
2015	2015
2007	2007
ACF Fiorentina	ACF Fiorentina
Serp	Slanger
1 ta' Jannar	1. januar
2 ta' Jannar	2. januar
Rivoluzzjoni Industrijali	Den industrielle revolusjon
Imperu Ruman	Det romerske keiserriket
Minsk	Minsk
Microsoft	Microsoft
8 ta' Diċembru	8. desember
Kurów	Kurów
Kimika	Kjemi
19 ta' Marzu	19. mars
Papa Benedittu XVI	Benedikt XVI
Papa Piju XII	Pius XII
Watford FC	Watford FC
Futbol	Fotball
L-Olokawst	Holocaust
Madrid	Madrid
Michael Jackson	Michael Jackson
5 ta' Settembru	5. september
4 ta' Settembru	4. september
Santiago (Ċili)	Santiago de Chile
25 ta' Ottubru	15. oktober
5 ta' Novembru	5. november
22 ta' Novembru	22. november
Aħdar	Grønn
Aħmar	Rød
Lourdes	Lourdes
Rabat (Marokk)	Rabat
Kometa	Komet
Belgrad	Beograd
Kategorija:Mudelli	Kategori:Maler
George Sand	George Sand
Nikosija	Nikosia
Asterojde	Asteroide
Manama	Manama
Eklissi solari	Solformørkelse
Wikipedija:Paġna tal-provi	Wikipedia:Sandkasse
Nettunu (mitoloġija)	Neptun (gud)
Alġebra	Algebra
Ajruport Dong Hoi	Dong Hoi lufthavn
Miley Cyrus	Miley Cyrus
Curitiba	Curitiba
Pangea	Pangea
Kategorija:1888	Kategori:1888
Konfuċju	Konfucius
Corbin Bleu	Corbin Bleu
Kategorija:Matematika	Kategori:Matematikk
Gżejjer Faroe	Færøyene
Ġove (mitoloġija)	Jupiter (gud)
Sherlock Holmes	Sherlock Holmes
Rinaxximent	Renessansen
Kategorija:Twieldu fl-1888	Kategori:Fødsler i 1888
Ewro	Euro
Baħar Mediterran	Middelhavet
Kristjaneżmu	Kristendom
Mudell:Favur	Mal:For
Għasfur	Fugler
Belt kapitali	Hovedstad
Monzón	Monzón
Mustafa Kemal Atatürk	Mustafa Kemal Atatürk
Mudell:Portal	Mal:Portal
Huang Xianfan	Huang Xian-fan
Bill Gates	Bill Gates
Struttura .NET	.NET
Enċiklopedija	Encyklopedi
Il-Paġna prinċipali	Portal:Forside
Baskitbol	Basketball
Francisco Goya	Francisco Goya
Albrecht Dürer	Albrecht Dürer
Frida Kahlo	Frida Kahlo
Mikelanġlu	Michelangelo
Miguel de Cervantes	Miguel de Cervantes
Charles Dickens	Charles Dickens
Mekka	Mekka
Che Guevara	Che Guevara
Mao Zedong	Mao Zedong
Johann Wolfgang von Goethe	Johann Wolfgang von Goethe
Filosofija	Filosofi
Jimi Hendrix	Jimi Hendrix
Kategorija:Proposti għat-tħassir minnufih	Kategori:Sider som er foreslått raskt slettet
Hebe Camargo	Hebe Camargo
Komuniżmu	Kommunisme
Saħara tal-Punent	Vest-Sahara
Kartaġni	Karthago
Kategorija:Astronomija	Kategori:Astronomi
UTC−3:30	UTC-03.30
Søren Kierkegaard	Søren Kierkegaard
Bolzano	Bolzano
Rivoluzzjoni Franċiża	Den franske revolusjon
Saħara	Sahara
Strażburgu	Strasbourg
Lingwa Kroata	Kroatisk
UTC+1	UTC+01.00
Omeru	Homer
UTC+2	UTC+02.00
UTC+3	UTC+03.00
Lena Meyer-Landrut	Lena Meyer-Landrut
Seklu XVII	17. århundre
Ateiżmu	Ateisme
Ekoloġija	Økologi
FC Barcelona	FC Barcelona
Marie Curie	Marie Curie
Premju Nobel	Nobelprisen
Alan Turing	Alan Turing
Ideoloġija	Ideologi
Ada Lovelace	Ada Byron Lovelace
Franz Schubert	Franz Schubert
Igor' Stravinskij	Igor Stravinskij
Pëtr Il'ič Čajkovskij	Pjotr Tsjajkovskij
Giuseppe Verdi	Giuseppe Verdi
Kristofru Kolombu	Christofer Columbus
Nagħġa	Tamsau
Mammiferu	Pattedyr
Naħla	Bier
Speċi	Art
Tifel	Barn
Napuljun III	Napoleon III av Frankrike
Vladimir Putin	Vladimir Putin
Analisi matematika	Matematisk analyse
Commonwealth tan-Nazzjonijiet	Samveldet av nasjoner
Organizzazzjoni Dinjija tas-Saħħa	Verdens helseorganisasjon
Demm	Blod
Pulmun	Lunge
Casablanca	Casablanca
Xjenza Naturali	Naturvitenskap
Santu Wistin	Augustin av Hippo
Nelson Mandela	Nelson Mandela
Martin Luther King Jr.	Martin Luther King jr.
Ġeometrija	Geometri
Atmosfera	Atmosfære
Kategorija:Bulgarija	Kategori:Bulgaria
Kategorija:Franza	Kategori:Frankrike
Kategorija:Mużika	Kategori:Musikk
Elf Lejla u Lejla	Tusen og én natt
Kategorija:Letteratura	Kategori:Litteratur
Ilijade	Iliaden
Alessandru Manju	Aleksander den store
Edukazzjoni	Utdannelse
Hugo Chávez	Hugo Chávez
Raġel	Mann
Otto von Bismarck	Otto von Bismarck
Abort	Abort
Skjavitù	Slaveri
Logħob Olimpiku tas-sajf 2008	Sommer-OL 2008
US Sassuolo Calcio	US Sassuolo Calcio
Logħob Olimpiku tas-sajf 2016	Sommer-OL 2016
Gwerra Ċivili Amerikana	Den amerikanske borgerkrigen
Imperu Brittaniku	Det britiske imperiet
Real Madrid CF	Real Madrid CF
Sivilja	Sevilla
Rivoluzzjoni Russa	Den russiske revolusjon
Arkimede	Arkimedes
Thomas Edison	Thomas Edison
Ewklide	Euklid
Bit	Bit
Parlament Ewropew	Europaparlamentet
Kostellazzjoni	Stjernebilde
Karl Marx	Karl Marx
Voltaire	Voltaire
Ħinduiżmu	Hinduisme
Erwin Schrödinger	Erwin Schrödinger
Lingwa Maltija	Maltesisk
Reliġjon	Religion
René Descartes	René Descartes
Pawlu minn Tarsu	Apostelen Paulus
Immanuel Kant	Immanuel Kant
Guy de Maupassant	Guy de Maupassant
Friedrich Nietzsche	Friedrich Nietzsche
Fwied	Lever
Kilwa	Nyre
Psikoloġija	Psykologi
Gautama Buddha	Buddha
Premier League	Premier League
Muħammed	Muhammed
Probabbiltà	Sannsynlighet
Martin Luteru	Martin Luther
Xigħa	Sjiaislam
Knisja Kattolika	Den katolske kirke
Chelsea FC	Chelsea FC
Arsenal FC	Arsenal FC
Sistema diġestiva	Fordøyelsessystem
Logħob Olimpiku tax-xitwa 2010	Vinter-OL 2010
Reġina Eliżabetta II	Elisabeth II av Storbritannia
Alfabett	Alfabet
Ronald Reagan	Ronald Reagan
Francisco Varallo	Francisco Varallo
Festival tal-Eurovision 2005	Eurovision Song Contest 2005
Festival tal-Eurovision 2006	Eurovision Song Contest 2006
Festival tal-Eurovision 2007	Eurovision Song Contest 2007
Festival tal-Eurovision 2008	Eurovision Song Contest 2008
Festival tal-Eurovision 2009	Eurovision Song Contest 2009
Festival tal-Eurovision 2010	Eurovision Song Contest 2010
Festival tal-Eurovision 2011	Eurovision Song Contest 2011
Festival tal-Eurovision 2012	Eurovision Song Contest 2012
Festival tal-Eurovision 2013	Eurovision Song Contest 2013
Catherine Middleton	Catherine, hertuginne av Cambridge
David Beckham	David Beckham
Ryan Giggs	Ryan Giggs
Frankonja t'Isfel	Unterfranken
Tom Cleverley	Tom Cleverley
Ben Foster	Ben Foster (fotballspiller)
Ashley Young	Ashley Young
Kim Jong-il	Kim Jong-il
Kategorija:Veneżwela	Kategori:Venezuela
Belfast	Belfast
Tavla perjodika	Periodesystemet
Tórshavn	Tórshavn
Manuel Almunia	Manuel Almunia
Attakki tal-11 ta' Settembru	Terrorangrepet 11. september 2001
Chordata	Ryggstrengdyr
Kultura	Kultur
Trattat ta' Maastricht	Maastricht-traktaten
Mediċina	Medisin
Sarajevo	Sarajevo
Ekwazzjoni differenzjali	Differensialligning
Kategorija:Brażil	Kategori:Brasil
Kategorija:Rumanija	Kategori:Romania
Element kimiku	Grunnstoff
Funzjonijiet (matematika)	Funksjon (matematikk)
Kimika organika	Organisk kjemi
Mekkanika klassika	Klassisk mekanikk
Klassifikazzjoni bijoloġika	Biologisk klassifikasjon
Arti marzjali	Kampkunst
Rota	Sykkel
Relatività ristretta	Den spesielle relativitetsteorien
Ħġieġ	Glass (materiale)
Karta	Papir
Kilogramm	Kilogram
Cristiano Ronaldo	Cristiano Ronaldo
Metru	Meter
Pittura	Malerkunst
Skultura	Skulptur
Żfin	Dans
Pajjiżi tad-dinja	Liste over stater
Preistorja	Forhistorisk tid
Silvio Berlusconi	Silvio Berlusconi
Eric Saade	Eric Saade
4′33″	4'33"
Kolera	Kolera
Skerma	Fekting
Sfera ċelesti	Himmelhvelving
Malarja	Malaria
AIDS	Aids
Tuberkulożi	Tuberkulose
Inna	Inna (artist)
Mona Lisa	Mona Lisa
Teorija tan-numri	Tallteori
Biżantini	Østromerriket
Kruċjata	Korstog
Imperu Ottoman	Det osmanske rike
Stephan El Shaarawy	Stephan El Shaarawy
Tuta tal-għollieq	Bjørnebær
Kurgan (belt)	Kurgan (by)
Trapani	Trapani
Wikispeċi	Wikispecies
Lingwa Għarbija	Arabisk
Jum ir-Ringrazzjament	Thanksgiving
Lingwa Oċċitanija	Oksitansk
Lingwa tas-Sinjali Amerikana	Amerikansk tegnspråk
Kategorija:Provinċji tal-Italja	Italias provinser
Alkoħoliżmu	Alkoholisme
FC Bayern Munich	FC Bayern München
Serie A	Serie A
Queen	Queen
Provinċja ta' Agrigento	Provinsen Agrigento
Provinċja ta' Bergamo	Provinsen Bergamo
Provinċja ta' Kaltanissetta	Provinsen Caltanissetta
Provinċja ta' Lodi	Provinsen Lodi
Wikipedija:Vetrina	Wikipedia:Utmerkede artikler
Wikipedija:Pjazza	Wikipedia:Tinget
Takson	Gruppe (biologi)
Papa Pawlu VI	Paul VI
Etna	Etna
Clube de Regatas do Flamengo	Clube de Regatas do Flamengo
Gerard Piqué	Gerard Piqué
San Lawrenz	Laurentius av Roma
Martin Schulz	Martin Schulz
KAA Gent	AA Gent
Mudell Standard	Standardmodellen
Teorija ta' kollox	Teorien om alt
Tamworth FC	Tamworth FC
Mafja	Mafia
Manchester United FC	Manchester United FC
Aston Villa FC	Aston Villa FC
West Ham United FC	West Ham United FC
UEFA Champions League	UEFA Champions League
UEFA Europa League	UEFA Europa League
Tazza tad-Dinja tal-Futbol	Verdensmesterskapet i fotball
Blackburn Rovers FC	Blackburn Rovers FC
Wolverhampton Wanderers FC	Wolverhampton Wanderers FC
Rafael Correa	Rafael Correa
R. Charleroi SC	R. Charleroi SC
FC Twente	FC Twente
Motorhead	Motörhead
Milied	Jul
Lingwi Romaniċi	Romanske språk
Steve Jobs	Steve Jobs
Lady Gaga	Lady Gaga
Indoewropew	Indoeuropeiske språk
Muammar al-Gaddafi	Muammar al-Gaddafi
Francesco Totti	Francesco Totti
Chișinău	Chișinău
Soċjoloġija	Sosiologi
Şalom	Şalom
Didelphidae	Pungrotter
Trojja	Troja
The Pirate Bay	The Pirate Bay
Kampjonati Ewropej tal-Futbol 2012	EM i fotball 2012
Audi	Audi
Abkażja	Abkhasia
Antropoloġija	Antropologi
Baħar l-Aħmar	Rødehavet
Octave Mirbeau	Octave Mirbeau
Abjad	Hvit
Iswed	Svart
Lordi	Lordi
Lingwa uffiċjali	Offisielt språk
Provinċja ta' Quảng Bình	Quang Binh (provins)
Entrena	Entrena
Mérida (Veneżwela)	Mérida (Venezuela)
Benito Mussolini	Benito Mussolini
LOST (Serje televiżiva)	Lost
Ġebla tal-ġir	Kalkstein
Valletta	Valletta
Papa Ġwanni XXIII	Johannes XXIII
Benetice (Světlá nad Sázavou)	Benetice (Světlá nad Sázavou)
Prixtina	Priština
Curaçao	Curaçao
Coccinellidae	Marihøner
Metatheria	Pungdyr
Pangolin	Skjelldyr
Lagomorpha	Haredyr
Baqra tal-baħar	Sjøkyr
Eutheria	Placentale pattedyr
Fenek Ewropew	Kanin
Imperu Kushan	Kushriket
Qlugħ	Seil
Klaas-Jan Huntelaar	Klaas-Jan Huntelaar
Proboscidea	Snabeldyr
Università Niccolò Cusano	Università degli Studi Niccolò Cusano
Fażijiet lunari	Månefase
Fariżej	Fariseere
M'Baye Niang	M'Baye Niang
Liebru Ewropew	Sørhare
Lepisma saccharina	Sølvkre
Laurasiatheria	Laurasiatheria
Afrotheria	Afrotheria
Ewropa t'Isfel	Syd-Europa
Ewropa Ċentrali	Sentral-Europa
Kristadelfjani	Kristadelfianere
Tim nazzjonali tal-futbol tal-Eġittu	Egypts herrelandslag i fotball
Maja	Mayakulturen
Chow Chow	Chow-chow
FC Kuban Krasnodar	FK Kuban Krasnodar
Derivata	Derivasjon
Kwalifikazzjoni għall-Kampjonati Ewropej tal-Futbol 2008	Kvalifisering til EM i fotball 2008
Chris Smalling	Chris Smalling
Jonny Evans	Jonny Evans
Michael Carrick	Michael Carrick
Multilingwiżmu	Flerspråklighet
Lingwa Sileżjana	Schlesisk
Avril Lavigne	Avril Lavigne
Mikhail Gorbachev	Mikhail Gorbatsjov
Madre Tereża ta' Kalkutta	Moder Teresa
UEFA Champions League 2013–14	Mesterligaen 2013/2014
Rudolf Clausius	Rudolf Clausius
Auguste Rodin	Auguste Rodin
Blogg	Blogg
Oscar Wilde	Oscar Wilde
Krakovja	Kraków
Malala Yousafzai	Malala Yousafzai
Valery Leontiev	Valerij Leontjev
Lingwa tas-Sinjali Finlandiża	Finsk tegnspråk
Mużew	Museum
Du Fu	Du Fu
Popolazzjoni	Befolkning
Arċipelagu	Arkipel
Lingwa Sqallija	Siciliansk
Valparaíso	Valparaíso
Nju	Niue
Tim nazzjonali tal-futbol tal-Iskozja	Skottlands herrelandslag i fotball
Lingwa Leoniża	Leonesisk
Żews	Zevs
Lingwa tas-Sinjali	Tegnspråk
Astroloġija	Astrologi
Mošovce	Mošovce
Saint-Dié-des-Vosges	Saint-Dié-des-Vosges
Boris Yeltsin	Boris Jeltsin
Hirohito	Hirohito av Japan
Baħar Eġew	Egeerhavet
J.K. Rowling	J.K. Rowling
Hiroshima	Hiroshima
Mitoloġija Griega	Gresk mytologi
Ġeneru (tassonomija)	Slekt (biologi)
Xjenzi soċjali	Samfunnsvitenskap
Lista ta' kodiċi telefoniċi	Landsnumre for telefon
Lista ta' bliet kapitali	Liste over hovedsteder etter land
Noemi (kantanta)	Noemi
Sit elettroniku	Nettsted
Odissea	Odysseen
Lingwa Ido	Ido
Etimoloġija	Etymologi
Nikita Krushchev	Nikita Khrusjtsjov
Kia Motors	Kia
Familja (bijoloġija)	Familie (biologi)
UEFA	UEFA
Arthur Conan Doyle	Arthur Conan Doyle
Sport Club Corinthians Paulista	Sport Club Corinthians Paulista
Lingwa Kopta	Koptisk
Folklor	Folkeminne
Siligo	Siligo
Mark Zuckerberg	Mark Zuckerberg
Lingwa tas-Sinjali Newzealander	Nyzealandsk tegnspråk
Neolitiku	Neolittisk tid
Katerina II tar-Russja	Katarina II av Russland
Guglielmo Marconi	Guglielmo Marconi
Ordni (bijoloġija)	Orden (biologi)
Cork	Cork
Renju (bijoloġija)	Rike (biologi)
Novial	Novial
Aung San Suu Kyi	Aung San Suu Kyi
Kompożitur	Komponist
Influwenza tal-majjali	Svineinfluensa
Serbja u Montenegro	Serbia og Montenegro
Romantiċiżmu	Romantikken
It-Trinita' Mqaddsa	Den hellige treenighet
Faragħun	Farao
Mariupol	Mariupol
Tazza tad-Dinja tal-Futbol 2006	VM i fotball 2006
Klaus Ebner	Klaus Ebner
Klassi (bijoloġija)	Klasse (biologi)
Bălţi	Bălți
Auckland Grammar School	Auckland Grammar School
Bolla postali	Frimerke
Era (mitoloġija)	Hera
Premju Nobel għall-Fiżika	Nobelprisen i fysikk
Enya	Enya
Phylum	Rekke (biologi)
Enriku VIII tal-Ingilterra	Henrik VIII av England
São Paulo FC	São Paulo Futebol Clube
Kelb tal-Fenek	Faraohund
Baħar Tirren	Tyrrenhavet
Leeds	Leeds
Surrealiżmu	Surrealisme
Ħaż-Żabbar	Żabbar
Mosta	Mosta
Tas-Sliema	Sliema
Ħal Qormi	Qormi
Birkirkara	Birkirkara
Radio Studio 54 Network	Radio Studio 54 Network
Atti ta' l-Appostli	Apostlenes gjerninger
Żodjaku	Dyrekretsen
Paulínia	Paulínia
Il-100 ktieb tas-seklu skont Le Monde	Århundrets 100 bøker ifølge Le Monde
Fonoloġija	Fonologi
Kim Il-sung	Kim Il-sung
Jan Vermeer	Johannes Vermeer
Borussia Dortmund	Borussia Dortmund
Għenba tax-xewk	Stikkelsbær
Michel de Montaigne	Michel de Montaigne
Golf ta' Biskaja	Biscayabukten
Sorċid	Spissmus
Feniċi	Fønikia
Akille	Akilles
Gramma	Gram
.mt	.mt
Michelangelo Merisi da Caravaggio	Caravaggio
Tim nazzjonali tal-futbol ta' Spanja	Spanias herrelandslag i fotball
Martin Weinek	Martin Weinek
Björk	Björk
H. G. Wells	H.G. Wells
Tumas More	Thomas More
Fernando Torres	Fernando Torres
Lamantin	Manater
Baħar Liguri	Det liguriske hav
Dima Bilan	Dima Bilan
Lega Anżejatika	Hansaforbundet
Kubiżmu	Kubisme
Qawwiet tal-Assi tat-Tieni Gwerra Dinjija	Aksemaktene
Wikipedija:Mistoqsijiet rikorrenti	Wikipedia:OSS
Għar ta' Thien Duong	Thien Duong
Tim nazzjonali tal-futbol tal-Ġermanja	Tysklands herrelandslag i fotball
Gustave Flaubert	Gustave Flaubert
San Mattew	Evangelisten Matteus
Sant'Ambroġju	Ambrosius av Milano
Ġwanni Kriżostmu	Johannes Khrysostomos
Papa Piju X	Pius X
Papa Ljun XIII	Leo XIII
Rasputin	Grigorij Rasputin
San Girgor Nażjanżenu	Gregor av Nazianz
Egon Schiele	Egon Schiele
Hamit Altıntop	Hamit Altıntop
Maximilien Robespierre	Maximilien de Robespierre
Ġlormu	Hieronymus
San Bażilju	Basilios den store
Michel Foucault	Michel Foucault
Daniel Van Buyten	Daniel Van Buyten
Rabat (Malta)	Rabat (Malta)
Fgura	Fgura
John Henry Newman	John Henry Newman
Ħ'Attard	Attard
Morus (botanika)	Morbærslekten
Son Doong	Son Doong
Alex Ferguson	Alex Ferguson
Arkanġlu Mikiel	Erkeengelen Mikael
Titan	Titaner
Kardinal	Kardinal
Iżabella ta' Kastilja	Isabella I av Castilla
Liebru	Harer
Felix Mendelssohn	Felix Mendelssohn
Orikteropu	Jordsvin
Leonardo Araújo	Leonardo Nascimento de Araújo
Metodu xjentifiku	Vitenskapelig metode
Espoo	Esbo
Bijodiversità	Biologisk mangfold
Kannella (kulur)	Brun
Tizjanu	Tizian
Matteo Renzi	Matteo Renzi
Venere (mitoloġija)	Venus (gudinne)
Tazza tad-Dinja tal-Futbol 2002	VM i fotball 2002
Tim nazzjonali tal-futbol tal-Ingilterra	Englands herrelandslag i fotball
Tim nazzjonali tal-futbol ta' Franza	Frankrikes herrelandslag i fotball
Sid Vicious	Sid Vicious
Mario Monti	Mario Monti
Stojċiżmu	Stoisme
Martin Heidegger	Martin Heidegger
Tazza tad-Dinja tal-Futbol 1930	VM i fotball 1930
Università ta' New York	New York University
Giulio Andreotti	Giulio Andreotti
Park Ji-Sung	Park Ji-sung
Slaten Maġi	De tre vise menn
Pajjiżi Nordiċi	Norden
Kategorija:Mudelli tal-kimika	Kategori:Kjemimaler
Trattat ta' Liżbona	Lisboa-traktaten
Claudio Monteverdi	Claudio Monteverdi
Iraċ	Klippegrevlinger
Sami Khedira	Sami Khedira
Provinċja ta' Soria	Soria (provins)
Arkanġlu Rafel	Erkeengelen Rafael
George Abela	George Abela
Moħammed VI	Mohammed VI av Marokko
Jum l-Indipendenza	Nasjonaldag
Lawrence Gonzi	Lawrence Gonzi
Assedju ta' Malta (1565)	Den store beleiringen av Malta i 1565
CONMEBOL	CONMEBOL
Erbivoru	Planteetere
Herbert von Bismarck	Herbert von Bismarck
Schönhausen	Schönhausen
Oskar Schindler	Oskar Schindler
Enejide	Æneiden
Flamurtari Vlorë	KS Flamurtari Vlorë
Besa Kavajë	KS Besa Kavajë
KF Laçi	KF Laçi
Affiss	Affiks
Norberto Murara Neto	Norberto Murara Neto
L-Għanja tal-Milied	En julefortelling
Semitiku	Semitter
Marrara	Galleblære
Sottospeċi	Underart
Ħassan II	Hassan II av Marokko
It-Tielet Repubblika Franċiża	Den tredje franske republikk
Joyeux Noël	En dag uten krig
FK Kukësi	FK Kukësi
KF Skënderbeu Korçë	KF Skënderbeu Korçë
Carlos Bacca	Carlos Bacca
Bank Ċentrali ta' Malta	Maltas sentralbank
Alfred Wegener	Alfred Wegener
Edith Stein	Edith Stein
Friedrich Carl von Savigny	Carl von Savigny
Johanna von Puttkamer	Johanna von Puttkamer
Wilhelm von Humboldt	Wilhelm von Humboldt
Wikipedija:Vetrina/Senjalazzjonijiet	Wikipedia:Kandidatsider
Tazza tad-Dinja tal-Futbol 2014	VM i fotball 2014
Coronel Fabriciano	Coronel Fabriciano
L-Integral	Integral (matematikk)
Miroslav Klose	Miroslav Klose
Alla Pugacheva	Alla Pugatsjeva
Dante Bonfim Costa Santos	Dante Bonfim Costa Santos
Isco	Isco
Fes	Fès
Liebru taż-żarbuna tas-silġ	Snøskohare
Greenpeace	Greenpeace
KS Vllaznia Shkodër	KS Vllaznia Shkodër
Teuta Durrës	KS Teuta Durrës
Arkanġlu Gabrijel	Gabriel
Mata Hari	Mata Hari
Fußball-Bundesliga	Bundesligaen i fotball for menn
Pressjoni tad-demm	Blodtrykk
Enea	Aineias
Politiku	Politiker
David Villa	David Villa
Demenzja	Demens
Jürgen Klopp	Jürgen Klopp
Tazza tan-Nazzjonijiet Afrikani	Afrikamesterskapet i fotball
Romeo u Ġuljetta	Romeo og Julie
Konfederazzjoni Ażjatika tal-Futbol	Asian Football Confederation
Robin Williams	Robin Williams
Normanni	Normannere
Tim nazzjonali tal-futbol tal-Brażil	Brasils herrelandslag i fotball
Grupp (matematika)	Gruppe (matematikk)
Mesut Özil	Mesut Özil
Isabel Allende	Isabel Allende
Wes Brown	Wes Brown
It-Tempesta	Stormen
Jum l-Indipendenza (Stati Uniti)	Uavhengighetsdagen (USA)
Mudell:Ċita ktieb	Mal:Kilde bok
Divorzju	Skilsmisse
Chrzanów	Chrzanów
Medjugori	Međugorje
Suffiss	Suffiks
Artiklu (grammatika)	Artikkel (ordklasse)
Australopithecus	Australopithecus
Festival tal-Eurovision tat-Tfal	Junior Eurovision Song Contest
Kaspar Capparoni	Kaspar Capparoni
Ħolma ta’ Lejla Sajfija	En midtsommernattsdrøm
Berthe Morisot	Berthe Morisot
Manuel Neuer	Manuel Neuer
Penny Black	One Penny Black
Armistizju	Våpenhvile
KV Mechelen	KV Mechelen
Heiko Westermann	Heiko Westermann
Montenegro fil-Festival tal-Eurovision	Montenegro i Eurovision Song Contest
Papa Ċelestinu V	Celestin V
Luftëtari Gjirokastër	KS Luftëtari Gjirokastër
Amedeo Modigliani	Amedeo Modigliani
Appendiċite	Appendisitt
Hakan Yakın	Hakan Yakin
Ludovic Magnin	Ludovic Magnin
Diego Benaglio	Diego Benaglio
Daniel Bernoulli	Daniel Bernoulli
Jacob Bernoulli	Jakob Bernoulli
Stella Mwangi	Stella Mwangi
Dziecinów	Dziecinów
Pajjiż interkjuż	Liste over verdens innlandsstater
Marcel Bezençon	Marcel Bezençon
Gwerer Puniċi	Punerkrigene
Ġunone	Juno
Massimo Oddo	Massimo Oddo
Fraizer Campbell	Fraizer Campbell
Allianz Arena	Allianz Arena
San Ġużepp	Josef, Jesu fosterfar
Hidetoshi Nakata	Hidetoshi Nakata
L-Aħħar Ċena (Leonardo)	Nattverden (Leonardo)
Macroscelididae	Springspissmus
Dugongu	Dugong
Galway	Galway
Mario Balotelli	Mario Balotelli
Macbeth	Macbeth (skuespill)
Akropoli ta' Ateni	Akropolis (Athen)
Filatelija	Filateli
Stromboli	Stromboli
The Fame	The Fame
FK Austria Wien	FK Austria Wien
SK Rapid Wien	Rapid Wien
IMMAGINE&POESIA	IMMAGINE&POESIA
Venere ta' Willendorf	Venus fra Willendorf
Bandiera ta' Malta	Maltas flagg
Teorija tal-grafi	Grafteori
Lola Pagnani	Lola Pagnani
Bitcoin	Bitcoin
Tim nazzjonali tal-futbol tad-Danimarka	Danmarks herrelandslag i fotball
Black metal	Black metal
Sataniżmu	Satanisme
Grawnd Nazzjonali ta' Bejġing	Beijings nasjonalstadion
Stadio Giuseppe Meazza	San Siro
SC Wiener Neustadt	SC Wiener Neustadt
Plotinu	Plotin
Tim nazzjonali tal-futbol tal-Kroazja	Kroatias herrelandslag i fotball
Tim nazzjonali tal-futbol tal-Greċja	Hellas' herrelandslag i fotball
Eklissi	Formørkelse
Neymar	Neymar
Brendi	Brandy
Dominju (bijoloġija)	Domene (biologi)
Kassisa	Solbær
Daniel Schneidermann	Daniel Schneidermann
Dragan Đokanović	Dragan Đokanović
David de Gea	David de Gea
Westfalenstadion	Signal Iduna Park
Robert Lewandowski	Robert Lewandowski
Kunflitt Iżraeli-Palestinjan	Israel-Palestina-konflikten
Għajnuna:Kif timmodifika artiklu	Hjelp:Redigering
Lidl	Lidl
Jupp Heynckes	Jupp Heynckes
Plutone (mitoloġija)	Pluto (gud)
Eddie Fenech Adami	Edward Fenech Adami
Prim Ministru ta' Malta	Maltas statsminister
Riccardo Montolivo	Riccardo Montolivo
Cristian Zaccardo	Cristian Zaccardo
Gwerra totali	Total krig
Nickelodeon	Nickelodeon (TV-kanal)
Ugo Grozju	Hugo Grotius
René Adler	René Adler
Eruka	Ruccola
Ablativ	Ablativ
Tazza Ażjatika tal-Futbol	Asiamesterskapet i fotball
Boomerang TV	Boomerang (TV-kanal)
Internazzjonali Soċjalista	Sosialistinternasjonalen
Nannakola tas-seba' tikek	Sjuprikket marihøne
Santa Sede	Den hellige stol
Ettore	Hektor
WK	Kristi fødsel
Reġina ta' Saba	Dronningen av Saba
Alġebra astratta	Abstrakt algebra
CONCACAF	CONCACAF
Skanderbeg	Skanderbeg
Tim nazzjonali tal-futbol tal-Iżvezja	Sveriges herrelandslag i fotball
Raducz	Raducz
Paul Allen	Paul Allen
Eroj	Helt
Kuopio	Kuopio
Soccer City	Soccer City
Tim nazzjonali tal-futbol tal-Awstrija	Østerrikes herrelandslag i fotball
Tim nazzjonali tal-futbol tal-Irlanda	Irlands herrelandslag i fotball
Nemanja Vidić	Nemanja Vidić
Derry	Londonderry
Ġuvni	Bachelor
Drużiżmu	Drusere
Omnivoru	Alteter
George Best	George Best
Oliver Twist	Oliver Twist
Javier Hernández Balcázar	Javier Hernández Balcázar
Tim nazzjonali tal-futbol tal-Iżvizzera	Sveits' herrelandslag i fotball
Ekwazzjoni ta' Schrödinger	Schrödingerligningen
Priżma	Prisme (optikk)
Ballun tad-Deheb	Gullballen
Tim nazzjonali tal-futbol tal-Polonja	Polens herrelandslag i fotball
Foviżmu	Fauvisme
Tim nazzjonali tal-futbol tal-Belġju	Belgias herrelandslag i fotball
Dom Mintoff	Dom Mintoff
Sant'Antnin ta' Padova	Antonius av Padua
Eredivisie	Eredivisie
Guido de Marco	Guido de Marco
Konfederazzjoni Afrikana tal-Futbol	CAF
Tim nazzjonali tal-futbol tar-Rumanija	Romanias herrelandslag i fotball
Zeca Pagodinho	Zeca Pagodinho
Dimitar Berbatov	Dimitar Berbatov
Tim nazzjonali tal-futbol tal-Ukrajna	Ukrainas herrelandslag i fotball
Għawdex	Gozo
Tim nazzjonali tal-futbol tal-Ungerija	Ungarns herrelandslag i fotball
Natura mejta	Stilleben
Laura Pausini	Laura Pausini
Gwerra Anglo-Żanżibarjana	Den anglo-zanzibarske krigen
Children of Bodom	Children of Bodom
Festival tal-Eurovision 1956	Eurovision Song Contest 1956
Tazza tal-Konfederazzjonijiet	FIFA Confederations Cup
Tim nazzjonali tal-futbol tas-Slovenja	Slovenias herrelandslag i fotball
Darren Fletcher	Darren Fletcher
Gowler	Målvakt
Mary Cassatt	Mary Cassatt
Frankinċens	Virak
Cape Town Stadium	Cape Town Stadium
Xenarthra	Gomlere
Lista ta' kimiċi organiċi	Organisk forbindelse
Lira Maltija	Maltesisk lire
Antonio Valencia	Luis Antonio Valencia
Tim nazzjonali tal-futbol tas-Slovakkja	Slovakias herrelandslag i fotball
Tereża ta' Ávila	Teresa av Ávila
Guernica (pittura)	Guernica (maleri)
Tim nazzjonali tal-futbol ta' New Zealand	New Zealands herrelandslag i fotball
Kompjuter kwantistiku	Kvantedatamaskin
Tazza tad-Dinja tal-Futbol 2010	VM i fotball 2010
Kantant	Låtskriver
Andrea Palladio	Andrea Palladio
Heurelho Gomes	Heurelho da Silva Gomes
Moviment Brownjan	Brownsk bevegelse
Filosofija Presokratika	Førsokratikerne
Meknès	Meknes
Copa América	Copa América
Santa Katarina ta' Lixandra	Katarina av Alexandria
Lipari	De eoliske øyer
Liebru tal-muntanji	Hare
Konfederazzjoni Oċeanika tal-Futbol	Oceania Football Confederation
Kwalifikazzjoni għall-Kampjonati Ewropej tal-Futbol 2012	Kvalifisering til EM i fotball 2012
Tim nazzjonali tal-futbol tal-Andorra	Andorras herrelandslag i fotball
Tim nazzjonali tal-futbol tal-Ażerbajġan	Aserbajdsjans herrelandslag i fotball
Klassifika dinjija tal-FIFA	FIFAs verdensranking
Charlotte Perrelli	Charlotte Perrelli
Tim nazzjonali tal-futbol tal-Bulgarija	Bulgarias herrelandslag i fotball
Tim nazzjonali tal-futbol ta' Wales	Wales' herrelandslag i fotball
Atomium	Atomium
Tim nazzjonali tal-futbol tal-Bożnija u Ħerżegovina	Bosnia-Hercegovinas herrelandslag i fotball
Tereża ta' Lisieux	Teresa av Lisieux
Tabella tal-midalji tal-Logħob Olimpiku tas-sajf 2008	Medaljefordeling under Sommer-OL 2008
Ellis Park Stadium	Ellis Park Stadium
Tazza Interkontinentali (futbol)	Intercontinental Cup
Bing	Bing (søkemotor)
Plejer tas-Sena tal-FIFA	FIFA World Player of the Year
Santa Luċija (qaddisa)	Den hellige Lucia
Tim nazzjonali tal-futbol tal-Armenja	Armenias herrelandslag i fotball
San Bastjan	Sebastian (helgen)
Kolugo	Skjermflygere
Tim nazzjonali tal-futbol tal-Każakistan	Kasakhstans herrelandslag i fotball
Tazza tal-Konfederazzjonijiet 2009	FIFA Confederations Cup 2009
Pika	Pipeharer
Thomas Vermaelen	Thomas Vermaelen
UEFA Champions League 2009–10	Mesterligaen 2009/2010
Tim nazzjonali tal-futbol tal-Lussemburgu	Luxembourgs herrelandslag i fotball
Diġitigrad	Tågjenger
Gareth Bale	Gareth Bale
Inkwiżizzjoni Spanjola	Den spanske inkvisisjonen
Glen Johnson	Glen Johnson
Manuel Rivera-Ortiz	Manuel Rivera-Ortiz
Tim nazzjonali tal-futbol ta' San Marino	San Marinos herrelandslag i fotball
Immakulata Kunċizzjoni	Den ubesmittede unnfangelse
Nigel de Jong	Nigel de Jong
Tim nazzjonali tal-futbol tal-Bjelorussja	Hviterusslands herrelandslag i fotball
Tim nazzjonali tal-futbol tal-Albanija	Albanias herrelandslag i fotball
Tim nazzjonali tal-futbol tal-Ġeorġja	Georgias herrelandslag i fotball
Tim nazzjonali tal-futbol tal-Litwanja	Litauens herrelandslag i fotball
Karmelitani	Karmelittordenen
UEFA Champions League 2007–08	Mesterligaen 2007/2008
Tim nazzjonali tal-futbol tal-Finlandja	Finlands herrelandslag i fotball
Tim nazzjonali tal-futbol tal-Liechtenstein	Liechtensteins herrelandslag i fotball
Premier League 2008–09	Premier League 2008/09
Tim nazzjonali tal-futbol tal-Estonja	Estlands herrelandslag i fotball
Premier League 2010–11	Premier League 2010/11
Ħin supplementari	Overtid (sport)
Peter Mokaba Stadium	Peter Mokaba Stadium
Joe Hart	Joe Hart
Malena Ernman	Malena Ernman
Premier League 2007–08	Premier League 2007/08
RSC Anderlecht	RSC Anderlecht
Barriera	Pukkverk
Oroskopju	Horoskop
Eġizzjan demotiku	Demotisk
Fatt	Faktum
FK Partizan	FK Partizan
Tim nazzjonali tal-futbol ta' Malta	Maltas herrelandslag i fotball
Supereroj	Superhelt
UEFA Champions League 2008–09	Mesterligaen 2008/2009
Tim nazzjonali tal-futbol ta' Ċipru	Kypros' herrelandslag i fotball
Premier League 2009–10	Premier League 2009/10
Tim nazzjonali tal-futbol tal-Montenegro	Montenegros herrelandslag i fotball
Andrey Korotayev	Andrej Korotajev
UEFA Champions League 2010–11	Mesterligaen 2010/2011
Rafael Pereira da Silva (twieled fl-1990)	Rafael da Silva
FA Community Shield	FA Community Shield
Tim nazzjonali tal-futbol tal-Iżlanda	Islands herrelandslag i fotball
Tim nazzjonali tal-futbol tal-Unjoni Sovjetika	Sovjetunionens herrelandslag i fotball
Soċjaliżmu Demokratiku	Demokratisk sosialisme
Tim nazzjonali tal-futbol tal-Latvja	Latvias herrelandslag i fotball
CONCACAF Gold Cup	CONCACAF Gold Cup
Pont du Gard	Pont du Gard
Sligo	Sligo
Emblema ta' Malta	Maltas riksvåpen
Benvenuto Cellini	Benvenuto Cellini
Ordni Militari Sovran ta' Malta	Malteserordenen
Standard Liège	Standard Liège
Club Brugge KV	Club Brugge
Jóhanna Guðrún Jónsdóttir	Jóhanna Guðrún Jónsdóttir
Tim nazzjonali tal-futbol tal-Irlanda ta' Fuq	Nord-Irlands herrelandslag i fotball
Kemmuna	Comino
FC BATE Borisov	FK BATE Borisov
Lucrezia Borgia	Lucrezia Borgia
Klara ta' Assisi	Klara av Assisi
Tim nazzjonali tal-futbol tal-Iżrael	Israels herrelandslag i fotball
Gareth Barry	Gareth Barry
FK Ekranas	FK Ekranas
Mini ta' Cu Chi	Tunnelene i Cu Chi
L-Innu Malti	L-Innu Malti
Kwalifikazzjoni għat-Tazza tad-Dinja tal-Futbol 2010	Kvalifisering til VM i fotball 2010
Kate Ryan	Kate Ryan
Lys Assia	Lys Assia
Patri Piju	Pio av Pietrelcina
Martín Cáceres	Martín Cáceres
Royale Union Saint-Gilloise	Union Saint-Gilloise
Łobez	Łobez
Fertilizzazzjoni ''in vitro''	In vitro-fertilisering
Tim nazzjonali tal-futbol tal-Gżejjer Faroe	Færøyenes herrelandslag i fotball
Magnificat	Magnificat
Theofanis Gekas	Fanis Gekas
Ażerbajġan fil-Festival tal-Eurovision	Aserbajdsjan i Eurovision Song Contest
Papat ta' Avignon	Avignon-pavedømmet
G-14	G-14
Armenja fil-Festival tal-Eurovision	Armenia i Eurovision Song Contest
Albanija fil-Festival tal-Eurovision	Albania i Eurovision Song Contest
Rush	Rush
Dundalk	Dundalk
Kumitat tar-Reġjuni	Regionkomitéen (Den europeiske union)
Mandejżmu	Mandeanisme
'O sole mio	O sole mio
SK Sturm Graz	SK Sturm Graz
Il-Merkant ta’ Venezja	Kjøpmannen i Venedig
Hugo (film)	Hugo Cabret
Hapoel Tel Aviv FC	Hapoel Tel-Aviv
UEFA Europa League 2009–10	UEFA Europa League 2009/10
Phil Jones	Phil Jones (fotballspiller)
UEFA Europa League 2010–11	UEFA Europa League 2010/11
Olympe de Gouges	Olympe de Gouges
Giovanni Falcone	Giovanni Falcone
Mdina	Mdina
Vulcano	Vulcano
Tranquillo Barnetta	Tranquillo Barnetta
Liġi tan-numri kbar	Store talls lov
Andorra fil-Festival tal-Eurovision	Andorra i Eurovision Song Contest
Batterija	Battery
Kung fu	Kung fu
San Marino fil-Festival tal-Eurovision	San Marino i Eurovision Song Contest
Federico Macheda	Federico Macheda
Regola tal-gowls barra mid-dar	Bortemålsregelen
Las Meninas	Las Meninas
Ingólfr Arnarson	Ingolf Arnarsson
Elezzjonijiet Ewropej 2009	Europaparlamentvalget 2009
KF Tirana	KF Tirana
Superliga Albaniża	Kategoria Superiore
Kewkba ta' Betlehem	Betlehemsstjernen
FC Dinamo Minsk	FK Dinamo Minsk
Nick Drake	Nick Drake
Marokk fil-Festival tal-Eurovision	Marokko i Eurovision Song Contest
Zoran Tošić	Zoran Tošić
Golf	Golf (andre betydninger)
Kwalifikazzjoni għat-Tazza tad-Dinja tal-Futbol 2010 (UEFA)	Kvalifisering til VM i fotball 2010 (UEFA)
Palazz Belvedere	Belvedere
Bjelorussja fil-Festival tal-Eurovision	Hviterussland i Eurovision Song Contest
Artemisia Gentileschi	Artemisia Gentileschi
Gżejjer Aran	Aranøyene
André Villas-Boas	André Villas-Boas
Samir Handanovič	Samir Handanovič
Ignazio Abate	Ignazio Abate
Gelson Fernandes	Gelson Fernandes
Idriss Carlos Kameni	Idriss Carlos Kameni
Marlee Matlin	Marlee Matlin
Football League	The Football League
Fábio Pereira da Silva	Fábio da Silva
Antonio Nocerino	Antonio Nocerino
Mohamed Bouazizi	Mohamed Bouazizi
Anna Bergendahl	Anna Bergendahl
Denílson Pereira Neves	Denílson Pereira Neves
Emerson Ferreira da Rosa	Emerson (fotballspiller)
L-Ewwel Diviżjoni Belġjana	Belgisk toppdivisjon i fotball
KRC Genk	KRC Genk
Lied	Lied
Kalkulu tal-varjazzjonijiet	Variasjonsregning
Ġgantija	Ġgantija
UNCLOS Konvenzjoni tal-Ġnus Magħquda dwar id-Dritt tal-Baħar	Havrettskonvensjonen
Trama (narrattiva)	Handling
Neftchi Baku PFC	Neftchi Baku PFC
Bundesliga (Awstrija)	Østerriksk Bundesliga (fotball)
Tazza tal-Konfederazzjonijiet 2013	FIFA Confederations Cup 2013
Giuseppe Rossi	Giuseppe Rossi
Darron Gibson	Darron Gibson
Russja fil-Festival tal-Eurovision	Russland i Eurovision Song Contest
Enzo Scifo	Enzo Scifo
Air Malta	Air Malta
Kwalifikazzjoni għat-Tazza tad-Dinja tal-Futbol 2010 (CONCACAF)	Kvalifisering til VM i fotball 2010 (CONCACAF)
F91 Dudelange	F91 Dudelange
FC Santa Coloma	FC Santa Coloma
KSC Lokeren Oost-Vlaanderen	KSC Lokeren Oost-Vlaanderen
Tito Vilanova	Tito Vilanova
Kwalifikazzjoni għat-Tazza tad-Dinja tal-Futbol 2010 (OFC)	Kvalifisering til VM i fotball 2010 (OFC)
Tazza tad-Dinja tal-Futbol tal-Klabbs	VM i fotball for klubblag
No (teatru)	No (japansk teaterform)
AFC	AFC
CAF	CAF (andre betydninger)
Alessandro Nesta	Alessandro Nesta
Johann Bernoulli	Johann Bernoulli
Tribù (bijoloġija)	Tribus (biologi)
Santa Katerina ta' Siena	Katarina av Siena
Alexa Internet	Alexa Internet
Tupaja	Trespissmus
Żarbuna tad-Deheb	Gullstøvelen
Denis Law	Denis Law
Notoryctemorphia	Pungmuldvarper
Daniele Bonera	Daniele Bonera
Incertae sedis	Incertae sedis
Sofonisba Anguissola	Sofonisba Anguissola
Elena Gheorghe	Elena Gheorghe
Hadise	Hadise
Lavinia Fontana	Lavinia Fontana
Marie Myriam	Marie Myriam
Nicole Hohloch	Nicole Seibert
Amanda Michalka	Amanda Michalka
Alyson Michalka	Alyson Michalka
Olta Boka	Olta Boka
Magdalena Tul	Magdalena Tul
Premier League Armen	Hajastani Bardzraguwjn chowmb
Rosalba Carriera	Rosalba Carriera
Ġeorġja fil-Festival tal-Eurovision	Georgia i Eurovision Song Contest
Konvenzjoni ta' Vjenna dwar id-Dritt tat-Trattati	Wien-konvensjonen om traktatretten
Grupp D tal-Kampjonati Ewropej tal-Futbol 2008	EM i fotball 2008 Gruppe D
Muniti tal-ewro ta' Malta	Maltesiske euromynter
Kampjonati Ewropej tal-Futbol 2008	EM i fotball 2008
Myrmecobiidae	Numbat
Papessa Ġovanna	Pavinne Johanna
Ottorino Respighi	Ottorino Respighi
Storja ta' Malta	Maltas historie
Mikrostat	Mikrostat
Premier League Bjelorussu	Vysshaya Liga
Linfield FC	Linfield FC
Anders Lindegaard	Anders Lindegaard
Florentino Pérez	Florentino Pérez
Diżugwaljanza ta' Čebyšëv	Tsjebysjevs ulikhet
Halloween	Allehelgensaften
Kuruna tal-Avvent	Adventskrans
FIFA	FIFA
Primera Divisió	Primera Divisió
Liebru tal-altipjan tal-Etjopja	Etiopisk fjellhare
Imblokk Kontinentali	Fastlandssperringen
Lista ta' pajjiżi skont l-erja	Liste over verdens stater etter areal
Kampjonati Ewropej tal-Futbol	Europamesterskapet i fotball
FC Wacker Innsbruck (2002)	Fußballclub Wacker Innsbruck
Constant Vanden Stock Stadium	Constant Vanden Stock stadion
SV Mattersburg	SV Mattersburg
Jean Parisot de la Valette	Jean Parisot de la Valette
Wayne Rooney	Wayne Rooney
Tim nazzjonali tal-futbol tal-Awstralja	Australias herrelandslag i fotball
Nouvelle Fédération-Board	NF-Board
Bulgarija fil-Festival tal-Eurovision	Bulgaria i Eurovision Song Contest
Ukraina fil-Festival tal-Eurovision	Ukraina i Eurovision Song Contest
Bożnija u Ħerżegovina fil-Festival tal-Eurovision	Bosnia-Hercegovina i Eurovision Song Contest
Vande Mataram	Vande Mataram
Attakkant	Angriper (fotball)
Music from The Body	Music from The Body
Nihat Kahveci	Nihat Kahveci
Oscar Romero	Óscar Romero
Nickelodeon (Amerika)	Nickelodeon
Karl Shuker	Karl Shuker
Lisandro López	Lisandro López
Chris Eagles	Chris Eagles
Robertu Bellarmino	Roberto Bellarmino
Michael Mifsud	Michael Mifsud
John O'Shea	John O'Shea
Guillermo Stábile	Guillermo Stábile
Massimo Busacca	Massimo Busacca
Ritchie De Laet	Ritchie De Laet
Manucho Gonçalves	Manucho Gonçalves
Diego Cavalieri	Diego Cavalieri
Urby Emanuelson	Urby Emanuelson
Paolo Borsellino	Paolo Borsellino
Jô	Jô
Grupp A tat-Tazza tad-Dinja tal-Futbol 2006	Kampfakta gruppe A VM i fotball 2006
Adem Ljajić	Adem Ljajić
Sebastian Prödl	Sebastian Prödl
Julien Faubert	Julien Faubert
Danny Simpson	Danny Simpson
Ruġġieru I ta' Sqallija	Roger I av Sicilia
Michael Mancienne	Michael Mancienne
Dong Fangzhuo	Dong Fangzhuo
Carlos Eugênio Simon	Carlos Simon
Pascal Zuberbühler	Pascal Zuberbühler
Stanislav Šesták	Stanislav Šesták
Franco Di Santo	Franco Di Santo
Luis Monti	Luis Monti
Bachir Gemayel	Bashir Gemayel
Digão	Digão
Grupp A tal-Kampjonati Ewropej tal-Futbol 2008	EM i fotball 2008 Gruppe A
Federazzjoni tal-Futbol tal-Andorra	Federació Andorrana de Fútbol
Premier League Malti	BOV Premier League
Nicolas Douchez	Nicolas Douchez
La Liga	Primera División
Premier League Ażerbajġan	Azərbaycan Premyer Liqası
Grupp Ġ tat-Tazza tad-Dinja tal-Futbol 2006	Kampfakta gruppe G VM i fotball 2006
Grupp Ċ tat-Tazza tad-Dinja tal-Futbol 2006	Kampfakta gruppe C VM i fotball 2006
Grupp E tat-Tazza tad-Dinja tal-Futbol 2006	Kampfakta gruppe E VM i fotball 2006
Grupp F tat-Tazza tad-Dinja tal-Futbol 2006	Kampfakta gruppe F VM i fotball 2006
Grupp D tat-Tazza tad-Dinja tal-Futbol 2006	Kampfakta gruppe D VM i fotball 2006
Alleati tat-Tieni Gwerra Dinjija	De allierte (andre verdenskrig)
Repubblika Ċeka fil-Festival tal-Eurovision	Tsjekkia i Eurovision Song Contest
Valletta FC	Valletta FC
Serbja u Montenegro fil-Festival tal-Eurovision	Serbia og Montenegro i Eurovision Song Contest
Jerzy Grotowski	Jerzy Grotowski
Gustavo Gutiérrez	Gustavo Gutiérrez
Joe Sacco	Joe Sacco
Jores Okore	Jores Okore
Gary Neville	Gary Neville
Johnny Leoni	Johnny Leoni
San Staniżlaw Martri	Stanislaus av Kraków
Emiliano Insúa	Emiliano Insúa
Anthony Mamo	Anthony Mamo
Paul Van Himst	Paul Van Himst
Cercle Brugge KSV	Cercle Brugge KSV
Adolfo Zumelzú	Adolfo Zumelzú
Unuri għall-klabbs tal-UEFA	UEFA Champions League Most Valuable Player
Bloggosfera	Bloggosfære
Life of Pi	Historien om Pi
SV Zulte Waregem	SV Zulte Waregem
Semih Şentürk	Semih Şentürk
Helder Camara	Hélder Câmara
Martri tal-Korea	De koreanske martyrene
Mattia De Sciglio	Mattia De Sciglio
Krassimir Avramov	Krasimir Avramov
UEFA Europa League 2012–13	UEFA Europa League 2012/13
Marsaxlokk FC	Marsaxlokk FC
Servizz Awstrijak barra l-pajjiż	Den østerrikske utlandstjenesten
Jamāhīriyya	Jamahiriya
Assoċjazzjoni tal-Futbol Albaniż	Federata Shqiptare e Futbollit
Fredrik Stenman	Fredrik Stenman
Hilma af Klint	Hilma af Klint
Owen Hargreaves	Owen Hargreaves
Elvedin Džinić	Elvedin Džinič
Papa Franġisku	Frans (pave)
Roman Kienast	Roman Kienast
Lamantin Amazoniku	Amazonasmanat
SV Ried	SV Ried
Il-Ktieb ta' Mormon	Mormons bok
Youddiph	Youddiph
Eddie Gustafsson	Eddie Gustafsson
Eva Gonzalès	Eva Gonzalès
Slovakkja fil-Festival tal-Eurovision	Slovakia i Eurovision Song Contest
Mattia Preti	Mattia Preti
It-Twerżiqa	Skrik
Euarchontoglires	Euarchontoglires
Paramore	Paramore
Klabb tal-futbol	Fotballag
Grupp B tal-Kampjonati Ewropej tal-Futbol 2008	EM i fotball 2008 Gruppe B
Festival tal-Eurovision taż-Żgħar 2008	Junior Eurovision Song Contest 2008
Coritiba Foot Ball Club	Coritiba Foot Ball Club
Ajruport Internazzjonali ta' Tan Son Nhat	Tan Son Nhat internasjonale lufthavn
Nani	Nani
Edwin van der Sar	Edwin van der Sar
Paolo Maldini	Paolo Maldini
Loreen	Loreen
Gonzalo Higuaín	Gonzalo Higuaín
Tim nazzjonali tal-futbol tat-Turkija	Tyrkias herrelandslag i fotball
Tim nazzjonali tal-futbol tar-Repubblika Ċeka	Tsjekkias herrelandslag i fotball
Tomasz Kuszczak	Tomasz Kuszczak
Anderson Luís de Abreu Oliveira	Anderson
UEFA Champions League 2011–12	Mesterligaen 2011/2012
Charles Manson	Charles Manson
UEFA Champions League 2012–13	Mesterligaen 2012/2013
Arda Turan	Arda Turan
Oġġett (filosofija)	Objekt
RAEC Mons	RAEC Mons
Galatasaray SK	Galatasaray
Moldova fil-Festival tal-Eurovision	Moldova i Eurovision Song Contest
Latvja fil-Festival tal-Eurovision	Latvia i Eurovision Song Contest
Nichi Vendola	Nichi Vendola
Waasland-Beveren	Waasland-Beveren
Kwalifikazzjoni għat-Tazza tad-Dinja tal-Futbol 2010 (CONMEBOL)	Kvalifisering til VM i fotball 2010 (CONMEBOL)
KS Bylis Ballsh	KS Bylis Ballsh
Matías Suárez	Matías Suárez
Ronaldo	Ronaldo
Kwalifikazzjoni għall-Kampjonati Ewropej tal-Futbol 2012 - Grupp Ċ	Kvalifisering til EM i fotball 2012, gruppe C
Kaká	Kaká
Rivalità bejn Liverpool FC u Manchester United FC	Rivaliseringen mellom Liverpool FC og Manchester United FC
Rumanija fil-Festival tal-Eurovision	Romania i Eurovision Song Contest
Giuseppe Merisi	Giuseppe Merisi
Finali tal-UEFA Champions League 2013	Mesterliga-finalen 2012/2013
FC Mika	FC Mika
Urugan Felix (2007)	Orkanen Felix
Super Cup Ewropea 2013	UEFA Super Cup 2013
KV Kortrijk	KV Kortrijk
Wikipedija:Abbrevjazzjoni	Wikipedia:Snarvei
Croagh Patrick	Croagh Patrick
The Kite Runner	Drageløperen
TM-XML	TM-XML
Qerda tal-innoċenti	Barnemordet i Betlehem
Beerschot AC	KFC Germinal Beerschot
Glires	Glires
Cinco de Mayo	Cinco de Mayo
Litwanja fil-Festival tal-Eurovision	Litauen i Eurovision Song Contest
San Franġisk t'Assisi	Frans av Assisi
Tim nazzjonali tal-futbol tal-Italja	Italias herrelandslag i fotball
Insettivoru	Insekteter
Partit Laburista (Malta)	Arbeiderpartiet (Malta)
Wolfsberger AC	Wolfsberger AC
FC Admira Wacker Mödling	FC Admira Wacker Mödling
Bolla fiskali	Stempelmerke
Cartoon Network	Cartoon Network
De facto	De facto
Lista ta' pajjiżi skont il-popolazzjoni	Liste over verdens stater etter befolkningsstørrelse
Klad	Klade
Kunsilli lokali ta' Malta	Maltas kommuner
Kwalifikazzjoni għall-Kampjonati Ewropej tal-Futbol 2012 - Grupp B	Kvalifisering til EM i fotball 2012, gruppe B
Grupp Ċ tal-Kampjonati Ewropej tal-Futbol 2008	EM i fotball 2008 Gruppe C
Tim nazzjonali tal-futbol tal-Komunità tal-Istati Indipendenti	Samveldet av uavhengige staters herrelandslag i fotball
Kwalifikazzjoni għall-Kampjonati Ewropej tal-Futbol 2012 - Grupp A	Kvalifisering til EM i fotball 2012, gruppe A
Inter Baku PFC	Inter Baku
FK Qarabağ	FK Qarabağ Ağdam
Lierse SK	Lierse SK
Tim nazzjonali tal-futbol tar-Russja	Russlands herrelandslag i fotball
Assoċjazzjoni tal-Futbol ta' Malta	Malta Football Association
Kwalifikazzjoni għall-Kampjonati Ewropej tal-Futbol 2012 - Grupp Ħ	Kvalifisering til EM i fotball 2012, gruppe H
Cobh	Cobh
Ħal Tarxien	Tarxien
Fenek ta' denbu qotni	Bomullshalekaniner
JK Nõmme Kalju	JK Nõmme Kalju
Birgu	Birgu
Kwalifikazzjoni għall-Kampjonati Ewropej tal-Futbol 2012 - Grupp D	Kvalifisering til EM i fotball 2012, gruppe D
Finali tal-Kampjonati Ewropej tal-Futbol 2008	Finalen i EM i fotball 2008
Mellieħa	Mellieħa
Bormla	Cospicua
Varjetà (botanika)	Varietet (biologi)
Ħal Balzan	Balzan
President ta' Malta	Maltas president
Birkirkara FC	Birkirkara FC
Furjana	Floriana
Grupp B tat-Tazza tad-Dinja tal-Futbol 2006	Kampfakta gruppe B VM i fotball 2006
Lingwa Awżiljari Internazzjonali	Internasjonalt hjelpespråk
Lista ta' lingwi uffiċjali	Liste over offisielle språk
It-Tripletta	The Treble
Raħal Ġdid	Paola (Malta)
Transnistrija	Transnistria
Kwalifikazzjoni għat-Tazza tad-Dinja tal-Futbol 2010 (UEFA) - Grupp 3	Fotball-VM 2010 kvalik gruppe 3 UEFA
Għajnuna:Kontenut	Hjelp:Portal
Għajnuna:Gwida essenzjali	Wikipedia:Veiledning
Oud-Heverlee Leuven	Oud-Heverlee Leuven
Kwalifikazzjoni għat-Tazza tad-Dinja tal-Futbol 2010 (UEFA) - Grupp 9	Fotball-VM 2010 kvalik gruppe 9 UEFA
Francis Dickoh	Francis Dickoh
Joseph Muscat	Joseph Muscat
Malta fil-Festival tal-Eurovision taż-Żgħar	Malta i Junior Eurovision Song Contest
Stade Maurice Dufrasne	Stade Maurice Dufrasne
Michael Essien	Michael Essien
Ġorġ Borg Olivier	Giorgio Borg Olivier
FC Red Bull Salzburg	Red Bull Salzburg
Westport (Irlanda)	Westport (Irland)
Statistika tat-Tazza tad-Dinja tal-Futbol 2010	Statistikk om VM i fotball 2010
Laurent Ciman	Laurent Ciman
Luttu nazzjonali	Landesorg
Apolonia Fier	Apolonia Fier
Liverpool FC	Liverpool FC
Malcolm Macdonald	Malcolm Macdonald
Plantigrad	Sålegjenger
Merlin (serje televiżiva)	Merlin (TV-serie)
Tim nazzjonali tal-futbol ta' Malta (nisa)	Maltas kvinnelandslag i fotball
Wikipedija:Ambaxxata	Wikipedia:Ambassade
Kampjonat tal-futbol Ingliż 1888-89	Engelsk 1. divisjon 1888–89
Karmenu Vella	Karmenu Vella
Sliema Wanderers FC	Sliema Wanderers FC
KS Kastrioti	KS Kastrioti Krujë
FK Tomori Berat	FK Tomori Berat
Kim Ojo	Kim Ojo
Shkumbini Peqin	KS Shkumbini Peqin
Grawnd Nazzjonali Ta' Qali	Ta' Qali stadion
Candies (grupp)	Candies
Palazz tal-Gran Mastru	Stormesterens palass
Kategorija:Ġermanja	Kategori:Tyskland
Kategorija:Italja	Kategori:Italia
Kategorija:Stati Uniti	Kategori:USA
Kategorija:Russja	Kategori:Russland
Kategorija:Renju Unit	Kategori:Storbritannia
Kategorija:Spanja	Kategori:Spania
Kategorija:Indja	Kategori:India
Kategorija:Turkija	Kategori:Tyrkia
Kategorija:New Zealand	Kategori:New Zealand
Kategorija:Afganistan	Kategori:Afghanistan
Kategorija:Alġerija	Kategori:Algerie
Kategorija:Awstrija	Kategori:Østerrike
Kategorija:Pajjiżi l-Baxxi	Kategori:Nederland
Kategorija:Niġerja	Kategori:Nigeria
Kategorija:Polonja	Kategori:Polen
Kategorija:Portugall	Kategori:Portugal
Kategorija:Żvizzera	Kategori:Sveits
Kategorija:Ukraina	Kategori:Ukraina
Kategorija:Vjetnam	Kategori:Vietnam
Kategorija:Fiżika	Kategori:Fysikk
Kategorija:Bijoloġija	Kategori:Biologi
Kategorija:Kimika	Kategori:Kjemi
Kategorija:Storja	Kategori:Historie
Kategorija:Ġeografija	Kategori:Geografi
Kategorija:Arti viżiva	Kategori:Billedkunst
Kategorija:Reliġjon	Kategori:Religion
Kategorija:Sport	Kategori:Sport
Kategorija:Xjenza	Kategori:Vitenskap
Kategorija:Unjoni Ewropea	Kategori:Den europeiske union
Kategorija:Ċinema	Kategori:Film
Kategorija:Komunikazzjoni	Kategori:Kommunikasjon
Premier League 2011–12	Premier League 2011/12
Marco Ureña	Marco Ureña
Palazz ta' Sant'Anton	San Anton Palace
Stat kostrutt	Status constructus
Kategorija:Mietu fl-2012	Kategori:Dødsfall i 2012
Kevin Borg	Kevin Borg
Ġeografija ta' Malta	Maltas geografi
Ħin tal-Afrika tal-Lvant	Østafrikansk tid
Superspeċi	Superart
Wikijunior	Wikijunior
Nicklas Helenius	Nicklas Helenius
Louis Grech	Louis Grech
Jim Larsen	Jim Larsen
Juan Antonio Villacañas	Juan Antonio Villacañas
Kategorija:Ekoloġija	Kategori:Økologi
Kategorija:Diżambigwazzjoni	Kategori:Pekere
Kategorija:Olimpjadi	Kategori:Olympiske leker
Kategorija:Filosofija	Kategori:Filosofi
Kategorija:Psikoloġija	Kategori:Psykologi
Kategorija:Buddiżmu	Kategori:Buddhisme
Kategorija:Kristjaneżmu	Kategori:Kristendom
Kategorija:Induiżmu	Kategori:Hinduisme
Kategorija:Iżlam	Kategori:Islam
Kategorija:Ġudaiżmu	Kategori:Jødedom
Wallace Fernando Pereira	Wallace Fernando Pereira
Ronaldo (diżambigwazzjoni)	Ronaldo (andre betydninger)
Forti Sant’Anġlu	Fort St. Angelo
Michy Batshuayi	Michy Batshuayi
Storja ta' Arsenal FC (1966–preżent)	Arsenal FCs historie (fra 1966)
Harry Stafford	Harry Stafford
Bochotnica	Bochotnica
Stat Iżlamiku	Den islamske staten Irak og Levanten
Benedicta Boccoli	Benedicta Boccoli
Lingwa tas-Sinjali Daniża	Dansk tegnspråk
Storja ta' Arsenal FC (1886–1966)	Arsenal FCs historie (1886–1966)
Għoti tal-penalties	Straffesparkkonkurranse
Kategorija:Abbozzi	Kategori:Stubber
Kategorija:Pjaneti	Kategori:Planeter
Kategorija:Abbozzi tal-mużika	Kategori:Musikkstubber
Kategorija:Abbozzi tal-kultura	Kategori:Kulturstubber
Kategorija:Kultura	Kategori:Kultur
Kategorija:Snin	Kategori:Årstall
Kategorija:Xjenzi soċjali	Kategori:Humaniora
Kategorija:Kontinenti	Kategori:Kontinenter
12 Years a Slave	12 Years a Slave
Des Lyttle	Des Lyttle
Għajnuna:Gwida essenzjali/Editjar	Wikipedia:Veiledning/Redigering
Mudell:SistemaSolari	Mal:Solsystem
Wikipedija:Konvenzjonijiet ta' nomenklatura	Wikipedia:Navnekonvensjoner
GNU/Linux	GNU/Linux
Marcon Bezzina	Marcon Bezzina
Prorastomidae	Prorastomidae
Għajnuna:Kif tirreġistra	Hjelp:Logge inn
Għajnuna:Wikiketta	Wikipedia:Wikikette
Kategorija:Bots tal-Wikipedija	Kategori:Boter
Mudell:Kwota	Mal:Sitat
Kategorija:Nies Taljani	Kategori:Italienere
Kategorija:Mużiċisti Amerikani	Kategori:Musikere fra USA
Kategorija:Futbolers Ġermaniżi	Kategori:Tyske fotballspillere
Mudell:Tl	Mal:Mal
Mudell:Kaxxa tal-utent	Mal:Userbox
Sergio Mattarella	Sergio Mattarella
Kategorija:Pajjiżi	Kategori:Land
Wikipedija:Amministraturi	Wikipedia:Administratorer
Kategorija:Każakistan	Kategori:Kasakhstan
Kategorija:Kategoriji skont in-nazzjonalità	Kategori:Kategorier etter nasjonalitet
Wikipedija:Bot	Wikipedia:Roboter
Kategorija:Kategoriji moħbija	Kategori:Skjulte kategorier
Kategorija:Internet	Kategori:Internett
Kategorija:Botanika	Kategori:Botanikk
Kategorija:Politika	Kategori:Politikk
Kategorija:Arti	Kategori:Kunst
Eġittu	Egypt
Kategorija:2013	Kategori:2013
Mudell:Bot	Mal:Bot
Kanada	Canada
Kategorija:Ungerija	Kategori:Ungarn
Kategorija:Stati membri tal-Unjoni Ewropea	Kategori:Den europeiske unions medlemsland
Kategorija:Belġju	Kategori:Belgia
Kategorija:Ċekja	Kategori:Tsjekkia
Kategorija:Danimarka	Kategori:Danmark
Kategorija:Estonja	Kategori:Estland
Kategorija:Finlandja	Kategori:Finland
Kategorija:Latvja	Kategori:Latvia
Kategorija:Iżlanda	Kategori:Island
Kategorija:Litwanja	Kategori:Litauen
Kategorija:Malta	Kategori:Malta
Kategorija:Żvezja	Kategori:Sverige
Kategorija:Slovakkja	Kategori:Slovakia
Kategorija:Slovenja	Kategori:Slovenia
Kategorija:Repubblika tal-Irlanda	Kategori:Republikken Irland
Kategorija:Artikli fil-vetrina	Kategori:Utmerkede artikler
Kategorija:Gwerer	Kategori:Kriger
Kategorija:Logħob elettroniku	Kategori:Videospill
Mudell:Flagicon	Mal:Flagicon
Kategorija:Pajjiżi tal-Ewropa	Kategori:Land i Europa
Kategorija:Ewropa	Kategori:Europa
Kategorija:Għajnuna	Kategori:Hjelp
Mudell:Dokumentazzjoni	Mal:Dokumentasjon
Kategorija:Paġni protetti	Kategori:Wikipedia beskyttede sider
Wikipedija:Politika dwar il-protezzjoni	Wikipedia:Denne siden er beskyttet
Kategorija:Paġni semi-protetti	Kategori:Wikipedia semibeskyttede sider
Kategorija:Wikipedjani	Kategori:Wikipedia-brukere
Wikipedija:Kunsens	Wikipedia:Konsensus
Wikipedija:L-ebda attakk personali	Wikipedia:Ingen personangrep
Wikipedija:Kuntatt	Wikipedia:Kontakt
Kategorija:Utenti skont il-lingwa	Kategori:Wikipedia-brukere etter språk
Kategorija:Politiki tal-Wikipedija	Kategori:Wikipedia-politikk
Wikipedija:Firem	Hjelp:Signatur
Wikipedija:Abbozz	Wikipedia:Stubb
Wikipedija:Artikli rikjesti	Wikipedia:Ønskelisten
Mudell:Softredirect	Mal:Softredirect
Mudell:Ħassar minnufih	Mal:Hurtigsletting
Kategorija:Teknoloġija	Kategori:Teknologi
Kategorija:Lingwa	Kategori:Språk
Għajnuna:Kif tibda artiklu	Hjelp:Hvordan starte en side
Kategorija:Wikipedija	Kategori:Wikipedia
Wikipedija:Ċaħda ġenerali	Wikipedia:Generelle forbehold
Kategorija:Avvenimenti kurrenti	Kategori:Pågående hendelser
Wikipedija:Manwal tal-istil	Wikipedia:Stilmanual
Mudell:-	Mal:-
Mudell:Navbox	Mal:Navboks
Mudell:Abbrevjazzjoni	Mal:Snarvei
Kategorija:Żoni tal-ħin	Kategori:Tidssoner
Kategorija:Nies ħajjin	Kategori:Biografier om levende personer
Festival tal-Eurovision 2014	Eurovision Song Contest 2014
Mudell:!	Mal:!
Kategorija:Mudelli ta' bnadar	Kategori:Flaggmaler
Mudell:!!	Mal:!!
Mudell:=	Mal:=
Mudell:Tnavbar	Mal:Tnavbar
Mudell:Ċiklu	Mal:Loop
Mudell:0	Mal:0
Kategorija:Mudelli ta' formattjar	Kategori:Formateringsmaler
Mudell:Clear	Mal:Clear
Mudell:Col-break	Mal:Col-break
Mudell:Col-begin	Mal:Col-begin
Mudell:Col-end	Mal:Col-end
Mudell:Kulur	Mal:Farve
Mudell:Deskrizzjoni kmand	Mal:Abbr
Wikipedija:Lista ta' artikli li kull Wikipedija għandu jkollha	Wikipedia:Liste over artikler vi bør ha
Kategorija:Afrika	Kategori:Afrika
Kategorija:Elettronika	Kategori:Elektronikk
Kategorija:Xhur tas-sena	Kategori:Måneder
Mudell:Wikisors	Mal:Wikisource
Mudell:Babel-3	Mal:Babel-3
Mudell:Babel	Mal:Babel
Mudell:Commons	Mal:Commons
Mudell:Referenzi	Mal:Referanser
Kategorija:Avvenimenti sportivi kurrenti	Kategori:Pågående sportsarrangementer
Għajnuna:Esplora lill-Wikipedija	Hjelp:Søking
Mudell:Pajjiżi tal-Commonwealth	Mal:Samveldet av nasjoner
Mudell:Stub	Mal:Stubb
Mudell:Utent ar-1	Mal:Bruker ar-1
Mudell:Utent az	Mal:Bruker az
Mudell:Utent be-2	Mal:Bruker be-2
Mudell:Utent da-1	Mal:Bruker da-1
Mudell:Utent eo-3	Mal:Bruker eo-3
Mudell:Utent de	Mal:Bruker de
Mudell:Utent de-1	Mal:Bruker de-1
Mudell:Utent el	Mal:Bruker el
Mudell:Utent es	Mal:Bruker es
Mudell:Utent de-3	Mal:Bruker de-3
Mudell:Utent en-3	Mal:Bruker en-3
Mudell:Utent en-1	Mal:Bruker en-1
Mudell:Utent en-2	Mal:Bruker en-2
Mudell:Utent en-4	Mal:Bruker en-4
Mudell:Utent en-0	Mal:Bruker en-0
Mudell:Utent en	Mal:Bruker en
Mudell:Utent de-2	Mal:Bruker de-2
Mudell:Utent es-1	Mal:Bruker es-1
Mudell:Utent fa	Mal:Bruker fa
Mudell:Utent fr-1	Mal:Bruker fr-1
Mudell:Utent ia-2	Mal:Bruker ia-2
Mudell:Utent hr	Mal:Bruker hr
Mudell:Utent it-3	Mal:Bruker it-3
Mudell:Utent grc-1	Mal:Bruker grc-1
Mudell:Utent ja-4	Mal:Bruker ja-4
Mudell:Utent sk	Mal:Bruker sk
Mudell:Utent tr-2	Mal:Bruker tr-2
Mudell:Utent fr-2	Mal:Bruker fr-2
Mudell:Utent ja	Mal:Bruker ja
Mudell:Utent it-1	Mal:Bruker it-1
Mudell:Utent fr	Mal:Bruker fr
Mudell:Ebda firma	Mal:Usignert
Kategorija:Turiżmu	Kategori:Turisme
Kategorija:1957	Kategori:1957
Kategorija:1949	Kategori:1949
Kategorija:1927	Kategori:1927
Kategorija:1919	Kategori:1919
Kategorija:Moldova	Kategori:Moldova
Kategorija:Ażerbajġan	Kategori:Aserbajdsjan
Mudell:Plejers fit-tim tal-futbol/nofs	Mal:Fs mid
Kategorija:Asja	Kategori:Asia
Kategorija:Ċili	Kategori:Chile
Kategorija:Seklu 21	Kategori:2000-tallet
Kategorija:Mudelli ta' servizz	Kategori:Artikkelmerker
Kategorija:Utenti uk	Kategori:Bruker uk
Kategorija:1930	Kategori:1930
Kategorija:Utenti uk-N	Kategori:Bruker uk-N
Kategorija:1936	Kategori:1936
Kategorija:1947	Kategori:1947
Mudell:Mudell ikkumplikat	Mal:Komplisert mal
Kategorija:1937	Kategori:1937
Kategorija:1940	Kategori:1940
Kategorija:1934	Kategori:1934
Kategorija:1960	Kategori:1960
Kategorija:1943	Kategori:1943
Kategorija:1951	Kategori:1951
Mudell:Tim tal-futbol	Mal:Spillerstall
Kategorija:1942	Kategori:1942
Kategorija:1959	Kategori:1959
Kategorija:1938	Kategori:1938
Kategorija:1928	Kategori:1928
Kategorija:1913	Kategori:1913
Kategorija:1918	Kategori:1918
Kategorija:1954	Kategori:1954
Kategorija:1941	Kategori:1941
Kategorija:1955	Kategori:1955
Kategorija:1950	Kategori:1950
Kategorija:1921	Kategori:1921
Kategorija:1977	Kategori:1977
Kategorija:1946	Kategori:1946
Kategorija:1948	Kategori:1948
Kategorija:1932	Kategori:1932
Mudell:Plejers fit-tim tal-futbol	Mal:Fs player
Kategorija:Futbol	Kategori:Fotball
Kategorija:1945	Kategori:1945
Mudell:Mod	Mal:Mod
Kategorija:1923	Kategori:1923
Kategorija:1935	Kategori:1935
Kategorija:1910	Kategori:1910
Kategorija:1917	Kategori:1917
Kategorija:1904	Kategori:1904
Kategorija:1926	Kategori:1926
Kategorija:1907	Kategori:1907
Kategorija:1914	Kategori:1914
Mudell:Utent sv	Mal:Bruker sv
Kategorija:1929	Kategori:1929
Kategorija:1920	Kategori:1920
Mudell:Utent it	Mal:Bruker it
Kategorija:1925	Kategori:1925
Mudell:Utent uk	Mal:Bruker uk
Kategorija:1905	Kategori:1905
Kategorija:1915	Kategori:1915
Mudell:Utent es-2	Mal:Bruker es-2
Kategorija:1908	Kategori:1908
Kategorija:1901	Kategori:1901
Kategorija:1903	Kategori:1903
Kategorija:1902	Kategori:1902
Kategorija:1900	Kategori:1900
Mudell:PaġnaPrinċipali/Proġetti	Mal:Søsterprosjekt
Kategorija:1933	Kategori:1933
Kategorija:1912	Kategori:1912
Kategorija:Klabbs tal-futbol Ingliżi	Kategori:Fotballag i England
Kategorija:Mudelli tal-koordinati	Kategori:Koordinatmaler
Kategorija:Klabbs tal-futbol Spanjoli	Kategori:Fotballag i Spania
Kategorija:1952	Kategori:1952
Mudell:Premier League	Mal:FA Premier League
Kategorija:Klabbs tal-futbol Ġermaniżi	Kategori:Fotballag i Tyskland
Kategorija:Lingwistika	Kategori:Lingvistikk
Kategorija:1911	Kategori:1911
Kategorija:1922	Kategori:1922
Kategorija:1924	Kategori:1924
Kategorija:1906	Kategori:1906
Kategorija:Klabbs tal-futbol	Kategori:Fotballag
Kategorija:Mudelli tal-futbol	Kategori:Fotballmaler
Kategorija:Utenti fr-1	Kategori:Bruker fr-1
Mudell:Wikiquote	Mal:Wikiquote
Kategorija:Innijiet Nazzjonali	Kategori:Nasjonalsanger
Mudell:Afrika	Mal:Afrikaland
Mudell:Wikimedia	Mal:Wikimedia-navigasjon
Mudell:Infobox artist mużikali	Mal:Infoboks musiker
Mudell:Es	Mal:Es icon
Mudell:Ambox	Mal:Amboks
Mudell:Għall-aġġornament	Mal:Trenger oppdatering
Mudell:Infobox Pajjiż	Mal:Infoboks land2
Mudell:Mas	Mal:Max
Mudell:Stampa kbira	Mal:Panoramabilde
Mudell:Kataktar	Mal:Hovedartikkel2
Mudell:Awdjo	Mal:Audio
Għajnuna:Gwida essenzjali/Ħoloq	Wikipedia:Veiledning/Wikipedia-lenker
Mudell:Sezzjoni-stub	Mal:Seksjonstubb
Mudell:Tmbox	Mal:Tmbox
Mudell:Kaxxa tal-bidu	Mal:S-start
Mudell:Politika	Mal:Retningslinje
Mudell:Facebook	Mal:Facebook
Mudell:Dablink	Mal:Dablink
Mudell:Tim futbol r daqs	Mal:Fb r width
Mudell:Vetrina	Mal:Utmerket
Mudell:Round4	Mal:Round4
Kategorija:Utenti en-4	Kategori:Bruker en-4
Kategorija:Utenti en	Kategori:Bruker en
Kategorija:Utenti zh	Kategori:Bruker zh
Kategorija:Kroazja	Kategori:Kroatia
Kategorija:Utenti zh-N	Kategori:Bruker zh-N
Kategorija:Utenti en-2	Kategori:Bruker en-2
Mudell:TOCright	Mal:TOC right
Mudell:Żmien utent Wikipedija	Mal:Bruker Wikipedia For
Kategorija:Mietu fl-1902	Kategori:Dødsfall i 1902
Mudell:Skwadra Ġermaniża Tazza tad-Dinja tal-Futbol 2002	Mal:Tysklands lag i fotball-VM 2002
Mudell:Utent zh	Mal:Bruker zh
Mudell:Leġenda	Mal:Legend
Mudell:Ċita web	Mal:Kilde www
Vojvodja	Voivodskap
Kategorija:Unuri tal-futbol	Kategori:Fotballpriser
Mudell:Ombox	Mal:Pmboks
Mudell:Lx	Mal:Lx
Mudell:Futbol internazzjonali	Mal:Internasjonal fotball
Kategorija:Kċina	Kategori:Mat og drikke
Mudell:Coor URL	Mal:Koor URL
Mudell:Pp-mudell	Mal:Beskyttet side
Mudell:Min	Mal:Min
Mudell:Wikizzjunarju	Mal:Wiktionary
Mudell:Utent nl-2	Mal:Bruker nl-2
Mudell:Bar box	Mal:Stolpediagram
Mudell:Languageicon	Mal:Språkikon
Kategorija:Agrikoltura	Kategori:Landbruk
Mudell:Babel-4	Mal:Babel-4
Mudell:Babel-6	Mal:Babel-6
Kategorija:Utenti hi	Kategori:Bruker hi
Kategorija:Seklu 20	Kategori:1900-tallet
Kategorija:Politiċi	Kategori:Politikere
Kategorija:Amerika	Kategori:Amerika
Mudell:Użioħra	Mal:Andrebetydninger
Mudell:Babel-1	Mal:Babel-1
Kategorija:Mudelli tal-lingwi tal-utenti	Kategori:Babel-maler
Kategorija:Bliet tal-Marokk	Kategori:Byer i Marokko
Mudell:Data tat-twelid u età	Mal:Fødselsdato og alder
Mudell:Clade	Mal:Clade
Mudell:ISEMXAHAR	Mal:MONTHNAME
Mudell:Rindirizzament kategorija	Mal:Kategoriomdirigering
Mudell:Infobox Kariga pubblika	Mal:Infoboks person med verv
Mudell:Proġetti oħra	Mal:Søsterlenker
Mudell:Sortname	Mal:Sorterbart navn
Mudell:Dati pajjiż Unjoni Ewropea	Mal:Country data Den europeiske union
Mudell:Data tal-mewt u età	Mal:Dødsdato og alder
Kategorija:Twieldu fl-1879	Kategori:Fødsler i 1879
Kategorija:Abbozzi ta' bijografiji	Kategori:Biografistubber
Mudell:Sport fil-futur	Mal:Fremtidig sport
Kategorija:Twieldu fl-1955	Kategori:Fødsler i 1955
Mudell:Ikoni tat-titlu	Mal:Toppikon
Kategorija:Twieldu fl-1963	Kategori:Fødsler i 1963
Kategorija:Twieldu fl-1817	Kategori:Fødsler i 1817
Kategorija:Twieldu fl-1998	Kategori:Fødsler i 1998
Mudell:Wikifikazzjoni	Mal:Wikifisering
Kategorija:Seklu 19	Kategori:1800-tallet
Kategorija:Kittieba	Kategori:Forfattere
Mudell:Yel	Mal:Gult
Mudell:Tim ta' AC Milan	Mal:AC Milan spillerstall
Mudell:Utent pt-1	Mal:Bruker pt-1
Kategorija:1931	Kategori:1931
Kategorija:1958	Kategori:1958
Kategorija:1956	Kategori:1956
Kategorija:1944	Kategori:1944
Kategorija:Jiem ta' Jannar	Kategori:Dager i januar
Kategorija:1916	Kategori:1916
Kategorija:1939	Kategori:1939
Mudell:Tavla Perjodika kumpatta	Mal:Periodesystemet
Kategorija:1909	Kategori:1909
Kategorija:Klabbs tal-futbol Taljani	Kategori:Fotballag i Italia
Kategorija:Mietu fl-1221	Kategori:Dødsfall i 1221
Mudell:Utent no-2	Mal:Bruker no-2
Mudell:Kategorijamoħbija	Mal:Skjult kategori
Mudell:Dokumentazzjoni mudell	Mal:Dokumentasjonsunderside
Mudell:Bundesliga	Mal:Bundesligaen i fotball for menn
Mudell:CcTLD	Mal:CcTLD
Mudell:Div col	Mal:Div col
Mudell:Klassifikazzjoni	Mal:Rangering
Kategorija:Pittura	Kategori:Malerkunst
Mudell:Div col end	Mal:Div col end
Mudell:TħassirKategorija	Mal:Tom kategori
Mudell:'	Mal:'
Mudell:Goal	Mal:Goal
Mudell:Paġna utent	Mal:Brukerside
Kategorija:UEFA Europa League	Kategori:UEFA-cupen
Mudell:Infobox Album	Mal:Infoboks musikk
Mudell:Utent	Mal:Bruker
Mudell:Tazza tad-Dinja tal-Klabbs Rawnd 8	Mal:7TeamBracket-WC-with-5th
Kategorija:Ajruporti fil-Vjetnam	Kategori:Flyplasser i Vietnam
Mudell:Emerġenza-buttuna-tifi	Mal:Emergency-bot-shutoff
Mudell:Imdb	Mal:Imdb navn
Kategorija:Tuneżija	Kategori:Tunisia
Mudell:Wikibarijiet	Mal:Wikinews
Mudell:Cmbox	Mal:Kmboks
Mudell:Rindirizz	Mal:Omdirigering
Mudell:TwoLegStart	Mal:TwoLeg start
Mudell:Pajjiżi fil-Logħob Olimpiku tas-Sajf 2008	Mal:OL 2008 nasjoner
Mudell:Kontra	Mal:Imot
Mudell:Coord/link	Mal:Koord/lenke
Mudell:Utent SUL	Mal:SUL-boks
Kategorija:Utenti ja-N	Kategori:Bruker ja-N
Kategorija:Futbolers Belġjani	Kategori:Belgiske fotballspillere
Kategorija:Futbolers Sloveni	Kategori:Slovenske fotballspillere
Kategorija:Artikli kandidati għall-vetrina tal-Wikipedija	Kategori:Kandidatsider
Mudell:Pdf	Mal:PDFlink
Kategorija:Twieldu fl-1903	Kategori:Fødsler i 1903
Kategorija:Twieldu fl-1925	Kategori:Fødsler i 1925
Kategorija:Twieldu fl-1936	Kategori:Fødsler i 1936
Kategorija:Twieldu fl-1916	Kategori:Fødsler i 1916
Kategorija:Twieldu fl-1910	Kategori:Fødsler i 1910
Kategorija:Twieldu fl-1939	Kategori:Fødsler i 1939
Mudell:Diżambigwazzjoni	Mal:Peker
Kategorija:1962	Kategori:1962
Mudell:QasamKat	Mal:Kategoridiffusjon
Kategorija:Mudelli infobox	Kategori:Infobokser
Mudell:Penmiss	Mal:Strbom
Kategorija:Real Madrid CF	Kategori:Real Madrid CF
Kategorija:Futbol fi Spanja	Kategori:Fotball i Spania
Mudell:Pengoal	Mal:Strmål
Kategorija:Mietu fl-2013	Kategori:Dødsfall i 2013
Mudell:Fb	Mal:Fotballflagg
Kategorija:Twieldu fl-1938	Kategori:Fødsler i 1938
Kategorija:Meta-mudelli tal-Wikipedija	Kategori:Metamaler
Mudell:Utent no-3	Mal:Bruker no-3
Mudell:Infobox Filosfu	Mal:Infoboks filosof
Kategorija:Teoloġija	Kategori:Teologi
Mudell:Infobox Organizzazzjoni	Mal:Infoboks organisasjon
Robin Stjernberg	Robin Stjernberg
Kategorija:1663	Kategori:1663
Kategorija:Mietu fl-1663	Kategori:Dødsfall i 1663
Kategorija:Arkitettura	Kategori:Arkitektur
Mudell:NATO	Mal:NATO
Mudell:Utent it-2	Mal:Bruker it-2
Kategorija:Bliet tal-Italja	Kategori:Kommuner i Italia
Mudell:Età	Mal:Alder
Kategorija:Pajjiżi li spiċċaw fl-1813	Kategori:Stater og territorier opphørt i 1813
Kategorija:Pajjiżi li spiċċaw fl-1923	Kategori:Stater og territorier opphørt i 1923
Kategorija:Pajjiżi li spiċċaw fl-1974	Kategori:Stater og territorier opphørt i 1974
Kategorija:Pajjiżi li spiċċaw fl-2006	Kategori:Stater og territorier opphørt i 2006
Kategorija:Pajjiżi stabbiliti fl-1299	Kategori:Stater og territorier etablert i 1299
Kategorija:Pajjiżi stabbiliti fl-1600	Kategori:Stater og territorier etablert i 1600
Kategorija:Pajjiżi stabbiliti fl-1948	Kategori:Stater og territorier etablert i 1948
Mudell:Għoti tal-penalties	Mal:Straffesparkkonkurranse
Kategorija:Plejers ta' Oud-Heverlee Leuven	Kategori:Fotballspillere for Oud-Heverlee Leuven
Mudell:Infobox Ċelebrità	Mal:Infoboks biografi
Mudell:La	Mal:La
Kategorija:1953	Kategori:1953
Mudell:Tim ta' AS Roma	Mal:AS Roma spillerstall
Mudell:Lista ta' kapitali Ewropej skont ir-reġjun	Mal:Hovedsteder i Europa
Mudell:L-Ewwel Diviżjoni Belġjana	Mal:Jupiler League
Kategorija:Isqfijiet Kattoliċi Rumani	Kategori:Katolske biskoper
Mudell:Coord	Mal:Koord
Kategorija:Twieldu fis-seklu 20	Kategori:Fødsler på 1900-tallet
Kategorija:Twieldu fis-seklu 19	Kategori:Fødsler på 1800-tallet
Kategorija:Twieldu fis-seklu 21	Kategori:Fødsler på 2000-tallet
Kategorija:Twieldu fis-seklu 18	Kategori:Fødsler på 1700-tallet
Kategorija:Twieldu fis-seklu 17	Kategori:Fødsler på 1600-tallet
Kategorija:Twieldu fis-seklu 16	Kategori:Fødsler på 1500-tallet
Kategorija:Twieldu fis-seklu 15	Kategori:Fødsler på 1400-tallet
Kategorija:Mudelli tal-klabbs tal-futbol Franċiżi	Kategori:Franske spillerstallmaler for fotball
Kategorija:FIFA	Kategori:FIFA
Kategorija:Futbolers Ivorjani	Kategori:Ivorianske fotballspillere
Mudell:Timijiet nazzjonali tal-CAF	Mal:CAF-landslag
Kategorija:Mietu fl-1622	Kategori:Dødsfall i 1622
Mudell:Ewropa	Mal:Europa
Kategorija:Futbolers skont in-nazzjonalità	Kategori:Fotballspillere etter nasjonalitet
Kategorija:Utenti yue	Kategori:Bruker yue
Kategorija:Utenti hif	Kategori:Bruker hif
Kategorija:Utenti az	Kategori:Bruker az
Kategorija:Utenti be	Kategori:Bruker be
Kategorija:Utenti hr	Kategori:Bruker hr
Kategorija:Utenti eo	Kategori:Bruker eo
Kategorija:Utenti fr	Kategori:Bruker fr
Kategorija:Utenti cy	Kategori:Bruker cy
Kategorija:Utenti id	Kategori:Bruker id
Kategorija:Utenti ga	Kategori:Bruker ga
Kategorija:Utenti ja	Kategori:Bruker ja
Kategorija:Utenti nn	Kategori:Bruker nn
Kategorija:Utenti pt	Kategori:Bruker pt
Kategorija:Utenti scn	Kategori:Bruker scn
Kategorija:Utenti sv	Kategori:Bruker sv
Kategorija:Utenti fr-3	Kategori:Bruker fr-3
Kategorija:Utenti it-3	Kategori:Bruker it-3
Kategorija:Utenti no-3	Kategori:Bruker no-3
Kategorija:Utenti pl-3	Kategori:Bruker pl-3
Kategorija:Utenti da-1	Kategori:Bruker da-1
Kategorija:Utenti ga-1	Kategori:Bruker ga-1
Kategorija:Utenti nl-1	Kategori:Bruker nl-1
Kategorija:Utenti tr-1	Kategori:Bruker tr-1
Kategorija:Utenti ar-1	Kategori:Bruker ar-1
Kategorija:Utenti it-4	Kategori:Bruker it-4
Kategorija:Utenti pl-4	Kategori:Bruker pl-4
Kategorija:Utenti be-2	Kategori:Bruker be-2
Kategorija:Utenti da-2	Kategori:Bruker da-2
Kategorija:Utenti fr-2	Kategori:Bruker fr-2
Kategorija:Utenti cy-2	Kategori:Bruker cy-2
Kategorija:Utenti hi-2	Kategori:Bruker hi-2
Kategorija:Utenti it-2	Kategori:Bruker it-2
Kategorija:Utenti ja-2	Kategori:Bruker ja-2
Kategorija:Utenti nl-2	Kategori:Bruker nl-2
Kategorija:Utenti pl-2	Kategori:Bruker pl-2
Kategorija:Utenti tr-2	Kategori:Bruker tr-2
Kategorija:Utenti be-N	Kategori:Bruker be-N
Kategorija:Utenti cs-N	Kategori:Bruker cs-N
Kategorija:Utenti hr-N	Kategori:Bruker hr-N
Kategorija:Utenti fr-N	Kategori:Bruker fr-N
Kategorija:Utenti it-N	Kategori:Bruker it-N
Kategorija:Utenti nl-N	Kategori:Bruker nl-N
Kategorija:Utenti no-N	Kategori:Bruker no-N
Kategorija:Utenti ru-N	Kategori:Bruker ru-N
Kategorija:Divertiment	Kategori:Underholdning
Kategorija:Utenti se-3	Kategori:Bruker se-3
Mudell:Nfteams	Mal:NFT-spiller
Kategorija:Klabbs tal-futbol xolti	Kategori:Tidligere fotballag
Kategorija:UEFA Champions League 2012–13	Kategori:Mesterligaen 2012/2013
Kategorija:UEFA Champions League	Kategori:UEFA Mesterliga
Mudell:Utent pdc-1	Mal:Bruker pdc-1
Kategorija:Abbozzi tal-enerġija	Kategori:Energistubber
Kategorija:Plejers ta' Enosis Neon Paralimni	Kategori:Fotballspillere for Enosis Neon Paralimni FC
Kategorija:Għall-wikifikazzjoni	Kategori:Artikler som trenger å wikifiseres
Kategorija:1220	Kategori:1220
Kategorija:Organizzazzjonijiet tal-futbol	Kategori:Fotballorganisasjoner
Kategorija:UEFA	Kategori:UEFA
Kategorija:Utenti af	Kategori:Bruker af
Kategorija:Utenti af-3	Kategori:Bruker af-3
Kategorija:Utenti ar	Kategori:Bruker ar
Kategorija:Utenti az-N	Kategori:Bruker az-N
Kategorija:Pajjiżi fil-Festival tal-Eurovision	Kategori:Land i Eurovision Song Contest
Kategorija:Utenti bg	Kategori:Bruker bg
Kategorija:Utenti bg-1	Kategori:Bruker bg-1
Kategorija:Utenti bg-N	Kategori:Bruker bg-N
Kategorija:Mużiċisti Awstrijaċi	Kategori:Østerrikske musikere
Kategorija:Utenti cs	Kategori:Bruker cs
Kategorija:Utenti da	Kategori:Bruker da
Kategorija:Provinċja ta' Quang Binh	Kategori:Quang Binh
Kategorija:Utenti de	Kategori:Bruker de
Kategorija:Utenti de-2	Kategori:Bruker de-2
Kategorija:Utenti de-3	Kategori:Bruker de-3
Kategorija:Utenti de-4	Kategori:Bruker de-4
Kategorija:Utenti de-N	Kategori:Bruker de-N
Kategorija:Utenti el	Kategori:Bruker el
Kategorija:Utenti el-N	Kategori:Bruker el-N
Kategorija:Utenti en-3	Kategori:Bruker en-3
Kategorija:Utenti en-N	Kategori:Bruker en-N
Kategorija:Utenti eo-3	Kategori:Bruker eo-3
Kategorija:Utenti es	Kategori:Bruker es
Kategorija:Utenti es-1	Kategori:Bruker es-1
Mudell:Pajjiżi tal-Unjoni Ewropea	Mal:EU-bunn
Kategorija:Utenti es-2	Kategori:Bruker es-2
Kategorija:Utenti es-3	Kategori:Bruker es-3
Kategorija:Utenti es-N	Kategori:Bruker es-N
Kategorija:Utenti fa	Kategori:Bruker fa
Kategorija:Utenti fa-N	Kategori:Bruker fa-N
Kategorija:Utenti fi	Kategori:Bruker fi
Kategorija:Utenti fi-N	Kategori:Bruker fi-N
Kategorija:Utenti ga-2	Kategori:Bruker ga-2
Kategorija:Utenti ga-3	Kategori:Bruker ga-3
Kategorija:Utenti ga-N	Kategori:Bruker ga-N
Kategorija:Utenti grc	Kategori:Bruker grc
Kategorija:Utenti grc-1	Kategori:Bruker grc-1
Kategorija:Utenti hu	Kategori:Bruker hu
Kategorija:Utenti hu-1	Kategori:Bruker hu-1
Kategorija:1452	Kategori:1452
Mudell:Tim ta' Bayer 04 Leverkusen	Mal:Bayer Leverkusen
Kategorija:Plejers ta' Los Angeles Galaxy	Kategori:Fotballspillere for Los Angeles Galaxy
Kategorija:Mietu fl-1904	Kategori:Dødsfall i 1904
Kategorija:Politiċi Veneżwelani	Kategori:Venezuelanske politikere
Mudell:Tim ta' Málaga CF	Mal:Málaga CF
Kategorija:Utenti pl-N	Kategori:Bruker pl-N
Kategorija:Utenti pt-1	Kategori:Bruker pt-1
Kategorija:Klabbs tal-futbol stabbiliti fl-1993	Kategori:Fotballag etablert i 1993
Kategorija:Mietu fl-1852	Kategori:Dødsfall i 1852
Kategorija:Mietu fl-1880	Kategori:Dødsfall i 1880
Kategorija:Ġeometrija	Kategori:Geometri
Kategorija:Klabbs tal-futbol stabbiliti fl-1975	Kategori:Fotballag etablert i 1975
Kategorija:Klabbs tal-futbol stabbiliti fl-1953	Kategori:Fotballag etablert i 1953
Kategorija:Klabbs tal-futbol stabbiliti fl-1920	Kategori:Fotballag etablert i 1920
Kategorija:Klabbs tal-futbol stabbiliti fl-1948	Kategori:Fotballag etablert i 1948
Kategorija:Klabbs tal-futbol stabbiliti fl-1945	Kategori:Fotballag etablert i 1945
Kategorija:Klabbs tal-futbol stabbiliti fl-1904	Kategori:Fotballag etablert i 1904
Kategorija:Klabbs tal-futbol stabbiliti fl-1960	Kategori:Fotballag etablert i 1960
Kategorija:Mietu fl-1942	Kategori:Dødsfall i 1942
Kategorija:Klabbs tal-futbol stabbiliti fl-1937	Kategori:Fotballag etablert i 1937
Kategorija:Klabbs tal-futbol stabbiliti fl-1944	Kategori:Fotballag etablert i 1944
Kategorija:Klabbs tal-futbol stabbiliti fl-1919	Kategori:Fotballag etablert i 1919
Kategorija:Klabbs tal-futbol stabbiliti fl-1925	Kategori:Fotballag etablert i 1925
Kategorija:Klabbs tal-futbol stabbiliti fl-1930	Kategori:Fotballag etablert i 1930
Kategorija:Klabbs tal-futbol stabbiliti fl-1924	Kategori:Fotballag etablert i 1924
Kategorija:Klabbs tal-futbol stabbiliti fl-1901	Kategori:Fotballag etablert i 1901
Kategorija:Klabbs tal-futbol stabbiliti fl-1902	Kategori:Fotballag etablert i 1902
Kategorija:Klabbs tal-futbol stabbiliti fl-1910	Kategori:Fotballag etablert i 1910
Kategorija:Klabbs tal-futbol stabbiliti fl-1899	Kategori:Fotballag etablert i 1899
Kategorija:Klabbs tal-futbol stabbiliti fl-1897	Kategori:Fotballag etablert i 1897
Kategorija:Klabbs tal-futbol stabbiliti fl-1996	Kategori:Fotballag etablert i 1996
Kategorija:Klabbs tal-futbol stabbiliti fl-1947	Kategori:Fotballag etablert i 1947
Kategorija:Klabbs tal-futbol stabbiliti fl-1909	Kategori:Fotballag etablert i 1909
Kategorija:Klabbs tal-futbol stabbiliti fl-1967	Kategori:Fotballag etablert i 1967
Kategorija:Klabbs tal-futbol stabbiliti fl-1928	Kategori:Fotballag etablert i 1928
Kategorija:Klabbs tal-futbol stabbiliti fl-1886	Kategori:Fotballag etablert i 1886
Kategorija:Klabbs tal-futbol stabbiliti fl-1926	Kategori:Fotballag etablert i 1926
Kategorija:Klabbs tal-futbol stabbiliti fl-1900	Kategori:Fotballag etablert i 1900
Kategorija:Klabbs tal-futbol stabbiliti fl-1956	Kategori:Fotballag etablert i 1956
Kategorija:Klabbs tal-futbol stabbiliti fl-1922	Kategori:Fotballag etablert i 1922
Kategorija:Klabbs tal-futbol stabbiliti fl-1988	Kategori:Fotballag etablert i 1988
Kategorija:Klabbs tal-futbol stabbiliti fl-1905	Kategori:Fotballag etablert i 1905
Kategorija:Klabbs tal-futbol stabbiliti fl-1946	Kategori:Fotballag etablert i 1946
Kategorija:Klabbs tal-futbol stabbiliti fl-1912	Kategori:Fotballag etablert i 1912
Kategorija:Klabbs tal-futbol stabbiliti fl-1974	Kategori:Fotballag etablert i 1974
Kategorija:Klabbs tal-futbol stabbiliti fl-2006	Kategori:Fotballag etablert i 2006
Kategorija:Kampjonati Ewropej tal-Futbol 2012	Kategori:EM i fotball 2012
Għajnuna:Gwida essenzjali/Ifformattjar	Wikipedia:Veiledning/Formatering
Kategorija:Klabbs tal-futbol stabbiliti fl-1911	Kategori:Fotballag etablert i 1911
Kategorija:Klabbs tal-futbol stabbiliti fl-1906	Kategori:Fotballag etablert i 1906
Kategorija:Klabbs tal-futbol stabbiliti fl-1936	Kategori:Fotballag etablert i 1936
Kategorija:Klabbs tal-futbol stabbiliti fl-1907	Kategori:Fotballag etablert i 1907
Kategorija:Klabbs tal-futbol stabbiliti fl-1955	Kategori:Fotballag etablert i 1955
Kategorija:Klabbs tal-futbol stabbiliti fl-1949	Kategori:Fotballag etablert i 1949
Kategorija:Utenti it	Kategori:Bruker it
Kategorija:Utenti it-1	Kategori:Bruker it-1
Kategorija:Klabbs tal-futbol stabbiliti fl-1972	Kategori:Fotballag etablert i 1972
Kategorija:Klabbs tal-futbol stabbiliti fl-1991	Kategori:Fotballag etablert i 1991
Kategorija:Klabbs tal-futbol stabbiliti fl-1950	Kategori:Fotballag etablert i 1950
Kategorija:Futbolers Ażerbajġani	Kategori:Aserbajdsjanske fotballspillere
Kategorija:European Broadcasting Union	Kategori:Den europeiske kringkastingsunion
Kategorija:Vulkani	Kategori:Vulkaner
Kategorija:Mietu fl-1564	Kategori:Dødsfall i 1564
Kategorija:1564	Kategori:1564
Kategorija:Provinċji tal-Vjetnam	Kategori:Vietnams provinser
Kategorija:1592	Kategori:1592
Kategorija:Plejers ta' De Graafschap	Kategori:Fotballspillere for BV De Graafschap
Kategorija:Pitturi tar-Rinaxximent	Kategori:Renessansemalere
Kategorija:Bijoloġi evoluzzjonarji	Kategori:Evolusjonsbiologer
Kategorija:Kowċis Olandiżi	Kategori:Nederlandske fotballtrenere
Kategorija:Mużiċisti Olandiżi	Kategori:Nederlandske musikere
Kategorija:Kantanti Olandiżi	Kategori:Nederlandske sangere
Mudell:Klassifikazzjoni xjentifika	Mal:Biologisk klassifisering
Kategorija:Mietu fl-1794	Kategori:Dødsfall i 1794
Kategorija:Mietu fl-1931	Kategori:Dødsfall i 1931
Kategorija:Mietu fl-1827	Kategori:Dødsfall i 1827
Kategorija:Utenti ru-1	Kategori:Bruker ru-1
Mudell:TOClimit	Mal:TOClimit
Wikipedija:Babel	Wikipedia:Babel
Kategorija:Mietu fl-1829	Kategori:Dødsfall i 1829
Kategorija:Mietu fl-1778	Kategori:Dødsfall i 1778
Kategorija:Mietu fl-1547	Kategori:Dødsfall i 1547
Mudell:·wrap	Mal:·wrap
Kategorija:Abbozzi tal-kimika	Kategori:Kjemistubber
Kategorija:1687	Kategori:1687
Kategorija:1614	Kategori:1614
Kategorija:1612	Kategori:1612
Kategorija:Mietu fl-1612	Kategori:Dødsfall i 1612
Kategorija:Mietu fl-1655	Kategori:Dødsfall i 1655
Kategorija:Mietu fl-1616	Kategori:Dødsfall i 1616
Kategorija:Mietu fl-1614	Kategori:Dødsfall i 1614
Kategorija:Futbolers Olandiżi	Kategori:Nederlandske fotballspillere
Kategorija:1655	Kategori:1655
Kategorija:Utenti nb-1	Kategori:Bruker nb-1
Kategorija:Utenti mt	Kategori:Bruker mt
Kategorija:Mietu fl-1994	Kategori:Dødsfall i 1994
Kategorija:Twieldu fl-1906	Kategori:Fødsler i 1906
Kategorija:Kompożituri tal-opra	Kategori:Operakomponister
Kategorija:Ibħra	Kategori:Hav
Kategorija:Bliet tal-Polonja	Kategori:Byer i Polen
Kategorija:Kompożituri skont in-nazzjonalità	Kategori:Komponister etter nasjonalitet
Mudell:Bundesliga (Awstrija)	Mal:Bundesliga (Østerrike)
Kategorija:Futbolers f'Wales skont il-klabb	Kategori:Fotballspillere i Wales etter klubb
Kategorija:Atturi skont in-nazzjonalità	Kategori:Skuespillere etter nasjonalitet
Kategorija:Mietu fl-2009	Kategori:Dødsfall i 2009
Kategorija:Utenti nb-3	Kategori:Bruker nb-3
Kategorija:Sistema solari	Kategori:Solsystemet
Trasformata ta' Fourier	Fouriertransformasjon
Mudell:FIFA	Mal:FIFA-spiller
Mudell:UEFA	Mal:UEFA-spiller
Kategorija:Entomoloġija	Kategori:Entomologi
Kategorija:Carnivora	Kategori:Rovdyr
Mudell:Premier League Bjelorussu	Mal:Vysshaya Liga
Kategorija:Klabbs tal-futbol Torok	Kategori:Fotballag i Tyrkia
Kategorija:Mietu fl-1321	Kategori:Dødsfall i 1321
Kategorija:Mietu fl-2005	Kategori:Dødsfall i 2005
Kategorija:Twieldu fl-1983	Kategori:Fødsler i 1983
Kategorija:Mietu fl-1592	Kategori:Dødsfall i 1592
Kategorija:Futbolers Pollakki	Kategori:Polske fotballspillere
Kategorija:Mużiċisti Bulgari	Kategori:Bulgarske musikere
Kategorija:Mietu fl-1991	Kategori:Dødsfall i 1991
Kategorija:Mietu fl-1992	Kategori:Dødsfall i 1992
Kategorija:Plejers ta' Sport Club Corinthians Paulista	Kategori:Fotballspillere for Sport Club Corinthians Paulista
Kategorija:Twieldu fl-1992	Kategori:Fødsler i 1992
Kategorija:Utenti nb	Kategori:Bruker nb
Kategorija:Twieldu fl-1970	Kategori:Fødsler i 1970
Kategorija:Mietu fl-1980	Kategori:Dødsfall i 1980
Kategorija:Mietu fl-2008	Kategori:Dødsfall i 2008
Kategorija:Mietu fl-1966	Kategori:Dødsfall i 1966
Kategorija:Mietu fl-1946	Kategori:Dødsfall i 1946
Kategorija:Mietu fl-1938	Kategori:Dødsfall i 1938
Kategorija:Twieldu fl-1984	Kategori:Fødsler i 1984
Kategorija:Mietu fl-1962	Kategori:Dødsfall i 1962
Kategorija:Twieldu fl-1990	Kategori:Fødsler i 1990
Kategorija:Mietu fl-1934	Kategori:Dødsfall i 1934
Kategorija:Twieldu fl-1974	Kategori:Fødsler i 1974
Kategorija:Mietu fl-1947	Kategori:Dødsfall i 1947
Kategorija:Mietu fl-2007	Kategori:Dødsfall i 2007
Kategorija:Twieldu fl-1965	Kategori:Fødsler i 1965
Kategorija:Twieldu fl-1940	Kategori:Fødsler i 1940
Kategorija:Twieldu fl-1898	Kategori:Fødsler i 1898
Kategorija:Twieldu fl-1867	Kategori:Fødsler i 1867
Kategorija:Twieldu fl-1871	Kategori:Fødsler i 1871
Kategorija:Twieldu fl-1862	Kategori:Fødsler i 1862
Kategorija:Twieldu fl-1977	Kategori:Fødsler i 1977
Kategorija:Twieldu fl-1899	Kategori:Fødsler i 1899
Kategorija:1844	Kategori:1844
Kategorija:Twieldu fl-1931	Kategori:Fødsler i 1931
Kategorija:Twieldu fl-1915	Kategori:Fødsler i 1915
Kategorija:Twieldu fl-1929	Kategori:Fødsler i 1929
Portal:Sport	Portal:Sport
Kategorija:Twieldu fl-1954	Kategori:Fødsler i 1954
Kategorija:Xjenza soċjali	Kategori:Samfunnsvitenskap
Kategorija:Bjelorussja	Kategori:Hviterussland
Kategorija:Twieldu fl-1960	Kategori:Fødsler i 1960
Kategorija:Kantanti Kanadiżi	Kategori:Canadiske sangere
Kategorija:Klabbs tal-futbol stabbiliti fl-1963	Kategori:Fotballag etablert i 1963
Kategorija:Klabbs tal-futbol stabbiliti fl-2008	Kategori:Fotballag etablert i 2008
Kategorija:Mietu fl-1830	Kategori:Dødsfall i 1830
Kategorija:Mietu fl-1993	Kategori:Dødsfall i 1993
Kategorija:Pajjiżi tal-Afrika	Kategori:Land i Afrika
Kategorija:Mietu fl-1998	Kategori:Dødsfall i 1998
Kategorija:Klabbs tal-futbol Ażerbajġani	Kategori:Fotballag i Aserbajdsjan
Kategorija:1170	Kategori:1170
Kategorija:Twieldu fl-1170	Kategori:Fødsler i 1170
Kategorija:Twieldu fl-1182	Kategori:Fødsler i 1182
Kategorija:Twieldu fl-1185	Kategori:Fødsler i 1185
Kategorija:Mietu fl-1220	Kategori:Dødsfall i 1220
Kategorija:1226	Kategori:1226
Kategorija:Mietu fl-1226	Kategori:Dødsfall i 1226
Kategorija:1227	Kategori:1227
Kategorija:Mietu fl-1227	Kategori:Dødsfall i 1227
Kategorija:Twieldu fl-1951	Kategori:Fødsler i 1951
Kategorija:Mietu fl-1882	Kategori:Dødsfall i 1882
Kategorija:Mietu fl-1883	Kategori:Dødsfall i 1883
Kategorija:1265	Kategori:1265
Kategorija:Twieldu fl-1265	Kategori:Fødsler i 1265
Kategorija:1296	Kategori:1296
Kategorija:Mietu fl-1296	Kategori:Dødsfall i 1296
Mudell:Utent da-3	Mal:Bruker da-3
Mudell:Tim ta' FC Barcelona	Mal:FC Barcelona
Mudell:Utent ja-2	Mal:Bruker ja-2
Kategorija:1528	Kategori:1528
Kategorija:1405	Kategori:1405
Mudell:Utent ru-2	Mal:Bruker ru-2
Kategorija:Twieldu fl-1405	Kategori:Fødsler i 1405
Kategorija:1522	Kategori:1522
Kategorija:1419	Kategori:1419
Kategorija:1508	Kategori:1508
Kategorija:1519	Kategori:1519
Kategorija:Futbol fil-Polonja	Kategori:Fotball i Polen
Kategorija:Futbolers fil-Polonja skont il-klabb	Kategori:Fotballspillere i Polen etter klubb
Kategorija:Twieldu fl-1452	Kategori:Fødsler i 1452
Kategorija:1466	Kategori:1466
Kategorija:1468	Kategori:1468
Kategorija:Mietu fl-1468	Kategori:Dødsfall i 1468
Kategorija:1471	Kategori:1471
Kategorija:Twieldu fl-1471	Kategori:Fødsler i 1471
Mudell:Skwadra Taljana Tazza tad-Dinja tal-Futbol 2010	Mal:Italias lag i fotball-VM 2010
Kategorija:1478	Kategori:1478
Kategorija:Twieldu fl-1478	Kategori:Fødsler i 1478
Kategorija:Twieldu fl-1480	Kategori:Fødsler i 1480
Kategorija:1483	Kategori:1483
Kategorija:1494	Kategori:1494
Kategorija:Twieldu fl-1494	Kategori:Fødsler i 1494
Kategorija:Utenti ru	Kategori:Bruker ru
Kategorija:Utenti ru-2	Kategori:Bruker ru-2
Kategorija:Utenti ru-3	Kategori:Bruker ru-3
Kategorija:Twieldu fl-1508	Kategori:Fødsler i 1508
Kategorija:Utenti se	Kategori:Bruker se
Kategorija:Twieldu fl-1515	Kategori:Fødsler i 1515
Kategorija:Mietu fl-1519	Kategori:Dødsfall i 1519
Kategorija:1532	Kategori:1532
Kategorija:Twieldu fl-1532	Kategori:Fødsler i 1532
Kategorija:Twieldu fl-1533	Kategori:Fødsler i 1533
Kategorija:Mietu fl-1535	Kategori:Dødsfall i 1535
Kategorija:Mietu fl-1539	Kategori:Dødsfall i 1539
Kategorija:1542	Kategori:1542
Kategorija:Utenti sv-3	Kategori:Bruker sv-3
Kategorija:1547	Kategori:1547
Kategorija:Utenti sv-N	Kategori:Bruker sv-N
Kategorija:Twieldu fl-1552	Kategori:Fødsler i 1552
Kategorija:1562	Kategori:1562
Kategorija:Twieldu fl-1564	Kategori:Fødsler i 1564
Kategorija:1567	Kategori:1567
Kategorija:1568	Kategori:1568
Kategorija:Mietu fl-1568	Kategori:Dødsfall i 1568
Kategorija:1573	Kategori:1573
Kategorija:Twieldu fl-1573	Kategori:Fødsler i 1573
Kategorija:1581	Kategori:1581
Kategorija:Twieldu fl-1582	Kategori:Fødsler i 1582
Kategorija:1591	Kategori:1591
Kategorija:1593	Kategori:1593
Kategorija:1597	Kategori:1597
Kategorija:1600	Kategori:1600
Kategorija:1616	Kategori:1616
Kategorija:1621	Kategori:1621
Kategorija:Utenti tr	Kategori:Bruker tr
Kategorija:Mietu fl-1621	Kategori:Dødsfall i 1621
Kategorija:1625	Kategori:1625
Kategorija:Mietu fl-1625	Kategori:Dødsfall i 1625
Kategorija:Utenti uk-4	Kategori:Bruker uk-4
Kategorija:1636	Kategori:1636
Kategorija:1643	Kategori:1643
Kategorija:Mietu fl-1643	Kategori:Dødsfall i 1643
Kategorija:1654	Kategori:1654
Kategorija:Twieldu fl-1654	Kategori:Fødsler i 1654
Kategorija:1656	Kategori:1656
Kategorija:Mietu fl-1656	Kategori:Dødsfall i 1656
Kategorija:Utenti yue-N	Kategori:Bruker yue-N
Kategorija:1660	Kategori:1660
Kategorija:1667	Kategori:1667
Kategorija:Mietu fl-1667	Kategori:Dødsfall i 1667
Kategorija:1670	Kategori:1670
Kategorija:Mietu fl-1670	Kategori:Dødsfall i 1670
Kategorija:1675	Kategori:1675
Kategorija:1685	Kategori:1685
Kategorija:Twieldu fl-1687	Kategori:Fødsler i 1687
Kategorija:1694	Kategori:1694
Kategorija:1695	Kategori:1695
Kategorija:Twieldu fl-1696	Kategori:Fødsler i 1696
Kategorija:Twieldu fl-1699	Kategori:Fødsler i 1699
Kategorija:1700	Kategori:1700
Mudell:Premier League Malti	Mal:BOV Premier League
Kategorija:Mietu fl-1705	Kategori:Dødsfall i 1705
Kategorija:1709	Kategori:1709
Kategorija:1710	Kategori:1710
Kategorija:Twieldu fl-1715	Kategori:Fødsler i 1715
Kategorija:Twieldu fl-1724	Kategori:Fødsler i 1724
Mudell:Spazji	Mal:Mellomrom
Kategorija:Mużiċisti	Kategori:Musikere
Kategorija:Twieldu fl-1881	Kategori:Fødsler i 1881
Mudell:Timijiet nazzjonali tal-UEFA	Mal:UEFA-landslag
Mudell:Tim ta' Manchester United FC	Mal:Manchester United
Kategorija:Kantanti Irlandiżi	Kategori:Irske sangere
Mudell:Skwadra Ġermaniża Tazza tad-Dinja tal-Futbol 2010	Mal:Tysklands lag i fotball-VM 2010
Mudell:Skwadra Ġermaniża Kampjonati Ewropej tal-Futbol 2008	Mal:Tysklands lag i fotball-EM 2008
Kategorija:Twieldu fl-1944	Kategori:Fødsler i 1944
Kategorija:Twieldu fl-1932	Kategori:Fødsler i 1932
Kategorija:Twieldu fl-1934	Kategori:Fødsler i 1934
Kategorija:Twieldu fl-1935	Kategori:Fødsler i 1935
Kategorija:Terminoloġija sportiva	Kategori:Sportsterminologi
Kategorija:Twieldu fl-1941	Kategori:Fødsler i 1941
Kategorija:Matematiċi Russi	Kategori:Russiske matematikere
Kategorija:Soċjoloġija	Kategori:Sosiologi
Kategorija:Twieldu fis-seklu 12	Kategori:Fødsler på 1100-tallet
Kategorija:Twieldu fis-seklu 13	Kategori:Fødsler på 1200-tallet
Kategorija:Twieldu fis-seklu 14	Kategori:Fødsler på 1300-tallet
Kategorija:Twieldu fl-1466	Kategori:Fødsler i 1466
Kategorija:Twieldu fl-1483	Kategori:Fødsler i 1483
Kategorija:Twieldu fl-1542	Kategori:Fødsler i 1542
Kategorija:Twieldu fl-1547	Kategori:Fødsler i 1547
Kategorija:Twieldu fl-1562	Kategori:Fødsler i 1562
Kategorija:Twieldu fl-1567	Kategori:Fødsler i 1567
Kategorija:Twieldu fl-1581	Kategori:Fødsler i 1581
Kategorija:Twieldu fl-1591	Kategori:Fødsler i 1591
Kategorija:Twieldu fl-1593	Kategori:Fødsler i 1593
Kategorija:Twieldu fl-1600	Kategori:Fødsler i 1600
Kategorija:Twieldu fl-1636	Kategori:Fødsler i 1636
Kategorija:Twieldu fl-1643	Kategori:Fødsler i 1643
Kategorija:Twieldu fl-1667	Kategori:Fødsler i 1667
Kategorija:Twieldu fl-1675	Kategori:Fødsler i 1675
Kategorija:Twieldu fl-1685	Kategori:Fødsler i 1685
Kategorija:Twieldu fl-1694	Kategori:Fødsler i 1694
Kategorija:Twieldu fl-1695	Kategori:Fødsler i 1695
Kategorija:Twieldu fl-1700	Kategori:Fødsler i 1700
Kategorija:Twieldu fl-1710	Kategori:Fødsler i 1710
Kategorija:Twieldu fl-1744	Kategori:Fødsler i 1744
Kategorija:Twieldu fl-1748	Kategori:Fødsler i 1748
Kategorija:Twieldu fl-1749	Kategori:Fødsler i 1749
Kategorija:Twieldu fl-1756	Kategori:Fødsler i 1756
Kategorija:Twieldu fl-1758	Kategori:Fødsler i 1758
Kategorija:Twieldu fl-1759	Kategori:Fødsler i 1759
Kategorija:Twieldu fl-1764	Kategori:Fødsler i 1764
Kategorija:Twieldu fl-1767	Kategori:Fødsler i 1767
Kategorija:Twieldu fl-1769	Kategori:Fødsler i 1769
Kategorija:Twieldu fl-1770	Kategori:Fødsler i 1770
Kategorija:Twieldu fl-1772	Kategori:Fødsler i 1772
Kategorija:Twieldu fl-1773	Kategori:Fødsler i 1773
Kategorija:Twieldu fl-1779	Kategori:Fødsler i 1779
Kategorija:Twieldu fl-1786	Kategori:Fødsler i 1786
Kategorija:Twieldu fl-1797	Kategori:Fødsler i 1797
Kategorija:Twieldu fl-1801	Kategori:Fødsler i 1801
Kategorija:Twieldu fl-1803	Kategori:Fødsler i 1803
Kategorija:Twieldu fl-1808	Kategori:Fødsler i 1808
Kategorija:Twieldu fl-1809	Kategori:Fødsler i 1809
Kategorija:Twieldu fl-1813	Kategori:Fødsler i 1813
Kategorija:Twieldu fl-1815	Kategori:Fødsler i 1815
Kategorija:Twieldu fl-1818	Kategori:Fødsler i 1818
Kategorija:Twieldu fl-1821	Kategori:Fødsler i 1821
Kategorija:Twieldu fl-1822	Kategori:Fødsler i 1822
Kategorija:Twieldu fl-1824	Kategori:Fødsler i 1824
Kategorija:Twieldu fl-1840	Kategori:Fødsler i 1840
Kategorija:Twieldu fl-1841	Kategori:Fødsler i 1841
Kategorija:Twieldu fl-1844	Kategori:Fødsler i 1844
Kategorija:Twieldu fl-1846	Kategori:Fødsler i 1846
Kategorija:Twieldu fl-1847	Kategori:Fødsler i 1847
Kategorija:Twieldu fl-1848	Kategori:Fødsler i 1848
Kategorija:Twieldu fl-1849	Kategori:Fødsler i 1849
Kategorija:Twieldu fl-1853	Kategori:Fødsler i 1853
Kategorija:Twieldu fl-1854	Kategori:Fødsler i 1854
Kategorija:Twieldu fl-1859	Kategori:Fødsler i 1859
Kategorija:Twieldu fl-1860	Kategori:Fødsler i 1860
Kategorija:Twieldu fl-1861	Kategori:Fødsler i 1861
Kategorija:Twieldu fl-1864	Kategori:Fødsler i 1864
Kategorija:Twieldu fl-1866	Kategori:Fødsler i 1866
Kategorija:Twieldu fl-1869	Kategori:Fødsler i 1869
Kategorija:Twieldu fl-1873	Kategori:Fødsler i 1873
Kategorija:Twieldu fl-1874	Kategori:Fødsler i 1874
Kategorija:Twieldu fl-1876	Kategori:Fødsler i 1876
Kategorija:Twieldu fl-1877	Kategori:Fødsler i 1877
Kategorija:Twieldu fl-1880	Kategori:Fødsler i 1880
Kategorija:Twieldu fl-1883	Kategori:Fødsler i 1883
Kategorija:Twieldu fl-1884	Kategori:Fødsler i 1884
Kategorija:Twieldu fl-1885	Kategori:Fødsler i 1885
Kategorija:Twieldu fl-1886	Kategori:Fødsler i 1886
Kategorija:Twieldu fl-1887	Kategori:Fødsler i 1887
Kategorija:Twieldu fl-1889	Kategori:Fødsler i 1889
Kategorija:Twieldu fl-1890	Kategori:Fødsler i 1890
Kategorija:Twieldu fl-1891	Kategori:Fødsler i 1891
Kategorija:Twieldu fl-1892	Kategori:Fødsler i 1892
Kategorija:Twieldu fl-1893	Kategori:Fødsler i 1893
Kategorija:Twieldu fl-1894	Kategori:Fødsler i 1894
Kategorija:Twieldu fl-1895	Kategori:Fødsler i 1895
Kategorija:Twieldu fl-1896	Kategori:Fødsler i 1896
Kategorija:Twieldu fl-1897	Kategori:Fødsler i 1897
Kategorija:Twieldu fl-1900	Kategori:Fødsler i 1900
Kategorija:Twieldu fl-1901	Kategori:Fødsler i 1901
Kategorija:Twieldu fl-1902	Kategori:Fødsler i 1902
Kategorija:Twieldu fl-1904	Kategori:Fødsler i 1904
Kategorija:Twieldu fl-1905	Kategori:Fødsler i 1905
Kategorija:Twieldu fl-1907	Kategori:Fødsler i 1907
Kategorija:Twieldu fl-1908	Kategori:Fødsler i 1908
Kategorija:Twieldu fl-1909	Kategori:Fødsler i 1909
Kategorija:Twieldu fl-1912	Kategori:Fødsler i 1912
Kategorija:Twieldu fl-1913	Kategori:Fødsler i 1913
Kategorija:Twieldu fl-1914	Kategori:Fødsler i 1914
Kategorija:Twieldu fl-1917	Kategori:Fødsler i 1917
Kategorija:Twieldu fl-1918	Kategori:Fødsler i 1918
Kategorija:Twieldu fl-1919	Kategori:Fødsler i 1919
Kategorija:Twieldu fl-1922	Kategori:Fødsler i 1922
Kategorija:Twieldu fl-1923	Kategori:Fødsler i 1923
Kategorija:Twieldu fl-1927	Kategori:Fødsler i 1927
Kategorija:Twieldu fl-1928	Kategori:Fødsler i 1928
Kategorija:Twieldu fl-1942	Kategori:Fødsler i 1942
Kategorija:Twieldu fl-1943	Kategori:Fødsler i 1943
Kategorija:Twieldu fl-1945	Kategori:Fødsler i 1945
Kategorija:Twieldu fl-1947	Kategori:Fødsler i 1947
Kategorija:Twieldu fl-1949	Kategori:Fødsler i 1949
Kategorija:Twieldu fl-1952	Kategori:Fødsler i 1952
Kategorija:Twieldu fl-1953	Kategori:Fødsler i 1953
Kategorija:Twieldu fl-1957	Kategori:Fødsler i 1957
Kategorija:Twieldu fl-1958	Kategori:Fødsler i 1958
Kategorija:Twieldu fl-1959	Kategori:Fødsler i 1959
Kategorija:Twieldu fl-1961	Kategori:Fødsler i 1961
Kategorija:Twieldu fl-1962	Kategori:Fødsler i 1962
Kategorija:Twieldu fl-1966	Kategori:Fødsler i 1966
Kategorija:Twieldu fl-1967	Kategori:Fødsler i 1967
Kategorija:Twieldu fl-1968	Kategori:Fødsler i 1968
Kategorija:Twieldu fl-1969	Kategori:Fødsler i 1969
Kategorija:Twieldu fl-1971	Kategori:Fødsler i 1971
Kategorija:Twieldu fl-1972	Kategori:Fødsler i 1972
Kategorija:Twieldu fl-1973	Kategori:Fødsler i 1973
Kategorija:Twieldu fl-1975	Kategori:Fødsler i 1975
Kategorija:Twieldu fl-1976	Kategori:Fødsler i 1976
Kategorija:Twieldu fl-1978	Kategori:Fødsler i 1978
Kategorija:Twieldu fl-1979	Kategori:Fødsler i 1979
Kategorija:Twieldu fl-1980	Kategori:Fødsler i 1980
Kategorija:Twieldu fl-1981	Kategori:Fødsler i 1981
Kategorija:Twieldu fl-1982	Kategori:Fødsler i 1982
Kategorija:Twieldu fl-1985	Kategori:Fødsler i 1985
Kategorija:Twieldu fl-1986	Kategori:Fødsler i 1986
Kategorija:Twieldu fl-1987	Kategori:Fødsler i 1987
Kategorija:Twieldu fl-1988	Kategori:Fødsler i 1988
Kategorija:Twieldu fl-1989	Kategori:Fødsler i 1989
Kategorija:Twieldu fl-1991	Kategori:Fødsler i 1991
Kategorija:Twieldu fl-1993	Kategori:Fødsler i 1993
Kategorija:Twieldu fl-1994	Kategori:Fødsler i 1994
Kategorija:Twieldu fl-1995	Kategori:Fødsler i 1995
Kategorija:Twieldu fl-1996	Kategori:Fødsler i 1996
Kategorija:Twieldu fl-1997	Kategori:Fødsler i 1997
Kategorija:Twieldu fl-1999	Kategori:Fødsler i 1999
Kategorija:Twieldu fl-2000	Kategori:Fødsler i 2000
Kategorija:1715	Kategori:1715
Kategorija:1797	Kategori:1797
Kategorija:1787	Kategori:1787
Kategorija:1539	Kategori:1539
Kategorija:1321	Kategori:1321
Mudell:Kwalifikazzjoni għat-Tazza tad-Dinja tal-Futbol 2010 (UEFA) - Grupp 2	Mal:Fotball-VM 2010 kvalik gruppe 2 UEFA tabell
Mudell:Kwalifikazzjoni għat-Tazza tad-Dinja tal-Futbol 2010 (UEFA) - Grupp 3	Mal:Fotball-VM 2010 kvalik gruppe 3 UEFA tabell
Mudell:Kwalifikazzjoni għat-Tazza tad-Dinja tal-Futbol 2010 (UEFA) - Grupp 4	Mal:Fotball-VM 2010 kvalik gruppe 4 UEFA tabell
Mudell:Kwalifikazzjoni għat-Tazza tad-Dinja tal-Futbol 2010 (UEFA) - Grupp 5	Mal:Fotball-VM 2010 kvalik gruppe 5 UEFA tabell
Mudell:Kwalifikazzjoni għat-Tazza tad-Dinja tal-Futbol 2010 (UEFA) - Grupp 6	Mal:Fotball-VM 2010 kvalik gruppe 6 UEFA tabell
Mudell:Kwalifikazzjoni għat-Tazza tad-Dinja tal-Futbol 2010 (UEFA) - Grupp 7	Mal:Fotball-VM 2010 kvalik gruppe 7 UEFA tabell
Mudell:Kwalifikazzjoni għat-Tazza tad-Dinja tal-Futbol 2010 (UEFA) - Grupp 8	Mal:Fotball-VM 2010 kvalik gruppe 8 UEFA tabell
Mudell:Kwalifikazzjoni għat-Tazza tad-Dinja tal-Futbol 2010 (UEFA) - Grupp 9	Mal:Fotball-VM 2010 kvalik gruppe 9 UEFA tabell
Mudell:Nowrap end	Mal:Nowrap end
Mudell:Tim ta' ACF Fiorentina	Mal:ACF Fiorentina spillerstall
Kategorija:Seklu 17	Kategori:1600-tallet
Kategorija:Deċennju tal-1260	Kategori:Hendelser i 1260-årene
Mudell:Tim ta' Arsenal FC	Mal:Arsenal
Kategorija:1182	Kategori:1182
Kategorija:1185	Kategori:1185
Kategorija:Proġetti tal-Wikimedia	Kategori:Wikimedia-prosjekter
Kategorija:1221	Kategori:1221
Mudell:Premier League Ażerbajġan	Mal:Azərbaycan Premyer Liqası
Kategorija:Plejers ta' Celta de Vigo	Kategori:Fotballspillere for Celta de Vigo
Mudell:Bar percent	Mal:Prosentstolpe
Mudell:Bk	Mal:Basketballflagg
Mudell:Tim ta' Bologna FC 1909	Mal:Bologna FC 1909 spillerstall
Kategorija:2014	Kategori:2014
Mudell:Skwadra Brażiljana Tazza tad-Dinja tal-Futbol 2010	Mal:Brasils lag i fotball-VM 2010
Mudell:Utent sv-3	Mal:Bruker sv-3
Mudell:Timijiet nazzjonali tal-CONMEBOL	Mal:CONMEBOL-landslag
Mudell:Fr	Mal:Fr icon
Kategorija:1515	Kategori:1515
Mudell:Twitter	Mal:Twitter
Kategorija:Mietu fl-1522	Kategori:Dødsfall i 1522
Kategorija:Portali	Kategori:Portaler
Kategorija:Mietu fl-1528	Kategori:Dødsfall i 1528
Kategorija:1533	Kategori:1533
Kategorija:1535	Kategori:1535
Kategorija:1546	Kategori:1546
Kategorija:1552	Kategori:1552
Kategorija:Futbolers Sud-Koreani	Kategori:Sørkoreanske fotballspillere
Kategorija:1580	Kategori:1580
Kategorija:Mietu fl-1580	Kategori:Dødsfall i 1580
Kategorija:1582	Kategori:1582
Kategorija:1595	Kategori:1595
Mudell:Utent af-3	Mal:Bruker af-3
Kategorija:1622	Kategori:1622
Kategorija:1642	Kategori:1642
Kategorija:Mietu fl-1642	Kategori:Dødsfall i 1642
Kategorija:Mietu fl-1660	Kategori:Dødsfall i 1660
Kategorija:1696	Kategori:1696
Kategorija:1699	Kategori:1699
Kategorija:1705	Kategori:1705
Kategorija:1726	Kategori:1726
Kategorija:Mietu fl-1726	Kategori:Dødsfall i 1726
Kategorija:Mietu fl-1727	Kategori:Dødsfall i 1727
Marie Louise Coleiro Preca	Marie Louise Coleiro Preca
Kategorija:Mietu fl-1748	Kategori:Dødsfall i 1748
Kategorija:Mietu fl-1757	Kategori:Dødsfall i 1757
Kategorija:Mietu fl-1759	Kategori:Dødsfall i 1759
Kategorija:Mietu fl-1760	Kategori:Dødsfall i 1760
Kategorija:1764	Kategori:1764
Kategorija:1767	Kategori:1767
Kategorija:1769	Kategori:1769
Kategorija:Mietu fl-1772	Kategori:Dødsfall i 1772
Kategorija:1779	Kategori:1779
Kategorija:Mietu fl-1782	Kategori:Dødsfall i 1782
Kategorija:Mietu fl-1787	Kategori:Dødsfall i 1787
Kategorija:Mietu fl-1789	Kategori:Dødsfall i 1789
Kategorija:Mietu fl-1790	Kategori:Dødsfall i 1790
Kategorija:1778	Kategori:1778
Mudell:Artiklu prinċipali	Mal:Utdypende artikkel
Mudell:Coord/dec2dms/dm	Mal:Koord/dec2dms/dm
Kategorija:Mudelli ta' kampjonati bl-eliminatorji	Kategori:Turneringsmaler
Mudell:Plejers fit-tim tal-futbol/tmiem	Mal:Fs end
Kategorija:Avvenimenti sportivi	Kategori:Sportsarrangementer
Kategorija:Avvenimenti sportivi futuri	Kategori:Fremtidige sportsarrangementer
Mudell:Plejers fit-tim tal-futbol/bidu	Mal:Fs start
Kategorija:Avvenimenti futuri	Kategori:Fremtidige hendelser
Kategorija:It-Tieni Gwerra Dinjija	Kategori:Andre verdenskrig
Kategorija:L-Ewwel Gwerra Dinjija	Kategori:Første verdenskrig
Kategorija:Plejers ta' AC Milan	Kategori:Fotballspillere for AC Milan
Kategorija:Logħob tal-mejda	Kategori:Brettspill
Kategorija:Mudelli ta' ċitazzjoni tas-sorsi	Kategori:Referansemaler
Mudell:Tim ta' FC Bayern Munich	Mal:Bayern München
Kategorija:Klabbs tal-futbol Albaniżi	Kategori:Fotballag i Albania
Kategorija:Kittieba Spanjoli	Kategori:Spanske forfattere
Kategorija:Klabbs tal-futbol Bjelorussi	Kategori:Fotballag i Hviterussland
Kategorija:Klabbs tal-futbol stabbiliti fl-1877	Kategori:Fotballag etablert i 1877
Kategorija:Klabbs tal-futbol stabbiliti fl-1878	Kategori:Fotballag etablert i 1878
Kategorija:Klabbs tal-futbol stabbiliti fl-1934	Kategori:Fotballag etablert i 1934
Kategorija:Klabbs tal-futbol stabbiliti fl-1935	Kategori:Fotballag etablert i 1935
Kategorija:Klabbs tal-futbol stabbiliti fl-1939	Kategori:Fotballag etablert i 1939
Kategorija:Klabbs tal-futbol stabbiliti fl-1943	Kategori:Fotballag etablert i 1943
Kategorija:Klabbs tal-futbol stabbiliti fl-1951	Kategori:Fotballag etablert i 1951
Kategorija:Klabbs tal-futbol stabbiliti fl-1957	Kategori:Fotballag etablert i 1957
Kategorija:Klabbs tal-futbol stabbiliti fl-1958	Kategori:Fotballag etablert i 1958
Kategorija:Klabbs tal-futbol stabbiliti fl-1959	Kategori:Fotballag etablert i 1959
Kategorija:Klabbs tal-futbol stabbiliti fl-1961	Kategori:Fotballag etablert i 1961
Kategorija:Klabbs tal-futbol stabbiliti fl-1962	Kategori:Fotballag etablert i 1962
Kategorija:Klabbs tal-futbol stabbiliti fl-1964	Kategori:Fotballag etablert i 1964
Kategorija:Klabbs tal-futbol stabbiliti fl-1968	Kategori:Fotballag etablert i 1968
Kategorija:Klabbs tal-futbol stabbiliti fl-1973	Kategori:Fotballag etablert i 1973
Kategorija:Klabbs tal-futbol stabbiliti fl-1977	Kategori:Fotballag etablert i 1977
Kategorija:Klabbs tal-futbol stabbiliti fl-1978	Kategori:Fotballag etablert i 1978
Kategorija:Klabbs tal-futbol stabbiliti fl-1982	Kategori:Fotballag etablert i 1982
Kategorija:Klabbs tal-futbol stabbiliti fl-1986	Kategori:Fotballag etablert i 1986
Kategorija:Klabbs tal-futbol stabbiliti fl-1987	Kategori:Fotballag etablert i 1987
Kategorija:Klabbs tal-futbol stabbiliti fl-1989	Kategori:Fotballag etablert i 1989
Kategorija:Klabbs tal-futbol stabbiliti fl-1990	Kategori:Fotballag etablert i 1990
Kategorija:Klabbs tal-futbol stabbiliti fl-1992	Kategori:Fotballag etablert i 1992
Kategorija:Klabbs tal-futbol stabbiliti fl-1995	Kategori:Fotballag etablert i 1995
Kategorija:Klabbs tal-futbol stabbiliti fl-1999	Kategori:Fotballag etablert i 1999
Kategorija:Klabbs tal-futbol stabbiliti fl-2000	Kategori:Fotballag etablert i 2000
Kategorija:Klabbs tal-futbol stabbiliti fl-2001	Kategori:Fotballag etablert i 2001
Kategorija:Klabbs tal-futbol stabbiliti fl-2002	Kategori:Fotballag etablert i 2002
Kategorija:Klabbs tal-futbol stabbiliti fl-2004	Kategori:Fotballag etablert i 2004
Kategorija:Klabbs tal-futbol stabbiliti fl-2005	Kategori:Fotballag etablert i 2005
Kategorija:Klabbs tal-futbol stabbiliti skont is-sena	Kategori:Fotballag etter etableringsår
Kategorija:Klabbs tal-futbol Latvjani	Kategori:Fotballag i Latvia
Kategorija:Klabbs tal-futbol Maltin	Kategori:Fotballag på Malta
Mudell:Round8	Mal:Fotballkvartfinaler
Mudell:Tim ta' Chelsea FC	Mal:Chelsea
Kategorija:Mietu fl-1937	Kategori:Dødsfall i 1937
Kategorija:Mietu fl-1950	Kategori:Dødsfall i 1950
Kategorija:Angola	Kategori:Angola
Kategorija:Libja	Kategori:Libya
Kategorija:Marokk	Kategori:Marokko
Kategorija:1480	Kategori:1480
Kategorija:Mietu fl-1595	Kategori:Dødsfall i 1595
Kategorija:Mietu fl-1597	Kategori:Dødsfall i 1597
Kategorija:1610	Kategori:1610
Kategorija:Mietu fl-1610	Kategori:Dødsfall i 1610
Mudell:Kaxxa ġenb	Mal:Sideboks
Kategorija:Unuri u trofej sportivi	Kategori:Idrettspriser
Kategorija:Mietu fl-2011	Kategori:Dødsfall i 2011
Kategorija:Kantanti Taljani	Kategori:Italienske sangere
Kategorija:Mietu fl-1546	Kategori:Dødsfall i 1546
Kategorija:1724	Kategori:1724
Kategorija:1748	Kategori:1748
Kategorija:1749	Kategori:1749
Kategorija:1750	Kategori:1750
Kategorija:Mietu fl-1750	Kategori:Dødsfall i 1750
Kategorija:1756	Kategori:1756
Kategorija:1757	Kategori:1757
Kategorija:1758	Kategori:1758
Kategorija:1759	Kategori:1759
Kategorija:1760	Kategori:1760
Kategorija:1770	Kategori:1770
Kategorija:1772	Kategori:1772
Kategorija:1773	Kategori:1773
Kategorija:Pajjiżi stabbiliti fl-1813	Kategori:Stater og territorier etablert i 1813
Kategorija:1782	Kategori:1782
Kategorija:Pajjiżi stabbiliti fl-1814	Kategori:Stater og territorier etablert i 1814
Kategorija:1786	Kategori:1786
Kategorija:1791	Kategori:1791
Kategorija:Mietu fl-1791	Kategori:Dødsfall i 1791
Kategorija:1792	Kategori:1792
Kategorija:Mietu fl-1792	Kategori:Dødsfall i 1792
Kategorija:1794	Kategori:1794
Kategorija:1801	Kategori:1801
Kategorija:1803	Kategori:1803
Kategorija:1804	Kategori:1804
Kategorija:Mietu fl-1804	Kategori:Dødsfall i 1804
Kategorija:1807	Kategori:1807
Kategorija:Mietu fl-1807	Kategori:Dødsfall i 1807
Kategorija:1809	Kategori:1809
Kategorija:1813	Kategori:1813
Kategorija:1815	Kategori:1815
Kategorija:1818	Kategori:1818
Kategorija:Mietu fl-1818	Kategori:Dødsfall i 1818
Kategorija:Mietu fl-1821	Kategori:Dødsfall i 1821
Kategorija:1827	Kategori:1827
Kategorija:Mietu fl-1828	Kategori:Dødsfall i 1828
Kategorija:1830	Kategori:1830
Kategorija:Mietu fl-1832	Kategori:Dødsfall i 1832
Kategorija:1835	Kategori:1835
Kategorija:1840	Kategori:1840
Kategorija:1842	Kategori:1842
Kategorija:Mietu fl-1842	Kategori:Dødsfall i 1842
Kategorija:1846	Kategori:1846
Kategorija:1847	Kategori:1847
Kategorija:Mietu fl-1847	Kategori:Dødsfall i 1847
Kategorija:1848	Kategori:1848
Kategorija:1849	Kategori:1849
Kategorija:1852	Kategori:1852
Kategorija:1853	Kategori:1853
Kategorija:1854	Kategori:1854
Kategorija:1859	Kategori:1859
Kategorija:Mietu fl-1859	Kategori:Dødsfall i 1859
Kategorija:1860	Kategori:1860
Kategorija:1861	Kategori:1861
Kategorija:Mietu fl-1861	Kategori:Dødsfall i 1861
Kategorija:1862	Kategori:1862
Kategorija:1864	Kategori:1864
Kategorija:1866	Kategori:1866
Kategorija:1869	Kategori:1869
Kategorija:Mietu fl-1869	Kategori:Dødsfall i 1869
Kategorija:1870	Kategori:1870
Kategorija:1871	Kategori:1871
Kategorija:1872	Kategori:1872
Kategorija:Mietu fl-1873	Kategori:Dødsfall i 1873
Kategorija:1874	Kategori:1874
Kategorija:1875	Kategori:1875
Kategorija:1876	Kategori:1876
Kategorija:1877	Kategori:1877
Kategorija:1879	Kategori:1879
Kategorija:1880	Kategori:1880
Kategorija:1881	Kategori:1881
Kategorija:1882	Kategori:1882
Kategorija:1883	Kategori:1883
Kategorija:1884	Kategori:1884
Kategorija:1885	Kategori:1885
Kategorija:1886	Kategori:1886
Kategorija:1887	Kategori:1887
Kategorija:1889	Kategori:1889
Kategorija:1890	Kategori:1890
Kategorija:Mietu fl-1890	Kategori:Dødsfall i 1890
Kategorija:1891	Kategori:1891
Kategorija:1892	Kategori:1892
Kategorija:1893	Kategori:1893
Kategorija:Mietu fl-1893	Kategori:Dødsfall i 1893
Kategorija:1894	Kategori:1894
Kategorija:Mietu fl-1894	Kategori:Dødsfall i 1894
Kategorija:1895	Kategori:1895
Kategorija:Mietu fl-1895	Kategori:Dødsfall i 1895
Kategorija:1897	Kategori:1897
Kategorija:Mietu fl-1897	Kategori:Dødsfall i 1897
Kategorija:Mietu fl-1898	Kategori:Dødsfall i 1898
Kategorija:1899	Kategori:1899
Kategorija:Mietu fl-1900	Kategori:Dødsfall i 1900
Kategorija:Mietu fl-1901	Kategori:Dødsfall i 1901
Kategorija:Mietu fl-1905	Kategori:Dødsfall i 1905
Kategorija:Mietu fl-1915	Kategori:Dødsfall i 1915
Kategorija:Mietu fl-1916	Kategori:Dødsfall i 1916
Kategorija:Mietu fl-1917	Kategori:Dødsfall i 1917
Kategorija:Mietu fl-1918	Kategori:Dødsfall i 1918
Kategorija:Mietu fl-1920	Kategori:Dødsfall i 1920
Kategorija:Mietu fl-1921	Kategori:Dødsfall i 1921
Kategorija:Mietu fl-1925	Kategori:Dødsfall i 1925
Kategorija:Mietu fl-1926	Kategori:Dødsfall i 1926
Kategorija:Mietu fl-1927	Kategori:Dødsfall i 1927
Kategorija:Mietu fl-1935	Kategori:Dødsfall i 1935
Kategorija:Mietu fl-1936	Kategori:Dødsfall i 1936
Kategorija:Mietu fl-1939	Kategori:Dødsfall i 1939
Kategorija:Mietu fl-1940	Kategori:Dødsfall i 1940
Kategorija:Mietu fl-1954	Kategori:Dødsfall i 1954
Kategorija:1961	Kategori:1961
Kategorija:1964	Kategori:1964
Kategorija:Mietu fl-1964	Kategori:Dødsfall i 1964
Kategorija:1965	Kategori:1965
Kategorija:1966	Kategori:1966
Kategorija:1967	Kategori:1967
Kategorija:Mietu fl-1967	Kategori:Dødsfall i 1967
Kategorija:Mietu fl-1968	Kategori:Dødsfall i 1968
Kategorija:1969	Kategori:1969
Kategorija:1970	Kategori:1970
Kategorija:Mietu fl-1970	Kategori:Dødsfall i 1970
Kategorija:Mietu fl-1971	Kategori:Dødsfall i 1971
Kategorija:1972	Kategori:1972
Kategorija:Mietu fl-1972	Kategori:Dødsfall i 1972
Kategorija:1973	Kategori:1973
Kategorija:Mietu fl-1973	Kategori:Dødsfall i 1973
Kategorija:1974	Kategori:1974
Kategorija:1975	Kategori:1975
Kategorija:1976	Kategori:1976
Kategorija:Mietu fl-1977	Kategori:Dødsfall i 1977
Kategorija:1978	Kategori:1978
Kategorija:1979	Kategori:1979
Kategorija:1980	Kategori:1980
Kategorija:1981	Kategori:1981
Kategorija:1982	Kategori:1982
Kategorija:Mietu fl-1982	Kategori:Dødsfall i 1982
Kategorija:1983	Kategori:1983
Kategorija:Mietu fl-1983	Kategori:Dødsfall i 1983
Kategorija:1984	Kategori:1984
Kategorija:Mietu fl-1984	Kategori:Dødsfall i 1984
Kategorija:1985	Kategori:1985
Kategorija:1986	Kategori:1986
Kategorija:1987	Kategori:1987
Kategorija:Mietu fl-1987	Kategori:Dødsfall i 1987
Kategorija:1988	Kategori:1988
Kategorija:1989	Kategori:1989
Kategorija:Mietu fl-1989	Kategori:Dødsfall i 1989
Kategorija:1990	Kategori:1990
Kategorija:Mietu fl-1990	Kategori:Dødsfall i 1990
Kategorija:1991	Kategori:1991
Kategorija:1992	Kategori:1992
Kategorija:1993	Kategori:1993
Kategorija:1994	Kategori:1994
Kategorija:1995	Kategori:1995
Kategorija:Mietu fl-1995	Kategori:Dødsfall i 1995
Kategorija:Fußball-Bundesliga	Kategori:Bundesliga
Kategorija:1996	Kategori:1996
Kategorija:Mietu fl-1996	Kategori:Dødsfall i 1996
Kategorija:1997	Kategori:1997
Kategorija:Mietu fl-1997	Kategori:Dødsfall i 1997
Kategorija:1999	Kategori:1999
Kategorija:2000	Kategori:2000
Kategorija:Mietu fl-2000	Kategori:Dødsfall i 2000
Kategorija:2001	Kategori:2001
Kategorija:Mietu fl-2001	Kategori:Dødsfall i 2001
Kategorija:2002	Kategori:2002
Kategorija:Mietu fl-2002	Kategori:Dødsfall i 2002
Kategorija:Mietu fl-2003	Kategori:Dødsfall i 2003
Kategorija:2004	Kategori:2004
Kategorija:Mietu fl-2004	Kategori:Dødsfall i 2004
Kategorija:2005	Kategori:2005
Kategorija:2006	Kategori:2006
Kategorija:Mietu fl-2006	Kategori:Dødsfall i 2006
Kategorija:2007	Kategori:2007
Kategorija:2008	Kategori:2008
Kategorija:2009	Kategori:2009
Kategorija:2010	Kategori:2010
Kategorija:2011	Kategori:2011
Kategorija:Ajruporti skont il-pajjiż	Kategori:Flyplasser etter område
Kategorija:Pajjiżi gżejjer	Kategori:Øystater
Kategorija:Pajjiżi interkjużi	Kategori:Innlandsstater
Kategorija:Politika ta' Malta	Kategori:Maltesisk politikk
Kategorija:Ġurnalisti Franċiżi	Kategori:Franske journalister
Kategorija:Grawnds tal-futbol fl-Italja	Kategori:Fotballstadioner i Italia
Kategorija:Futbol fil-Gambja	Kategori:Fotball i Gambia
Kategorija:Futbol fil-Greċja	Kategori:Fotball i Hellas
Kategorija:Futbol fin-Niġerja	Kategori:Fotball i Nigeria
Kategorija:Futbol fl-Afrika t'Isfel	Kategori:Fotball i Sør-Afrika
Kategorija:Futbol fil-Latvja	Kategori:Fotball i Latvia
Kategorija:Futbol fir-Rumanija	Kategori:Fotball i Romania
Kategorija:Futbol fil-Litwanja	Kategori:Fotball i Litauen
Kategorija:Futbol fil-Montenegro	Kategori:Fotball i Montenegro
Kategorija:Futbol f'Malta	Kategori:Fotball på Malta
Kategorija:Futbol fl-Istati Uniti	Kategori:Fotball i USA
Kategorija:Futbol fil-Belġju	Kategori:Fotball i Belgia
Kategorija:Futbol fil-Bożnija u Ħerżegovina	Kategori:Fotball i Bosnia-Hercegovina
Kategorija:Futbol fil-Bulgarija	Kategori:Fotball i Bulgaria
Kategorija:Futbol fis-Serbja	Kategori:Fotball i Serbia
Kategorija:Futbol fl-Unjoni Sovjetika	Kategori:Fotball i Sovjetunionen
Kategorija:Futbol fl-Iżvizzera	Kategori:Fotball i Sveits
Kategorija:Futbol fl-Iskozja	Kategori:Fotball i Skottland
Kategorija:Futbol fis-Slovakkja	Kategori:Fotball i Slovakia
Kategorija:Futbol fl-Arġentina	Kategori:Fotball i Argentina
Kategorija:Futbol fl-Iżlanda	Kategori:Fotball på Island
Kategorija:Futbol fl-Irlanda	Kategori:Fotball i Irland
Kategorija:Futbol fl-Albanija	Kategori:Fotball i Albania
Kategorija:Futbol fl-Angola	Kategori:Fotball i Angola
Kategorija:Futbol fl-Estonja	Kategori:Fotball i Estland
Kategorija:Futbol fl-Awstralja	Kategori:Fotball i Australia
Kategorija:Futbol f'Wales	Kategori:Fotball i Wales
Kategorija:Futbol fl-Iżrael	Kategori:Fotball i Israel
Kategorija:Futbol fiċ-Ċina	Kategori:Fotball i Kina
Kategorija:Futbol fil-Kamerun	Kategori:Fotball i Kamerun
Kategorija:Futbol fil-Kosta tal-Avorju	Kategori:Fotball i Elfenbenskysten
Kategorija:Futbol f'Ċipru	Kategori:Fotball på Kypros
Mudell:Utent be	Mal:Bruker be
Kategorija:Presidenti tar-Royal Society	Kategori:Presidenter i Royal Society
Mudell:Utent ru-1	Mal:Bruker ru-1
Mudell:Utent uk-4	Mal:Bruker uk-4
Mudell:Utent zh-1	Mal:Bruker zh-1
Kategorija:Mużiċisti skont in-nazzjonalità	Kategori:Musikere etter nasjonalitet
Kategorija:Filosfi skont in-nazzjonalità	Kategori:Filosofer etter nasjonalitet
Kategorija:Storja ta' Malta	Kategori:Maltas historie
Kategorija:Futbol fil-Gana	Kategori:Fotball i Ghana
Kategorija:Futbol fl-Olanda	Kategori:Fotball i Nederland
Kategorija:Futbol fin-Norveġja	Kategori:Fotball i Norge
Kategorija:Futbol fil-Ġermanja	Kategori:Fotball i Tyskland
Kategorija:Futbol fil-Bjelorussja	Kategori:Fotball i Hviterussland
Kategorija:Futbol fl-Irlanda ta' Fuq	Kategori:Fotball i Nord-Irland
Kategorija:Futbol fil-Brażil	Kategori:Fotball i Brasil
Kategorija:Futbol fl-Armenja	Kategori:Fotball i Armenia
Kategorija:Futbol fl-Ażerbajġan	Kategori:Fotball i Aserbajdsjan
Kategorija:Futbol fl-Awstrija	Kategori:Fotball i Østerrike
Kategorija:Futbol fl-Urugwaj	Kategori:Fotball i Uruguay
Kategorija:Futbol fl-Italja	Kategori:Fotball i Italia
Kategorija:Futbol fl-Ingilterra	Kategori:Fotball i England
Kategorija:Futbol fir-Repubblika Ċeka	Kategori:Fotball i Tsjekkia
Kategorija:Futbol fil-Każakistan	Kategori:Fotball i Kasakhstan
Kategorija:Futbol fil-Kolombja	Kategori:Fotball i Colombia
Kategorija:Futbol fit-Turkija	Kategori:Fotball i Tyrkia
Kategorija:Futbol fil-Portugall	Kategori:Fotball i Portugal
Kategorija:Futbol fl-Ungerija	Kategori:Fotball i Ungarn
Mudell:TwoLegResult	Mal:TwoLegResult
Kategorija:Festival tal-Eurovision	Kategori:Eurovision Song Contest
Kategorija:Kowċis Arġentini	Kategori:Argentinske fotballtrenere
Kategorija:Kowċis Awstrijaċi	Kategori:Østerrikske fotballtrenere
Kategorija:Kowċis Belġjani	Kategori:Belgiske fotballtrenere
Kategorija:Kowċis Brażiljani	Kategori:Brasilianske fotballtrenere
Kategorija:Kowċis Ingliżi	Kategori:Engelske fotballtrenere
Kategorija:Kowċis Skoċċiżi	Kategori:Skotske fotballtrenere
Kategorija:Teatru	Kategori:Teater
Kategorija:Kowċis Kroati	Kategori:Kroatiske fotballtrenere
Kategorija:Kowċis Ġermaniżi	Kategori:Tyske fotballtrenere
Kategorija:Kantanti skont in-nazzjonalità	Kategori:Sangere etter nasjonalitet
Kategorija:Kowċis Rumeni	Kategori:Rumenske fotballtrenere
Kategorija:Kowċis Spanjoli	Kategori:Spanske fotballtrenere
Kategorija:Futbolers Albaniżi	Kategori:Albanske fotballspillere
Kategorija:Futbolers Angoliżi	Kategori:Angolanske fotballspillere
Kategorija:Futbolers Arġentini	Kategori:Argentinske fotballspillere
Kategorija:Futbolers Armeni	Kategori:Armenske fotballspillere
Kategorija:Futbolers Awstraljani	Kategori:Australske fotballspillere
Kategorija:Futbolers Awstrijaċi	Kategori:Østerrikske fotballspillere
Kategorija:Futbolers Bożnijaċi	Kategori:Bosniske fotballspillere
Kategorija:Futbolers Brażiljani	Kategori:Brasilianske fotballspillere
Kategorija:Futbolers Ingliżi	Kategori:Engelske fotballspillere
Kategorija:Mudelli ta' diżambigwazzjoni u riindirizzi	Kategori:Maler for omdirigering og flertydighet
Mudell:Newtrali	Mal:Nøytral
Kategorija:Kantanti Żvediżi	Kategori:Svenske sangere
Kategorija:Kantanti Iżraeljani	Kategori:Israelske sangere
Kategorija:Kantanti Pollakki	Kategori:Polske sangere
Kategorija:Kantanti Franċiżi	Kategori:Franske sangere
Kategorija:Utenti nl	Kategori:Bruker nl
Kategorija:Utenti nn-3	Kategori:Bruker nn-3
Kategorija:Utenti no-2	Kategori:Bruker no-2
Kategorija:Utenti no	Kategori:Bruker no
Kategorija:Utenti zh-1	Kategori:Bruker zh-1
Kategorija:Armenja	Kategori:Armenia
Kategorija:Fiżiċi Brittaniċi	Kategori:Britiske fysikere
Kategorija:Pajjiżi stabbiliti fl-1297	Kategori:Stater og territorier etablert i 1297
Kategorija:Pajjiżi stabbiliti fl-1992	Kategori:Stater og territorier etablert i 1992
Kategorija:Atturi Taljani	Kategori:Italienske skuespillere
Kategorija:Pajjiżi skond is-sena li ġew stabbiliti	Kategori:Stater og territorier etter etableringsår
Kategorija:Finanza	Kategori:Finans
Kategorija:Diskografiji	Kategori:Diskografier
Kategorija:Kompetizzjonijiet tal-futbol	Kategori:Fotballturneringer
Kategorija:Sports għal persuni b'diżabbilità	Kategori:Handikappidrett
Kategorija:Sports ta' studenti	Kategori:Studentidrett
Kategorija:Televiżjoni	Kategori:TV
Kategorija:Prim Ministri ta' Malta	Kategori:Maltas statsministre
Kategorija:Mietu fl-1945	Kategori:Dødsfall i 1945
Kategorija:Mietu fl-1963	Kategori:Dødsfall i 1963
Kategorija:1832	Kategori:1832
Kategorija:Mietu fl-1930	Kategori:Dødsfall i 1930
Kategorija:1822	Kategori:1822
Kategorija:Skulturi	Kategori:Billedhuggere
Kategorija:Seklu 14	Kategori:1300-tallet
Kategorija:Sekli	Kategori:Århundrer
Kategorija:Seklu 13	Kategori:1200-tallet
Kategorija:Seklu 16	Kategori:1500-tallet
Kategorija:Seklu 12	Kategori:1100-tallet
Kategorija:Seklu 18	Kategori:1700-tallet
Kategorija:Kompożituri Russi	Kategori:Russiske komponister
Kategorija:Kompożituri Franċiżi	Kategori:Franske komponister
Kategorija:Kompożituri Barokki	Kategori:Barokkomponister
Kategorija:Kompożituri Pollakki	Kategori:Polske komponister
Kategorija:Kompożituri Ġermaniżi	Kategori:Tyske komponister
Kategorija:Kompożituri Awstrijaċi	Kategori:Østerrikske komponister
Kategorija:Mużiċisti Pollakki	Kategori:Polske musikere
Kategorija:Skulturi Taljani	Kategori:Italienske billedhuggere
Kategorija:Storiċi Russi	Kategori:Russiske historikere
Kategorija:Mużiċisti Norveġiżi	Kategori:Norske musikere
Kategorija:Mużiċisti Daniżi	Kategori:Danske musikere
Kategorija:Mużiċisti Russi	Kategori:Russiske musikere
Kategorija:Mużiċisti Brażiljani	Kategori:Brasilianske musikere
Kategorija:Mużiċisti Żvediżi	Kategori:Svenske musikere
Kategorija:Mużiċisti Irlandiżi	Kategori:Irske musikere
Kategorija:Mużiċisti Brittaniċi	Kategori:Britiske musikere
Kategorija:Mużiċisti Taljani	Kategori:Italienske musikere
Kategorija:Mużiċisti Kanadiżi	Kategori:Canadiske musikere
Kategorija:Mużiċisti Franċiżi	Kategori:Franske musikere
Kategorija:1829	Kategori:1829
Kategorija:Kompożituri Taljani	Kategori:Italienske komponister
Kategorija:Mużiċisti Ġermaniżi	Kategori:Tyske musikere
Kategorija:Politiċi Maltin	Kategori:Maltesiske politikere
Kategorija:Politiċi Taljani	Kategori:Italienske politikere
Kategorija:Politiċi Franċiżi	Kategori:Franske politikere
Kategorija:Filosfi Griegi	Kategori:Greske filosofer
Kategorija:Filosfi Ġermaniżi	Kategori:Tyske filosofer
Kategorija:Filosfi Brittaniċi	Kategori:Britiske filosofer
Kategorija:Bavarja	Kategori:Bayern
Kategorija:Futbolers Niġerjani	Kategori:Nigerianske fotballspillere
Kategorija:Futbolers Rumeni	Kategori:Rumenske fotballspillere
Kategorija:Futbolers Bulgari	Kategori:Bulgarske fotballspillere
Kategorija:Futbolers Żvediżi	Kategori:Svenske fotballspillere
Kategorija:Futbolers Skoċċiżi	Kategori:Skotske fotballspillere
Kategorija:Futbolers Ekwadorjani	Kategori:Ecuadorianske fotballspillere
Kategorija:Futbolers Urugwajani	Kategori:Uruguayanske fotballspillere
Kategorija:Futbolers Eġizzjani	Kategori:Egyptiske fotballspillere
Kategorija:Futbolers Ċiniżi	Kategori:Kinesiske fotballspillere
Kategorija:Futbolers Franċiżi	Kategori:Franske fotballspillere
Kategorija:Teorija tal-logħob	Kategori:Spillteori
Kategorija:1789	Kategori:1789
Kategorija:Mietu fl-1809	Kategori:Dødsfall i 1809
Kategorija:1821	Kategori:1821
Kategorija:1828	Kategori:1828
Kategorija:1841	Kategori:1841
Kategorija:1867	Kategori:1867
Kategorija:1873	Kategori:1873
Kategorija:1878	Kategori:1878
Kategorija:1896	Kategori:1896
Kategorija:1963	Kategori:1963
Kategorija:Mietu fl-1981	Kategori:Dødsfall i 1981
Kategorija:Mietu fl-1999	Kategori:Dødsfall i 1999
Kategorija:2012	Kategori:2012
Kategorija:Sportivi Sud-Koreani	Kategori:Sørkoreanske sportsutøvere
Kategorija:Imprendituri Amerikani	Kategori:Forretningsfolk fra USA
Kategorija:Inventuri Brittaniċi	Kategori:Britiske oppfinnere
Kategorija:Futbolers Torok	Kategori:Tyrkiske fotballspillere
Kategorija:Futbolers Montenegrini	Kategori:Montenegrinske fotballspillere
Kategorija:Futbolers Żvizzeri	Kategori:Sveitsiske fotballspillere
Kategorija:Futbolers Spanjoli	Kategori:Spanske fotballspillere
Kategorija:Futbolers Ungeriżi	Kategori:Ungarske fotballspillere
Kategorija:Futbolers Serbi	Kategori:Serbiske fotballspillere
Kategorija:Futbolers Taljani	Kategori:Italienske fotballspillere
Kategorija:Futbolers Daniżi	Kategori:Danske fotballspillere
Kategorija:Futbolers Galliċi	Kategori:Walisiske fotballspillere
Kategorija:Futbolers Nord-Irlandiżi	Kategori:Nordirske fotballspillere
Kategorija:Futbolers Irlandiżi	Kategori:Irske fotballspillere
Kategorija:Futbolers Kolombjani	Kategori:Colombianske fotballspillere
Kategorija:Futbolers Kroati	Kategori:Kroatiske fotballspillere
Kategorija:Futbolers Portugiżi	Kategori:Portugisiske fotballspillere
Kategorija:Kantanti Norveġiżi	Kategori:Norske sangere
Kategorija:Kantanti Brażiljani	Kategori:Brasilianske sangere
Kategorija:Kantanti Russi	Kategori:Russiske sangere
Kategorija:Kantanti Daniżi	Kategori:Danske sangere
Kategorija:Denominazzjonijiet Kristjani	Kategori:Kristne samfunn
Kategorija:Abbozzi tal-militar	Kategori:Militærstubber
Kategorija:Abbozzi tal-matematika	Kategori:Matematikkstubber
Kategorija:Abbozzi tal-bijoloġija	Kategori:Biologistubber
Kategorija:Abbozzi tal-ġeografija	Kategori:Geografistubber
Kategorija:Seklu 15	Kategori:1400-tallet
Kategorija:Mietu fis-seklu 16	Kategori:Dødsfall på 1500-tallet
Kategorija:Mietu fis-seklu 17	Kategori:Dødsfall på 1600-tallet
Kategorija:Mietu fis-seklu 18	Kategori:Dødsfall på 1700-tallet
Kategorija:Mietu fis-seklu 19	Kategori:Dødsfall på 1800-tallet
Kategorija:Mietu fis-seklu 20	Kategori:Dødsfall på 1900-tallet
Kategorija:Mietu fis-seklu 21	Kategori:Dødsfall på 2000-tallet
Kategorija:Futbol fi New Zealand	Kategori:Fotball på New Zealand
Kategorija:Futbol fil-Messiku	Kategori:Fotball i Mexico
Kategorija:Futbol fl-Iżvezja	Kategori:Fotball i Sverige
Kategorija:Futbol fl-Ukrajna	Kategori:Fotball i Ukraina
Kategorija:Futbol fil-Kroazja	Kategori:Fotball i Kroatia
Kategorija:Futbol fi Franza	Kategori:Fotball i Frankrike
Kategorija:Ġeorġja	Kategori:Georgia
Kategorija:Taljani skont ix-xogħol tagħhom	Kategori:Italienere etter beskjeftigelse
Kategorija:Kantanti Amerikani	Kategori:Sangere fra USA
Kategorija:Bijoloġi Brittaniċi	Kategori:Britiske biologer
Kategorija:Mużiċisti Żvizzeri	Kategori:Sveitsiske musikere
Kategorija:Mużiċisti Armeni	Kategori:Armenske musikere
Kategorija:Mużiċisti Ażerbajġani	Kategori:Aserbajdsjanske musikere
Kategorija:Mużiċisti Iżraeljani	Kategori:Israelske musikere
Kategorija:Ġeoloġi Brittaniċi	Kategori:Britiske geologer
Kategorija:Futbolers Ganiżi	Kategori:Ghanesiske fotballspillere
Kategorija:1727	Kategori:1727
Kategorija:1744	Kategori:1744
Kategorija:1808	Kategori:1808
Kategorija:1824	Kategori:1824
Kategorija:Mietu fl-1835	Kategori:Dødsfall i 1835
Kategorija:Mietu fl-1868	Kategori:Dødsfall i 1868
Kategorija:Mietu fl-1888	Kategori:Dødsfall i 1888
Kategorija:Mietu fl-1933	Kategori:Dødsfall i 1933
Kategorija:Mietu fl-1961	Kategori:Dødsfall i 1961
Kategorija:1968	Kategori:1968
Kategorija:Futbol fir-Russja	Kategori:Fotball i Russland
Kategorija:Futbol fl-Ekwador	Kategori:Fotball i Ecuador
Kategorija:Futbol fl-Eġittu	Kategori:Fotball i Egypt
Kategorija:Plejers ta' FC Spartak Moscow	Kategori:Fotballspillere for FK Spartak Moskva
Kategorija:Futbol fl-Andorra	Kategori:Fotball i Andorra
Kategorija:Nies Maltin	Kategori:Maltesere
Kategorija:Matematiċi Brittaniċi	Kategori:Britiske matematikere
Kategorija:Mużiċisti Belġjani	Kategori:Belgiske musikere
Kategorija:Futbolers Gambjani	Kategori:Gambiske fotballspillere
Kategorija:Futbolers Griegi	Kategori:Greske fotballspillere
Kategorija:Futbolers Sud-Afrikani	Kategori:Sørafrikanske fotballspillere
Kategorija:Futbolers Litwani	Kategori:Litauiske fotballspillere
Kategorija:Futbolers Maċedoni	Kategori:Makedonske fotballspillere
Kategorija:Futbolers Maltin	Kategori:Maltesiske fotballspillere
Kategorija:Futbolers Senegaliżi	Kategori:Senegalesiske fotballspillere
Kategorija:Futbolers Iżlandiżi	Kategori:Islandske fotballspillere
Kategorija:Futbolers Iżraeljani	Kategori:Israelske fotballspillere
Kategorija:Futbolers Kamerunjani	Kategori:Kamerunske fotballspillere
Kategorija:1817	Kategori:1817
Kategorija:1898	Kategori:1898
Kategorija:1998	Kategori:1998
Kategorija:Libanu	Kategori:Libanon
Kategorija:Mietu fis-seklu 15	Kategori:Dødsfall på 1400-tallet
Kategorija:Kantanti Ġermaniżi	Kategori:Tyske sangere
Kategorija:Kantanti Belġjani	Kategori:Belgiske sangere
Kategorija:Mużiċisti Iżlandiżi	Kategori:Islandske musikere
Kategorija:Kompożituri Irlandiżi	Kategori:Irske komponister
Kategorija:Futbolers Messikani	Kategori:Meksikanske fotballspillere
Kategorija:2003	Kategori:2003
Kategorija:Mietu fis-seklu 14	Kategori:Dødsfall på 1300-tallet
Kategorija:Futbol fid-Danimarka	Kategori:Fotball i Danmark
Kategorija:Xjenzati Brittaniċi	Kategori:Britiske forskere
Kategorija:Mudelli tal-klabbs tal-futbol Taljani	Kategori:Italienske spillerstallmaler for fotball
Kategorija:1971	Kategori:1971
Kategorija:Mietu fis-seklu 13	Kategori:Dødsfall på 1200-tallet
Kategorija:Mudelli kkumplikati	Kategori:Kompliserte maler
Kategorija:Abbozzi tal-politika	Kategori:Politikkstubber
Kategorija:Abbozzi tal-astronomija	Kategori:Astronomistubber
Kategorija:Abbozzi tal-istorja	Kategori:Historiestubber
Kategorija:Abbozzi tal-arti	Kategori:Kunststubber
Kategorija:Abbozzi tar-reliġjon	Kategori:Religionsstubber
Mudell:Utent de-4	Mal:Bruker de-4
Kategorija:Abbozzi tal-ekonomija	Kategori:Økonomistubber
Kategorija:Plejers ta' PSV Eindhoven	Kategori:Fotballspillere for PSV Eindhoven
Kategorija:Plejers ta' Aston Villa FC	Kategori:Fotballspillere for Aston Villa FC
Kategorija:Plejers ta' CA Osasuna	Kategori:Fotballspillere for CA Osasuna
Kategorija:Plejers ta' AFC Ajax	Kategori:Fotballspillere for AFC Ajax
Kategorija:Plejers ta' MSV Duisburg	Kategori:Fotballspillere for MSV Duisburg
Kategorija:Plejers ta' Empoli FC	Kategori:Fotballspillere for Empoli FC
Kategorija:Plejers ta' Eintracht Braunschweig	Kategori:Fotballspillere for Eintracht Braunschweig
Kategorija:Futbolers fil-Bulgarija skont il-klabb	Kategori:Fotballspillere i Bulgaria etter klubb
Kategorija:Plejers ta' Red Star Belgrade	Kategori:Fotballspillere for Røde Stjerne Beograd
Kategorija:Plejers ta' FC Basel	Kategori:Fotballspillere for FC Basel
Kategorija:Plejers ta' Bayer 04 Leverkusen	Kategori:Fotballspillere for TSV Bayer 04 Leverkusen
Kategorija:Plejers ta' Birmingham City FC	Kategori:Fotballspillere for Birmingham City FC
Kategorija:Plejers ta' Blackburn Rovers FC	Kategori:Fotballspillere for Blackburn Rovers FC
Kategorija:Plejers ta' VfL Bochum	Kategori:Fotballspillere for Vfl Bochum 1848
Kategorija:Plejers ta' Portsmouth FC	Kategori:Fotballspillere for Portsmouth FC
Kategorija:Plejers ta' Borussia Dortmund	Kategori:Fotballspillere for BV Borussia 09 Dortmund
Kategorija:Plejers ta' Bolton Wanderers FC	Kategori:Fotballspillere for Bolton Wanderers FC
Kategorija:Plejers ta' Piacenza Calcio	Kategori:Fotballspillere for Piacenza Calcio
Kategorija:Plejers ta' Charlton Athletic FC	Kategori:Fotballspillere for Charlton Athletic FC
Kategorija:Plejers ta' Torino FC	Kategori:Fotballspillere for Torino FC
Kategorija:Plejers ta' Genoa CFC	Kategori:Fotballspillere for Genoa CFC
Kategorija:Plejers ta' FC Dynamo Moscow	Kategori:Fotballspillere for FK Dynamo Moskva
Kategorija:Plejers ta' Stade de Reims	Kategori:Fotballspillere for Stade de Reims
Kategorija:Plejers ta' Racing de Santander	Kategori:Fotballspillere for Racing Santander
Kategorija:Plejers ta' Real Valladolid	Kategori:Fotballspillere for Real Valladolid
Kategorija:Plejers ta' R. Charleroi SC	Kategori:Fotballspillere for Royal Charleroi SC
Kategorija:Plejers ta' Sporting de Gijón	Kategori:Fotballspillere for Real Sporting de Gijón SAD
Kategorija:Plejers ta' Real Sociedad	Kategori:Fotballspillere for Real Sociedad
Kategorija:Plejers ta' RCD Mallorca	Kategori:Fotballspillere for RCD Mallorca
Kategorija:Plejers ta' Recreativo de Huelva	Kategori:Fotballspillere for Recreativo de Huelva
Kategorija:Plejers ta' FC Zürich	Kategori:Fotballspillere for FC Zürich
Kategorija:Plejers ta' UC Sampdoria	Kategori:Fotballspillere for UC Sampdoria
Kategorija:Plejers ta' Santos Futebol Clube	Kategori:Fotballspillere for Santos FC
Kategorija:Plejers ta' São Paulo Futebol Clube	Kategori:Fotballspillere for São Paulo FC
Kategorija:Plejers ta' Sporting Clube de Portugal	Kategori:Fotballspillere for Sporting Lisboa
Kategorija:Plejers ta' Stoke City FC	Kategori:Fotballspillere for Stoke City FC
Kategorija:Plejers ta' Sunderland AFC	Kategori:Fotballspillere for Sunderland AFC
Kategorija:Plejers ta' VfB Stuttgart	Kategori:Fotballspillere for VfB Stuttgart 1893
Kategorija:Plejers ta' Sheffield Wednesday FC	Kategori:Fotballspillere for Sheffield Wednesday FC
Kategorija:Plejers ta' Sheffield United FC	Kategori:Fotballspillere for Sheffield United FC
Kategorija:Plejers ta' Grêmio Foot-Ball Porto Alegrense	Kategori:Fotballspillere for Grêmio Foot-Ball Porto Alegrense
Kategorija:Plejers ta' KAA Gent	Kategori:Fotballspillere for AA Gent
Kategorija:Plejers ta' Fluminense Football Club	Kategori:Fotballspillere for Fluminense FC
Kategorija:Plejers ta' Fulham FC	Kategori:Fotballspillere for Fulham FC
Kategorija:Plejers ta' FC Carl Zeiss Jena	Kategori:Fotballspillere for FC Carl Zeiss Jena
Kategorija:Plejers ta' Cagliari Calcio	Kategori:Fotballspillere for Cagliari Calcio
Kategorija:Plejers ta' AS Cannes	Kategori:Fotballspillere for AS Cannes
Kategorija:Plejers ta' 1. FC Kaiserslautern	Kategori:Fotballspillere for 1. FC Kaiserslautern
Kategorija:Futbolers fi Spanja skont il-klabb	Kategori:Fotballspillere i Spania etter klubb
Kategorija:Futbolers fl-Iskozja skont il-klabb	Kategori:Fotballspillere i Skottland etter klubb
Kategorija:Futbolers fil-Portugall skont il-klabb	Kategori:Fotballspillere i Portugal etter klubb
Kategorija:Futbolers fl-Ungerija skont il-klabb	Kategori:Fotballspillere i Ungarn etter klubb
Kategorija:Futbolers fir-Russja skont il-klabb	Kategori:Fotballspillere i Russland etter klubb
Kategorija:Futbolers fir-Rumanija skont il-klabb	Kategori:Fotballspillere i Romania etter klubb
Kategorija:Plejers ta' Cruzeiro Esporte Clube	Kategori:Fotballspillere for Cruzeiro Esporte Clube
Kategorija:Plejers ta' KV Kortrijk	Kategori:Fotballspillere for KV Kortrijk
Kategorija:Plejers ta' Queens Park Rangers FC	Kategori:Fotballspillere for Queens Park Rangers FC
Kategorija:Imwiet skont is-sena	Kategori:Dødsfall etter årstall
Kategorija:Plejers ta' Calcio Lecco 1912	Kategori:Fotballspillere for Calcio Lecco 1912
Kategorija:Plejers ta' US Lecce	Kategori:Fotballspillere for US Lecce
Kategorija:San Marino	Kategori:San Marino
Kategorija:Liechtenstein	Kategori:Liechtenstein
Kategorija:Andorra	Kategori:Andorra
Kategorija:Serbja	Kategori:Serbia
Kategorija:Albanija	Kategori:Albania
Kategorija:Pajjiżi tal-Oċeanja	Kategori:Land i Oseania
Kategorija:Pajjiżi tal-Amerika ta' Fuq	Kategori:Land i Nord-Amerika
Kategorija:Klabbs tal-futbol Litwani	Kategori:Fotballag i Litauen
Kategorija:Plejers ta' Modena FC	Kategori:Fotballspillere for Modena FC
Kategorija:Plejers ta' AC Monza Brianza 1912	Kategori:Fotballspillere for AC Monza Brianza 1912
Kategorija:Plejers ta' SSC Napoli	Kategori:Fotballspillere for SSC Napoli
Kategorija:Plejers ta' Calcio Padova	Kategori:Fotballspillere for Calcio Padova
Kategorija:Plejers ta' Perugia Calcio	Kategori:Fotballspillere for Perugia Calcio
Kategorija:Plejers ta' Burnley FC	Kategori:Fotballspillere for Burnley FC
Kategorija:Plejers ta' Getafe CF	Kategori:Fotballspillere for Getafe CF
Kategorija:Plejers ta' Swansea City AFC	Kategori:Fotballspillere for Swansea City AFC
Kategorija:Plejers ta' Villarreal CF	Kategori:Fotballspillere for Villarreal CF
Kategorija:Plejers ta' Málaga CF	Kategori:Fotballspillere for Málaga CF
Kategorija:Plejers ta' Watford FC	Kategori:Fotballspillere for Watford FC
Kategorija:Plejers ta' Novara Calcio	Kategori:Fotballspillere for Novara Calcio
Kategorija:Plejers ta' Newcastle United FC	Kategori:Fotballspillere for Newcastle United FC
Kategorija:Plejers ta' Hannover 96	Kategori:Fotballspillere for Hannoverscher SV 1896
Kategorija:Plejers ta' Huddersfield Town FC	Kategori:Fotballspillere for Huddersfield Town FC
Kategorija:Plejers ta' Hertha BSC	Kategori:Fotballspillere for Hertha BSC Berlin
Kategorija:Plejers ta' Hellas Verona FC	Kategori:Fotballspillere for Hellas Verona FC
Kategorija:Plejers ta' Wolverhampton Wanderers FC	Kategori:Fotballspillere for Wolverhampton Wanderers FC
Kategorija:Plejers ta' Wigan Athletic FC	Kategori:Fotballspillere for Wigan Athletic FC
Kategorija:Plejers ta' West Bromwich Albion FC	Kategori:Fotballspillere for West Bromwich Albion FC
Kategorija:Rebbieħa tal-Festival tal-Eurovision	Kategori:Vinnere av Eurovision Song Contest
Kategorija:Referis tal-futbol skond in-nazzjonalita	Kategori:Fotballdommere etter nasjonalitet
Kategorija:Referis tal-futbol Ingliżi	Kategori:Engelske fotballdommere
Kategorija:Referis tal-futbol Taljani	Kategori:Italienske fotballdommere
Kategorija:Plejers ta' FC Barcelona	Kategori:Fotballspillere for FC Barcelona
Kategorija:Plejers ta' Valencia CF	Kategori:Fotballspillere for Valencia CF
Kategorija:Plejers ta' Liverpool FC	Kategori:Fotballspillere for Liverpool FC
Kategorija:Plejers ta' FC Bayern Munich	Kategori:Fotballspillere for FC Bayern München
Kategorija:Plejers ta' Manchester City FC	Kategori:Fotballspillere for Manchester City FC
Kategorija:Plejers ta' Atlético Madrid	Kategori:Fotballspillere for Atlético Madrid
Kategorija:Plejers ta' Arsenal FC	Kategori:Fotballspillere for Arsenal FC
Kategorija:Plejers ta' FC Porto	Kategori:Fotballspillere for FC Porto
Kategorija:Plejers ta' AS Roma	Kategori:Fotballspillere for AS Roma
Kategorija:Kampjonati tal-futbol nazzjonali	Kategori:Nasjonale toppdivisjoner i fotball
Kategorija:Timijiet nazzjonali tal-futbol	Kategori:Landslag i fotball
Kategorija:Vulkani tal-Italja	Kategori:Vulkaner i Italia
Kategorija:Antropoloġija	Kategori:Antropologi
Kategorija:Pajjiżi stabbiliti fl-1801	Kategori:Stater og territorier etablert i 1801
Kategorija:Pajjiżi stabbiliti fl-1803	Kategori:Stater og territorier etablert i 1803
Kategorija:Pajjiżi stabbiliti fl-1830	Kategori:Stater og territorier etablert i 1830
Kategorija:Pajjiżi stabbiliti fl-1866	Kategori:Stater og territorier etablert i 1866
Kategorija:Pajjiżi stabbiliti fl-1910	Kategori:Stater og territorier etablert i 1910
Kategorija:Pajjiżi stabbiliti fl-1946	Kategori:Stater og territorier etablert i 1946
Kategorija:Pajjiżi stabbiliti fl-1944	Kategori:Stater og territorier etablert i 1944
Kategorija:Pajjiżi stabbiliti fl-1929	Kategori:Stater og territorier etablert i 1929
Kategorija:Pajjiżi stabbiliti fl-1923	Kategori:Stater og territorier etablert i 1923
Kategorija:Pajjiżi stabbiliti fl-1955	Kategori:Stater og territorier etablert i 1955
Kategorija:Pajjiżi stabbiliti fl-1960	Kategori:Stater og territorier etablert i 1960
Kategorija:Pajjiżi stabbiliti fl-1964	Kategori:Stater og territorier etablert i 1964
Kategorija:Pajjiżi stabbiliti fl-1974	Kategori:Stater og territorier etablert i 1974
Kategorija:Pajjiżi stabbiliti fl-1975	Kategori:Stater og territorier etablert i 1975
Kategorija:Pajjiżi stabbiliti fl-1991	Kategori:Stater og territorier etablert i 1991
Kategorija:Pajjiżi stabbiliti fl-1993	Kategori:Stater og territorier etablert i 1993
Kategorija:Pajjiżi stabbiliti fl-2003	Kategori:Stater og territorier etablert i 2003
Kategorija:Pajjiżi stabbiliti fl-2006	Kategori:Stater og territorier etablert i 2006
Kategorija:Pajjiżi stabbiliti fl-2010	Kategori:Stater og territorier etablert i 2010
Kategorija:Pajjiżi stabbiliti fl-2011	Kategori:Stater og territorier etablert i 2011
Kategorija:Bliet tal-Veneżwela	Kategori:Byer i Venezuela
Mudell:Tim ta' Inter Milan	Mal:Internazionale spillerstall
Kategorija:Repubbliki	Kategori:Republikker
Kategorija:Chelsea FC	Kategori:Chelsea FC
Kategorija:Arsenal FC	Kategori:Arsenal FC
Kategorija:Liverpool FC	Kategori:Liverpool FC
Kategorija:Inter Milan	Kategori:Internazionale
Kategorija:Manchester United FC	Kategori:Manchester United
Kategorija:AC Milan	Kategori:AC Milan
Kategorija:Klabbs tal-futbol Olandiżi	Kategori:Fotballag i Nederland
Kategorija:Lagomorpha	Kategori:Haredyr
Kategorija:Kontestanti fil-Festival tal-Eurovision	Kategori:Deltakere i Eurovision Song Contest
Kategorija:Pajjiżi tal-Amerika t'Isfel	Kategori:Land i Sør-Amerika
Kategorija:Abbozzi tal-isport	Kategori:Sportsstubber
Kategorija:Plejers ta' FC Vaslui	Kategori:Fotballspillere for FC Vaslui
Kategorija:Klabbs tal-futbol tal-Andorra	Kategori:Fotballag i Andorra
Kategorija:Analisi matematika	Kategori:Matematisk analyse
Kategorija:Sirenia	Kategori:Sjøkyr
Kategorija:Mitoloġija Griega	Kategori:Gresk mytologi
Kategorija:Bliet kapitali	Kategori:Hovedsteder
Kategorija:Avvenimenti	Kategori:Historiske hendelser
Kategorija:HIV/AIDS	Kategori:Hiv/aids
Kategorija:Filatelija	Kategori:Filateli
Kategorija:Arkeoloġija	Kategori:Arkeologi
Kategorija:Astroloġija	Kategori:Astrologi
Kategorija:Logħob Olimpiku tas-sajf 2008	Kategori:Sommer-OL 2008
Kategorija:Ho Chi Minh (belt)	Kategori:Ho Chi Minh-byen
Kategorija:Elettriċità	Kategori:Elektrisitet
Kategorija:Posta	Kategori:Postombæring
Kategorija:Utenti pl	Kategori:Bruker pl
Kategorija:Trasport	Kategori:Transport
Kategorija:Ir-Rivoluzzjoni Franċiża	Kategori:Den franske revolusjon
Kategorija:Żfin	Kategori:Dans
Kategorija:Sports tat-timijiet	Kategori:Lagsport
Kategorija:Teorija tal-grafi	Kategori:Grafteori
Kategorija:Teorija tan-numri	Kategori:Tallteori
Kategorija:Kantanti	Kategori:Sangere
Kategorija:Futbolers	Kategori:Fotballspillere
Kategorija:Matematiċi	Kategori:Matematikere
Kategorija:Futbolers fl-Italja skont il-klabb	Kategori:Fotballspillere i Italia etter klubb
Kategorija:Futbolers fl-Olanda skont il-klabb	Kategori:Fotballspillere i Nederland etter klubb
Kategorija:Futbolers fl-Ingilterra skont il-klabb	Kategori:Fotballspillere i England etter klubb
Kategorija:Futbolers skont il-klabb	Kategori:Fotballspillere etter klubb
Mudell:Coord/dec2dms/d	Mal:Koord/dec2dms/d
Kategorija:Presidenti tal-Italja	Kategori:Italienske presidenter
Kategorija:Kompetizzjonijiet tal-futbol fil-Ġermanja	Kategori:Fotballturneringer i Tyskland
Kategorija:Sportivi	Kategori:Sportsutøvere
Kategorija:Skultura	Kategori:Skulptur
Kategorija:Montenegro	Kategori:Montenegro
Kategorija:Plejers ta' Everton FC	Kategori:Fotballspillere for Everton FC
Kategorija:Plejers ta' West Ham United FC	Kategori:Fotballspillere for West Ham United FC
Kategorija:Plejers ta' Manchester United FC	Kategori:Fotballspillere for Manchester United FC
Kategorija:Kampjonati Ewropej tal-Futbol 2008	Kategori:EM i fotball 2008
Kategorija:Pajjiżi stabbiliti fl-1800	Kategori:Stater og territorier etablert i 1800
Kategorija:Pajjiżi stabbiliti fl-1890	Kategori:Stater og territorier etablert i 1890
Kategorija:Pajjiżi stabbiliti fl-1917	Kategori:Stater og territorier etablert i 1917
Kategorija:Pajjiżi stabbiliti fl-1967	Kategori:Stater og territorier etablert i 1967
Kategorija:Pajjiżi stabbiliti fl-1905	Kategori:Stater og territorier etablert i 1905
Kategorija:Pajjiżi stabbiliti fl-1990	Kategori:Stater og territorier etablert i 1990
Mudell:G14	Mal:G14
Kategorija:Kultura tal-Veneżwela	Kategori:Venezuelansk kultur
Kategorija:Bliet ta' Malta	Kategori:Byer på Malta
Kategorija:Bliet tal-Vjetnam	Kategori:Byer i Vietnam
Kategorija:Bliet kapitali fl-Ewropa	Kategori:Hovedsteder i Europa
Kategorija:Plejers ta' Djurgårdens IF Fotboll	Kategori:Fotballspillere for Djurgårdens IF
Kategorija:Logħob tal-ballun	Kategori:Ballsport
Kategorija:Belt Valletta	Kategori:Valletta
Kategorija:Mediterran	Kategori:Middelhavet
Kategorija:Mużiċisti Albaniżi	Kategori:Albanske musikere
Kategorija:Storja tal-matematika	Kategori:Matematikkens historie
Kategorija:Mudelli tal-klabbs tal-futbol Ingliżi	Kategori:Engelske spillerstallmaler for fotball
Mudell:Żoni tal-ħin	Mal:Tidssoner
Kategorija:Plejers ta' Lille OSC	Kategori:Fotballspillere for Lille OSC
Kategorija:Plejers ta' Millwall FC	Kategori:Fotballspillere for Millwall FC
Mudell:Fb-lemin	Mal:Fotballflagg-h
Kategorija:Etoloġi	Kategori:Etologer
Kategorija:Kowċis ta' FC Barcelona	Kategori:Barcelona-trenere
Kategorija:Kowċis ta' Real Madrid CF	Kategori:Real Madrid-trenere
Kategorija:Klabbs tal-futbol Belġjani	Kategori:Fotballag i Belgia
Kategorija:L-Ewwel Diviżjoni Belġjana	Kategori:Belgisk toppdivisjon i fotball
Kategorija:Saħħa	Kategori:Helse
Kategorija:Futbolers fil-Ġermanja skont il-klabb	Kategori:Fotballspillere i Tyskland etter klubb
Kategorija:Klabbs tal-futbol Russi	Kategori:Fotballag i Russland
Mudell:Coord/prec dec	Mal:Koord/prec dec
Kategorija:Mudelli tal-klabbs tal-futbol Belġjani	Kategori:Belgiske spillerstallmaler for fotball
Kategorija:Mudelli tal-klabbs tal-futbol Ġermaniżi	Kategori:Tyske spillerstallmaler for fotball
Kategorija:Mudelli tal-klabbs tal-futbol Spanjoli	Kategori:Spanske spillerstallmaler for fotball
Kategorija:Plejers ta' US Avellino	Kategori:Fotballspillere for US Avellino
Kategorija:Plejers ta' Albacete Balompié	Kategori:Fotballspillere for Albacete Balompié
Kategorija:Plejers ta' SC Rheindorf Altach	Kategori:Fotballspillere for SC Rheindorf Altach
Kategorija:Plejers ta' Royal Antwerp FC	Kategori:Fotballspillere for Royal Antwerp FC
Kategorija:Plejers ta' FC Aarau	Kategori:Fotballspillere for FC Aarau
Kategorija:Plejers ta' Besa Kavajë	Kategori:Fotballspillere for KS Besa Kavajë
Kategorija:Plejers ta' Brighton & Hove Albion FC	Kategori:Fotballspillere for Brighton & Hove Albion FC
Kategorija:Plejers ta' Bristol City FC	Kategori:Fotballspillere for Bristol City FC
Kategorija:Plejers ta' RKC Waalwijk	Kategori:Fotballspillere for RKC Waalwijk
Kategorija:Isqfijiet Taljani	Kategori:Italienske biskoper
Kategorija:Plejers ta' Wellington Phoenix FC	Kategori:Fotballspillere for Wellington Phoenix FC
Kategorija:Plejers ta' KS Vllaznia Shkodër	Kategori:Fotballspillere for KS Vllaznia Shkodër
Kategorija:Plejers ta' Chivas de Guadalajara	Kategori:Fotballspillere for CD Guadalajara
Kategorija:Plejers ta' KRC Genk	Kategori:Fotballspillere for KRC Genk
Kategorija:Plejers ta' Defensor Sporting Club	Kategori:Fotballspillere for Defensor Sporting Club
Kategorija:Plejers ta' Beerschot AC	Kategori:Fotballspillere for KFC Germinal Beerschot
Kategorija:Plejers ta' SV Zulte Waregem	Kategori:Fotballspillere for SV Zulte Waregem
Kategorija:Plejers ta' FC Crotone	Kategori:Fotballspillere for FC Crotone
Kategorija:Plejers ta' Lillestrøm SK	Kategori:Fotballspillere for Lillestrøm SK
Kategorija:Plejers ta' KSC Lokeren Oost-Vlaanderen	Kategori:Fotballspillere for K.S.C. Lokeren Oost-Vlaanderen
Kategorija:Plejers ta' PFC Lokomotiv Sofia	Kategori:Fotballspillere for PFC Lokomotiv Sofia
Kategorija:Plejers ta' AC Lugano	Kategori:Fotballspillere for FC Lugano
Kategorija:Plejers ta' AC Lumezzane	Kategori:Fotballspillere for AC Lumezzane
Kategorija:Plejers ta' Luton Town FC	Kategori:Fotballspillere for Luton Town FC
Kategorija:Plejers ta' Lierse SK	Kategori:Fotballspillere for KV Lierse
Kategorija:Plejers ta' FC Lucerne	Kategori:Fotballspillere for FC Luzern
Kategorija:Plejers ta' Manisaspor	Kategori:Fotballspillere for Manisaspor
Kategorija:Plejers ta' KV Mechelen	Kategori:Fotballspillere for KV Mechelen
Kategorija:Plejers ta' CD Nacional	Kategori:Fotballspillere for CD Nacional
Kategorija:Plejers ta' AC Omonia	Kategori:Fotballspillere for AC Omonia
Kategorija:Plejers ta' SK Rapid Wien	Kategori:Fotballspillere for SK Rapid Wien
Kategorija:Plejers ta' Rimini Calcio FC	Kategori:Fotballspillere for AC Rimini 1912
Kategorija:Plejers ta' FC St. Gallen	Kategori:Fotballspillere for FC St. Gallen
Kategorija:Plejers ta' FK Sarajevo	Kategori:Fotballspillere for FK Sarajevo
Kategorija:Plejers ta' Servette FC	Kategori:Fotballspillere for Servette FC
Kategorija:Plejers ta' Cercle Brugge KSV	Kategori:Fotballspillere for Cercle Brugge KSV
Kategorija:Plejers ta' Standard Liège	Kategori:Fotballspillere for Standard Liège
Kategorija:Plejers ta' FC Sion	Kategori:Fotballspillere for FC Sion
Kategorija:Plejers ta' KS Teuta Durrës	Kategori:Fotballspillere for KS Teuta Durrës
Kategorija:Plejers ta' KF Tirana	Kategori:Fotballspillere for KF Tirana
Kategorija:Plejers ta' Ferencváros TC	Kategori:Fotballspillere for Ferencváros TC
Kategorija:Plejers ta' KS Flamurtari Vlorë	Kategori:Fotballspillere for KS Flamurtari Vlorë
Kategorija:Plejers ta' Hibernian FC	Kategori:Fotballspillere for Hibernian FC
Kategorija:Plejers ta' Hull City AFC	Kategori:Fotballspillere for Hull City AFC
Kategorija:Plejers ta' Chester City FC	Kategori:Fotballspillere for Chester City FC
Kategorija:Plejers ta' FC Schaffhausen	Kategori:Fotballspillere for FC Schaffhausen
Kategorija:Plejers ta' Shamrock Rovers FC	Kategori:Fotballspillere for Shamrock Rovers FC
Kategorija:Plejers ta' SD Eibar	Kategori:Fotballspillere for SD Eibar
Kategorija:Plejers ta' El Nacional	Kategori:Fotballspillere for Club Deportivo El Nacional
Kategorija:Plejers ta' Yverdon-Sport FC	Kategori:Fotballspillere for Yverdon-Sport FC
Kategorija:Plejers ta' BSC Young Boys	Kategori:Fotballspillere for BSC Young Boys
Kategorija:Plejers ta' PFC CSKA Sofia	Kategori:Fotballspillere for CSKA Sofia
Kategorija:William Shakespeare	Kategori:William Shakespeare
Kategorija:Wolverhampton Wanderers FC	Kategori:Wolverhampton Wanderers
Kategorija:Plejers ta' Galatasaray SK	Kategori:Fotballspillere for Galatasaray SK
Kategorija:Mudelli tal-mużika	Kategori:Musikkmaler
Kategorija:Kittieba tar-Rinaxximent	Kategori:Renessanseforfattere
Mudell:Infobox Kulur	Mal:Infoboks farge
Kategorija:Kompożituri	Kategori:Komponister
Kategorija:Futbolers f'Ċipru skont il-klabb	Kategori:Fotballspillere på Kypros etter klubb
Mudell:Kampjonati tal-UEFA	Mal:UEFA-ligaer
Mudell:Pajjiżi tal-Eurovision	Mal:Land i Eurovision Song Contest
Mudell:Skwadra Ġermaniża Kampjonati Ewropej tal-Futbol 2012	Mal:Tysklands lag i fotball-EM 2012
Mudell:Skwadra Ġermaniża Tazza tad-Dinja tal-Futbol 2006	Mal:Tysklands lag i fotball-VM 2006
Kategorija:Mudelli semi-protetti	Kategori:Wikipedia semibeskyttede maler
Kategorija:Artikli li jeħtieġu aġġornament	Kategori:Trenger oppdatering
Kategorija:Plejers ta' FC Dynamo Kyiv	Kategori:Fotballspillere for FC Dynamo Kiev
Mudell:Kontribuzzjonijiet utent	Mal:Brukerbidrag
Kategorija:Tazza tad-Dinja tal-Futbol 2006	Kategori:VM i fotball 2006
Kategorija:Kwalifikazzjoni għat-Tazza tad-Dinja tal-Futbol 2010	Kategori:Kvalifisering til Fotball-VM 2010
Kategorija:Grawnds tal-futbol fil-Ġermanja	Kategori:Fotballstadioner i Tyskland
Kategorija:Plejers ta' AC ChievoVerona	Kategori:Fotballspillere for AC ChievoVerona
Kategorija:Kowċis ta' AC Milan	Kategori:Milan-trenere
Kategorija:Plejers ta' AFC Bournemouth	Kategori:Fotballspillere for AFC Bournemouth
Kategorija:Plejers ta' ACF Fiorentina	Kategori:Fotballspillere for ACF Fiorentina
Kategorija:Plejers ta' AS Monaco FC	Kategori:Fotballspillere for AS Monaco
Kategorija:Plejers ta' AS Saint-Étienne	Kategori:Fotballspillere for AS Saint-Étienne
Kategorija:Klabbs tal-futbol stabbiliti fl-1864	Kategori:Fotballag etablert i 1864
Kategorija:Klabbs tal-futbol stabbiliti fl-1874	Kategori:Fotballag etablert i 1874
Kategorija:Klabbs tal-futbol stabbiliti fl-1875	Kategori:Fotballag etablert i 1875
Kategorija:Klabbs tal-futbol stabbiliti fl-1881	Kategori:Fotballag etablert i 1881
Kategorija:Klabbs tal-futbol stabbiliti fl-1890	Kategori:Fotballag etablert i 1890
Kategorija:Klabbs tal-futbol stabbiliti fl-1892	Kategori:Fotballag etablert i 1892
Kategorija:Klabbs tal-futbol stabbiliti fl-1894	Kategori:Fotballag etablert i 1894
Kategorija:Klabbs tal-futbol stabbiliti fl-1895	Kategori:Fotballag etablert i 1895
Kategorija:Klabbs tal-futbol stabbiliti fl-1898	Kategori:Fotballag etablert i 1898
Kategorija:Klabbs tal-futbol stabbiliti fl-1908	Kategori:Fotballag etablert i 1908
Kategorija:Klabbs tal-futbol stabbiliti fl-1927	Kategori:Fotballag etablert i 1927
Kategorija:Klabbs tal-futbol stabbiliti fl-1923	Kategori:Fotballag etablert i 1923
Kategorija:Klabbs tal-futbol stabbiliti fl-1931	Kategori:Fotballag etablert i 1931
Kategorija:Klabbs tal-futbol stabbiliti fl-1933	Kategori:Fotballag etablert i 1933
Kategorija:Klabbs tal-futbol stabbiliti fl-1985	Kategori:Fotballag etablert i 1985
Kategorija:Klabbs tal-futbol stabbiliti fl-1994	Kategori:Fotballag etablert i 1994
Kategorija:Klabbs tal-futbol stabbiliti fl-2010	Kategori:Fotballag etablert i 2010
Kategorija:Klabbs tal-futbol stabbiliti fl-2009	Kategori:Fotballag etablert i 2009
Kategorija:Klabbs tal-futbol stabbiliti fl-1997	Kategori:Fotballag etablert i 1997
Kategorija:Federazzjonijiet tal-futbol	Kategori:Fotballforbund
Kategorija:Kowċis skont il-klabb	Kategori:Fotballtrenere etter klubb
Kategorija:Futbolers fi New Zealand skont il-klabb	Kategori:Fotballspillere i New Zealand etter klubb
Kategorija:Futbolers fl-Irlanda skont il-klabb	Kategori:Fotballspillere i Irland etter klubb
Kategorija:Plejers ta' Atalanta BC	Kategori:Fotballspillere for Atalanta BC
Kategorija:Kantanti Ażerbajġani	Kategori:Aserbajdsjanske sangere
Kategorija:Plejers ta' Barnsley FC	Kategori:Fotballspillere for Barnsley FC
Mudell:Tim ta' Valencia CF	Mal:Valencia CF
Kategorija:Plejers ta' Boca Juniors	Kategori:Fotballspillere for Boca Juniors
Kategorija:Referis tal-futbol Brażiljani	Kategori:Brasilianske fotballdommere
Kategorija:Pajjiżi tal-Amerika Ċentrali	Kategori:Land i Sentral-Amerika
Mudell:TOCleft	Mal:TOC left
Kategorija:Abbozzi tal-edukazzjoni	Kategori:Utdanningsstubber
Kategorija:Plejers ta' Eintracht Frankfurt	Kategori:Fotballspillere for Eintracht Frankfurt
Kategorija:Edizzjonijiet tal-Festival tal-Eurovision	Kategori:Eurovision Song Contest etter år
Kategorija:Plejers ta' FC Admira Wacker Mödling	Kategori:Fotballspillere for FC Admira Wacker Mödling
Kategorija:FC Barcelona	Kategori:FC Barcelona
Kategorija:Plejers ta' FC Girondins de Bordeaux	Kategori:Fotballspillere for FC Girondins de Bordeaux
Kategorija:Plejers ta' FC Lausanne-Sport	Kategori:Fotballspillere for FC Lausanne-Sport
Kategorija:Plejers ta' FC Schalke 04	Kategori:Fotballspillere for FC Schalke 04
Kategorija:Plejers ta' FC Sochaux-Montbéliard	Kategori:Fotballspillere for FC Sochaux-Montbéliard
Kategorija:Plejers ta' FC Thun	Kategori:Fotballspillere for FC Thun
Kategorija:Plejers ta' FC Utrecht	Kategori:Fotballspillere for FC Utrecht
Kategorija:Tazza tad-Dinja tal-Futbol	Kategori:VM i fotball
Kategorija:Plejers ta' FK Borac Banja Luka	Kategori:Fotballspillere for FK Borac Banja Luka
Kategorija:Plejers ta' FK Partizan	Kategori:Fotballspillere for FK Partizan
Kategorija:Klabbs tal-futbol Armeni	Kategori:Fotballag i Armenia
Kategorija:Klabbs tal-futbol Awstrijaċi	Kategori:Fotballag i Østerrike
Kategorija:Klabbs tal-futbol Bożnijaċi	Kategori:Fotballag i Bosnia-Hercegovina
Kategorija:Klabbs tal-futbol Estonjani	Kategori:Fotballag i Estland
Kategorija:Klabbs tal-futbol Iżraeljani	Kategori:Fotballag i Israel
Kategorija:Klabbs tal-futbol Serbi	Kategori:Fotballag i Serbia
Kategorija:Futbol fil-Korea t'Isfel	Kategori:Fotball i Sør-Korea
Kategorija:Kowċis fil-Portugall skont il-klabb	Kategori:Fotballtrenere i Portugal etter klubb
Kategorija:Kowċis fl-Olanda skont il-klabb	Kategori:Fotballtrenere i Nederland etter klubb
Kategorija:Grawnds tal-futbol fil-Belġju	Kategori:Fotballstadioner i Belgia
Kategorija:Futbolers fl-Arġentina skont il-klabb	Kategori:Fotballspillere i Argentina etter klubb
Kategorija:Futbolers fil-Belġju skont il-klabb	Kategori:Fotballspillere i Belgia etter klubb
Kategorija:Futbolers fil-Bożnija u Ħerżegovina skont il-klabb	Kategori:Fotballspillere i Bosnia-Hercegovina etter klubb
Kategorija:Futbolers fil-Brażil skont il-klabb	Kategori:Fotballspillere i Brasil etter klubb
Kategorija:Futbolers fl-Ekwador skont il-klabb	Kategori:Fotballspillere i Ecuador etter klubb
Kategorija:Futbolers fi Franza skont il-klabb	Kategori:Fotballspillere i Frankrike etter klubb
Kategorija:Futbolers fil-Greċja skont il-klabb	Kategori:Fotballspillere i Hellas etter klubb
Kategorija:Futbolers fl-Iżrael skont il-klabb	Kategori:Fotballspillere i Israel etter klubb
Kategorija:Futbolers fil-Messiku skont il-klabb	Kategori:Fotballspillere i Mexico etter klubb
Kategorija:Futbolers fin-Norveġja skont il-klabb	Kategori:Fotballspillere i Norge etter klubb
Kategorija:Futbolers fis-Serbja skont il-klabb	Kategori:Fotballspillere i Serbia etter klubb
Kategorija:Futbolers fil-Korea t'Isfel skont il-klabb	Kategori:Fotballspillere i Sør-Korea etter klubb
Kategorija:Futbolers fl-Iżvezja skont il-klabb	Kategori:Fotballspillere i Sverige etter klubb
Kategorija:Futbolers fl-Iżvizzera skont il-klabb	Kategori:Fotballspillere i Sveits etter klubb
Kategorija:Futbolers fit-Turkija skont il-klabb	Kategori:Fotballspillere i Tyrkia etter klubb
Kategorija:Futbolers fl-Urugwaj skont il-klabb	Kategori:Fotballspillere i Uruguay etter klubb
Mudell:Preċiżjoni1	Mal:Precision1
Kategorija:Plejers ta' Grasshopper-Club Zürich	Kategori:Fotballspillere for Grasshopper-Club Zürich
Kategorija:Plejers ta' Hamburger SV	Kategori:Fotballspillere for Hamburger SV
Kategorija:Simboli Olimpiċi	Kategori:Olympiske symboler
Kategorija:Kowċis ta' Inter Milan	Kategori:Internazionale-trenere
Kategorija:Plejers ta' Inter Milan	Kategori:Fotballspillere for FC Internazionale Milano
Kategorija:Plejers ta' Ipswich Town FC	Kategori:Fotballspillere for Ipswich Town FC
Kategorija:Irlanda	Kategori:Irland
Għajnuna:Kronoloġija	Hjelp:Revisjonshistorikk
Kategorija:Kowċis fi Spanja skont il-klabb	Kategori:Fotballtrenere i Spania etter klubb
Kategorija:Festival tal-Eurovision taż-Żgħar	Kategori:Junior Eurovision Song Contest
Kategorija:Plejers ta' Juventus FC	Kategori:Fotballspillere for Juventus FC
Kategorija:Ordni Militari Sovran ta' Malta	Kategori:Malteserordenen
Kategorija:Plejers ta' Larissa FC	Kategori:Fotballspillere for AE Larisa
Kategorija:Plejers ta' Legia Warszawa	Kategori:Fotballspillere for KP Legia Warszawa
Kategorija:Plejers ta' Macclesfield Town FC	Kategori:Fotballspillere for Macclesfield Town FC
Kategorija:Abbozzi tal-letteratura	Kategori:Litteraturstubber
Kategorija:Plejers ta' Mansfield Town FC	Kategori:Fotballspillere for Mansfield Town FC
Kategorija:Plejers ta' RSC Anderlecht	Kategori:Fotballspillere for RSC Anderlecht
Kategorija:Abbozzi tal-mediċina	Kategori:Medisinstubber
Kategorija:Plejers ta' RC Strasbourg	Kategori:Fotballspillere for RC Strasbourg
Kategorija:Plejers ta' Racing Club	Kategori:Fotballspillere for Racing Club de Avellaneda
Kategorija:Plejers ta' Real Madrid CF	Kategori:Fotballspillere for Real Madrid CF
Kategorija:Plejers ta' Real Zaragoza	Kategori:Fotballspillere for Real Zaragoza
Kategorija:Plejers ta' NEC Nijmegen	Kategori:Fotballspillere for NEC Nijmegen
Kategorija:Plejers ta' River Plate	Kategori:Fotballspillere for CA River Plate
Kategorija:Kompożituri Romantiċi	Kategori:Romantiske komponister
Kategorija:Plejers ta' Rosario Central	Kategori:Fotballspillere for Rosario Central
Kategorija:Plejers ta' SS Lazio	Kategori:Fotballspillere for SS Lazio
Kategorija:Abbozzi tas-sesswalità	Kategori:Seksualitetstubber
Kategorija:Abbozzi tal-filosofija	Kategori:Filosofistubber
Kategorija:Plejers ta' SC Heerenveen	Kategori:Fotballspillere for SC Heerenveen
Kategorija:Plejers ta' SV Werder Bremen	Kategori:Fotballspillere for SV Werder Bremen 1899
Kategorija:Plejers ta' PFC CSKA Moscow	Kategori:Fotballspillere for CSKA Moskva
Kategorija:Pitturi ta' Pablo Picasso	Kategori:Malerier av Pablo Picasso
Kategorija:Plejers ta' Parma FC	Kategori:Fotballspillere for Parma FC
Kategorija:Lingwi Semitiċi	Kategori:Semittiske språk
Kategorija:Mużiċisti Slovakki	Kategori:Slovakiske musikere
Kategorija:Futbolers fl-Istati Uniti skont il-klabb	Kategori:Fotballspillere i USA etter klubb
Kategorija:Grawnds tal-futbol fl-Afrika t'Isfel	Kategori:Fotballstadioner i Sør-Afrika
Kategorija:Plejers ta' Sociedade Esportiva Palmeiras	Kategori:Fotballspillere for SE Palmeiras
Kategorija:Referis tal-futbol Spanjoli	Kategori:Spanske fotballdommere
Kategorija:Mużewijiet sportivi	Kategori:Idrettsmuseer
Kategorija:Ateiżmu	Kategori:Ateisme
Kategorija:Plejers ta' Stade Rennais FC	Kategori:Fotballspillere for Stade Rennais FC
Kategorija:Pajjiżi skond is-sena li spiċċaw	Kategori:Stater og territorier etter opphørsår
Kategorija:Pajjiżi stabbiliti fl-1278	Kategori:Stater og territorier etablert i 1278
Kategorija:Pajjiżi stabbiliti fl-1798	Kategori:Stater og territorier etablert i 1798
Kategorija:Pajjiżi stabbiliti fl-1937	Kategori:Stater og territorier etablert i 1937
Kategorija:Pajjiżi stabbiliti fl-2008	Kategori:Stater og territorier etablert i 2008
Kategorija:Plejers ta' Swindon Town FC	Kategori:Fotballspillere for Swindon Town FC
Kategorija:Edizzjonijiet tal-Kampjonati Ewropej tal-Futbol	Kategori:EM i fotball
Kategorija:Bolol	Kategori:Frimerker
Kategorija:Xjenza Applikati	Kategori:Anvendt vitenskap
Kategorija:Trattati tal-Unjoni Ewropea	Kategori:Den europeiske unions traktater
Kategorija:Coritiba Foot Ball Club	Kategori:Coritiba Foot Ball Club
Kategorija:Futbol fil-Maċedonja	Kategori:Fotball i Makedonia
Kategorija:Snin tas-seklu 12	Kategori:Årstall på 1100-tallet
Kategorija:Snin tas-seklu 13	Kategori:Årstall på 1200-tallet
Kategorija:Snin tas-seklu 14	Kategori:Årstall på 1300-tallet
Kategorija:Snin tas-seklu 15	Kategori:Årstall på 1400-tallet
Kategorija:Snin tas-seklu 16	Kategori:Årstall på 1500-tallet
Kategorija:Snin tas-seklu 17	Kategori:Årstall på 1600-tallet
Kategorija:Snin tas-seklu 18	Kategori:Årstall på 1700-tallet
Kategorija:Snin tas-seklu 19	Kategori:Årstall på 1800-tallet
Kategorija:Snin tas-seklu 20	Kategori:Årstall på 1900-tallet
Kategorija:Snin tas-seklu 21	Kategori:Årstall på 2000-tallet
Kategorija:Logħob tat-tfal	Kategori:Leker
Kategorija:Provinċja ta' Bergamo	Kategori:Provinsen Bergamo
Kategorija:Kantanti Bulgari	Kategori:Bulgarske sangere
Mudell:Premier League Armen	Mal:Hajastani Bardzraguwjn chowmb
Kategorija:Provinċja ta' Lodi	Kategori:Provinsen Lodi
Kategorija:Plejers ta' Beşiktaş JK	Kategori:Fotballspillere for Beşiktaş JK
Kategorija:Plejers ta' Chelsea FC	Kategori:Fotballspillere for Chelsea FC
Kategorija:Plejers ta' Club Brugge KV	Kategori:Fotballspillere for Club Brügge
Kategorija:Plejers ta' Coventry City FC	Kategori:Fotballspillere for Coventry City FC
Kategorija:Plejers ta' Neuchâtel Xamax	Kategori:Fotballspillere for Neuchâtel Xamax FC
Kategorija:Plejers ta' Nottingham Forest FC	Kategori:Fotballspillere for Nottingham Forest FC
Kategorija:Plejers ta' Panathinaikos	Kategori:Fotballspillere for Panathinaikos AO
Kategorija:Plejers ta' Paris Saint-Germain FC	Kategori:Fotballspillere for Paris Saint-Germain FC
Kategorija:Plejers ta' Tottenham Hotspur FC	Kategori:Fotballspillere for Tottenham Hotspur FC
Kategorija:Plejers ta' VfL Wolfsburg	Kategori:Fotballspillere for VfL Wolfsburg
Kategorija:Plejers ta' Wrexham FC	Kategori:Fotballspillere for Wrexham FC
Kategorija:Plejers ta' 1. FC Köln	Kategori:Fotballspillere for 1. FC Köln
Kategorija:Plejers ta' OGC Nice	Kategori:Fotballspillere for OGC Nice
Kategorija:Plejers ta' Olympique Lyonnais	Kategori:Fotballspillere for Olympique Lyon
Kategorija:Pedagoġija	Kategori:Pedagogikk
Kategorija:Preistorja	Kategori:Forhistorisk tid
Kategorija:Drammi ta' William Shakespeare	Kategori:William Shakespeares skuespill
Kategorija:Mużiċisti Torok	Kategori:Tyrkiske musikere
Kategorija:Staġuni tal-Premier League	Kategori:FA Premier League-sesonger
Kategorija:Abbozzi tal-arkitettura	Kategori:Arkitekturstubber
Kategorija:Artikli b'sezzjonijiet għall-espansjoni	Kategori:Artikler med seksjoner som behøver utvidelse
Għajnuna:Gwida essenzjali/Sorsi	Wikipedia:Veiledning/Sitere kilder
Mudell:Infobox Gazzetta	Mal:Infoboks avis
Mudell:IMSLP	Mal:IMSLP
Kategorija:Abbozzi ta' organizzazzjonijiet	Kategori:Organisasjonstubber
Kategorija:Utenti en-1	Kategori:Bruker en-1
Kategorija:Twieldu fl-1930	Kategori:Fødsler i 1930
Kategorija:Twieldu fl-1946	Kategori:Fødsler i 1946
Kategorija:Utenti de-1	Kategori:Bruker de-1
Kategorija:Twieldu fl-1920	Kategori:Fødsler i 1920
Kategorija:Twieldu fl-1956	Kategori:Fødsler i 1956
Kategorija:Twieldu fl-1933	Kategori:Fødsler i 1933
Kategorija:Twieldu fl-1911	Kategori:Fødsler i 1911
Kategorija:Twieldu fl-1937	Kategori:Fødsler i 1937
Kategorija:Twieldu fl-1948	Kategori:Fødsler i 1948
Kategorija:Mudelli protetti	Kategori:Wikipedia beskyttede maler
Kategorija:Mietu fl-1978	Kategori:Dødsfall i 1978
Kategorija:Twieldu fl-1921	Kategori:Fødsler i 1921
Kategorija:Twieldu fl-1924	Kategori:Fødsler i 1924
Kategorija:Twieldu fl-1926	Kategori:Fødsler i 1926
Kategorija:Twieldu fl-1950	Kategori:Fødsler i 1950
Kategorija:Twieldu fl-1964	Kategori:Fødsler i 1964
Kategorija:Atturi Amerikani	Kategori:Skuespillere fra USA
Kategorija:Mietu fl-1979	Kategori:Dødsfall i 1979
Kategorija:Mietu fl-2010	Kategori:Dødsfall i 2010
Kategorija:Mużiċisti Rumeni	Kategori:Rumenske musikere
Mudell:Nowrap begin	Mal:Nowrap begin
Mudell:Soccerbase	Mal:Soccerbase
Mudell:Tim ta' Sunderland AFC	Mal:Sunderland AFC
Mudell:Tim ta' Borussia Dortmund	Mal:Borussia Dortmund
Mudell:Tim ta' VfL Wolfsburg	Mal:VfL Wolfsburg
Mudell:Tim ta' SS Lazio	Mal:SS Lazio
Għajnuna:Medja	Hjelp:Multimedia
Wikipedija:Ċaħda medika	Wikipedia:Helsemessige forbehold
Mudell:Kunsill Nordiku	Mal:Nordisk råd
Kategorija:Premier League	Kategori:FA Premier League
Mudell:Primera Divisió	Mal:Primera Divisió
Mudell:Tim ta' Real Madrid CF	Mal:Real Madrid
Mudell:Tim ta' Wigan Athletic FC	Mal:Wigan Athletic FC
Mudell:Kunsilli lokali ta' Malta u Għawdex	Mal:Kommuner og kommuneråd på Malta og Gozo
Mudell:Tim ta' Manchester City FC	Mal:Manchester City
Mudell:Infobox kompetizzjoni sportiva	Mal:Infoboks sportsliga
Mudell:Kwalifikazzjoni għat-Tazza tad-Dinja tal-Futbol 2010 (UEFA) - Grupp 1	Mal:Fotball-VM 2010 kvalik gruppe 1 UEFA tabell
Mudell:Tim ta' RAEC Mons	Mal:RAEC Mons spillerstall
Mudell:Federazzjonijiet tal-UEFA	Mal:UEFA-forbund
Mudell:Skwadra Slovena Tazza tad-Dinja tal-Futbol 2010	Mal:Slovenias lag i fotball-VM 2010
Għajnuna:Paġna kwalunkwe	Wikipedia:Tilfeldig
Mudell:Superliga Albaniża	Mal:Kategoria Superiore
Mudell:Tim ta' Liverpool FC	Mal:Liverpool FC
Mudell:Tim ta' Birmingham City FC	Mal:Birmingham City FC
Mudell:Tim ta' Hull City AFC	Mal:Hull City AFC
Mudell:Tim ta' Aston Villa FC	Mal:Aston Villa
Mudell:Tim ta' Tottenham Hotspur FC	Mal:Tottenham Hotspur FC
Mudell:Tim ta' Villareal CF	Mal:Villarreal CF
Wikipedija:VisualEditor	Wikipedia:VisualEditor
Mudell:Skwadra Taljana Kampjonati Ewropej tal-Futbol 2012	Mal:Italias lag i fotball-EM 2012
Mudell:Gwida essenzjali	Wikipedia:Veiledning/Faner
Premier League 2013–14	Premier League 2013/14
Mudell:Tim ta' KAA Gent	Mal:AA Gent spillerstall
Kategorija:Pajjiżi li spiċċaw fl-1800	Kategori:Stater og territorier opphørt i 1800
Mudell:Tim ta' Fulham FC	Mal:Fulham
Mudell:Tim ta' Oud-Heverlee Leuven	Mal:Oud-Heverlee Leuven spillerstall
Birdman (film)	Birdman (film)
Mudell:Skwadra Ġermaniża Kampjonati Ewropej tal-Futbol 2004	Mal:Tysklands lag i fotball-EM 2004
Mudell:Hs	Mal:Skjulsorter
Mudell:Fb r header/team	Mal:Fb r header/team
Mudell:Infobox weather/line	Mal:Infoboks vær/linje
Mudell:Infobox Temp/kolp	Mal:Infoboks vær/kolp
Mudell:Infobox Temp/kolt	Mal:Infoboks vær/kolt
Edward Snowden	Edward Snowden
Mudell:Premijer Liga	Mal:Premijer liga
Mudell:Dati pajjiż Kamerun	Mal:Flagg/Kamerun
Speċjali:TibdilRiċenti	Spesial:Siste endringer
Kategorija:Utenti ja-4	Kategori:Bruker ja-4
Module:Navbox	Modul:Navbox
Kategorija:Mietu fl-1976	Kategori:Dødsfall i 1976
Kategorija:Mietu fl-1975	Kategori:Dødsfall i 1975
Kategorija:Mietu fl-1974	Kategori:Dødsfall i 1974
Krimea	Republikken Krim
Kategorija:Pajjiżi stabbiliti fl-2014	Kategori:Stater og territorier etablert i 2014
Maurizio Malvestiti	Maurizio Malvestiti
Jezidiżmu	Jesidismen
