Naakaii Łizhiní Bikéyah	Afrika
Binaʼadaałtzózí Dinéʼiʼ Bikéyah	Japan
Bitsiighaʼ Łichííʼí Bikéyah	Irland
Hángewii	Ungarn
Dibé Diníí Bikéyah	Spania
Wááshindoon Bikéyah Ałhidadiidzooígíí	USA
Bélgii Bikéyah	Belgia
Látsębooʼ	Luxembourg
Yágháhookáán	Universet
Nahasdzáán	Jorden
Nahoditsʼǫʼłání	Finland
Déinish Dineʼé Bikéyah	Danmark
Póolish Dineʼé Bikéyah	Polen
Łitʼoowę́ęya	Litauen
Ídelii	Italia
Swis Bikéyah	Sveits
Óóswiya	Østerrike
Gwíík Dineʼé Bikéyah	Hellas
Tʼóok Bikéyah	Tyrkia
Béésh Bichʼahníí Bikéyah	Europa
(*@@@u0026asia")	Asia
Shádiʼááhjí kéyah yistinígíí	Antarktika
Kéyah Wóyahgo Siʼánígíí	Nederland
Béésh bee akʼeʼelchíhí tʼáá bí nitsékeesígíí	Datamaskin
Hastiin alą́ąjįʼ dahsidáhígíí Barack Obama	Barack Obama
Táłtłʼááh Chʼosh Bitooh (Kéyah Dah Siʼánígíí)	Uruguay
Bilasáana	Epleslekten
Méhigo	Mexico
Akééháshį́į́h Hahoodzo	California
Máaz	Mars (planet)
Kénya	Kenya
Iithiyópya	Etiopia
Gáana	Ghana
Náshdóítsoh bitsiijįʼ daditłʼooígíí	Løve
Dáághahii Dinéʼiʼ Bikéyah	Frankrike
Łééchąąʼí	Tamhund
Tótaʼ Dinéʼiʼ Bikéyah	Storbritannia
Mósí	Tamkatt
Dáághahii bizaad	Fransk
Łóóʼ	Fisk
Bwazííl	Brasil
Biʼééʼ Łichííʼí Bikéyah	Russland
Łóóʼtsoh dóó Tééh hóyáanii	Hvaler
Élábéemah Hahoodzo	Alabama
Béésh Bichʼahii Bikéyah	Tyskland
Bééshbichʼahii bizaad	Tysk
Tin Bikéyah	Island
Ééstii Bikéyah	Estland
Séetin	Saturn
Chidí naatʼaʼí	Fly
Hastiin alą́ąjįʼ dahsidáhígíí George W. Bush	George W. Bush
Létbiiya	Latvia
Yóókwein	Ukraina
Chek Bikéyah	Tsjekkia
Słóbaʼ Bikéyah	Slovakia
Słobíín Bikéyah	Slovenia
Wooméiniya	Romania
Bálgaa Bikéyah	Bulgaria
Dziłigaii Bikéyah	Albania
Haʼaʼaahjí Hakʼaz Dineʼé Bikéyah	Grønland
Kwóóʼad Bikéyah	Kroatia
Bosna dóó Hetsog Bikéyah	Bosnia-Hercegovina
Azééwii Bikéyah	Aserbajdsjan
Andówa	Andorra
Béésh Łichíiʼii Bikéyah	Republikken Kypros
Jóojah (Kéyah)	Georgia
Kʼazah Bikéyah	Kasakhstan
Dziłizhin Bikéyah	Montenegro
Bádikin Sídii	Vatikanstaten
San Mawínoo Bikéyah	San Marino
Kyóoba	Cuba
Hashkʼaan Bikéyah	Barbados
Indoníízha	Indonesia
Tʼóok bizaad	Tyrkisk
Kéyah Naakai Łizhinii Bikéyah Shádiʼááhjí Siʼánígíí	Sør-Afrika
Aljííya	Algerie
Ózbeʼ Bikéyah	Usbekistan
Tó	Vann
Níłchʼi naalkidí	Fjernsyn
Chíilii	Chile
Doodaatsaahii (Jíísas)	Jesus Kristus
Mókiwii	Merkur
Ákáʼátʼįįł (béésh ntsékeesígíí álʼíní)	Apple
Biinis	Venus
Jíbitoo	Jupiter
Yoowéinis	Uranus
Néʼtoon	Neptun (planet)
Sį́ʼgaboo	Singapore
Tłóotoo	Pluto
Łííhtensain	Liechtenstein
Dágháilchįįh	Adolf Hitler
Naaltsoos biniiʼ	Facebook
Naaki góneʼ yéigo daʼahijoogą́ą́ʼ	Andre verdenskrig
Ałhíʼayiiltááh	Matematikk
Aooméénii Bikéyah	Armenia
Ooljééʼ	Månen
Nahatʼeʼiitsoh Bikéyah	Australia
Béésh Łigaii Bikéyah	Argentina
Kolíya Bikéyah Náhookǫsjí Siʼánígíí	Nord-Korea
Naayééʼ	Dinosaurer
Naturalis Historia of Pliny the Elder	Naturalis Historia
Encyclopædia Britannica	Encyclopædia Britannica
Tó yaʼnidaʼaazgééd	Akvedukt
Chʼil łitsooí díkʼǫ́zhígíí	Sitron
Hashkʼaan (łitsooígíí)	Bananer
Sǫʼ	Stjerne
Jóhonaaʼéí	Solen
Háájiʼjin	Hydrogen
Níłchʼi Ászólí	Helium
Haʼaʼaahjí Tíímow	Øst-Timor
Séwes	Ceres (dvergplanet)
Haʼooméya	Haumea
Maakiimaakii	Makemake
Ééwis	Eris (dvergplanet)
Káábin	Karbon
Níłchʼi Yáʼátʼéehii	Oksygen
Hadoh dóó hakʼaz neiłkidígíí	Termometer
Níłchʼi Łitsxooí	Neon
Chihuahua Hahoodzo	Chihuahua (delstat)
Soodin	Natrium
Béésh Łikoní	Magnesium
Béésh Ászólí	Aluminium
Tó Wónaanídę́ę́ʼ Bitsįʼ Yishtłizhii Bikéyah	India
Tʼoobááloo	Tuvalu
Béésh (Fe)	Jern
Tʼónga	Tonga
Łeetsoii	Svovel
Samóa	Samoa
Sólomon Tó Bináhaazyínígíí	Salomonøyene
Banoʼáátʼoo	Vanuatu
Páápowa Bigíní Ániidí	Papua Ny-Guinea
Níłchʼi Dootłʼizhí	Argon
Eʼeʼaahjí Tónteel bikáaʼgi Kéyah Yázhí dah Ndaaʼeełgo Ałhidadiidzooígíí	Mikronesiaføderasjonen
Káálsiiyin	Kalsium
Dilyį́hí	Bly
Kílíbas	Kiribati
Chʼah Diʼilii Bikéyah	Mongolia
Fííjii	Fiji
Béésh doo Ńdiniichxíihii	Titan (grunnstoff)
Táłkááʼ Bighan Dineʼé Bikéyah	Venezuela
Méíin Hahoodzo	Maine
Łį́į́ʼ	Hest
Naaldeehii	Dyr
Sówinam	Surinam
Kéyah Nahasdzáán Ałníiʼgi Siʼánígíí	Ecuador
Kolámbiya	Colombia
Béésh Łibáhí	Kobolt
Bolíbiya	Bolivia
Béésh Łichíiʼii	Kobber
Niihémpshoo Hahoodzo	New Hampshire
Chʼosh doo yitʼíinii dláádí dóó Ábishjaaʼ	Sopper
Jaméíkʼa	Jamaica
Méésíchóoshish Hahoodzo	Massachusetts
Kanédikiʼ Hahoodzo	Connecticut
Naaʼahóóhai	Tamhøns
Antíígwa dóó Hashkʼaan Bikéyah Yázhí	Antigua og Barbuda
Kéyah Ałkéé Nitį́įgo Dah Ndaaʼeełí	Hawaii
Damóo Bikéyah	Dominica
Domingo Bikéyah	Den dominikanske republikk
Bisóodi	Gris
Héítii	Haiti
Iiwą́ą́	Iran
Iiwááʼ	Irak
Hakʼaz Dineʼé Bikéyah Hahoodzo	Alaska
Ízrel Bikéyah	Israel
Shádiʼááhjí Ásáí Bikéyah	Jemen
Jóoʼdan	Jordan
Gah Bikeeʼ Taahíʼahí	Florida
Kíígiz Bikéyah	Kirgisistan
Hoozdo Hahoodzo	Arizona
Kóóweiʼ	Kuwait
Lááʼos	Laos
Łíbanoo	Libanon
Óogin Hahoodzo	Oregon
Naakaii Dootłʼizhí Bikéyah Yázhí (Tó Bináhaazyínígíí)	Maldivene
Kéyah dah siʼánígíí	Amerika
Áshįįh Biiʼtó Hahoodzo	Utah
Béégashii	Storfe
Maléízha	Malaysia
Dziłgaiitsoh Honeezkʼazii Bikéyah	Nepal
Omą́ą́	Oman
Eʼeʼaahjí Naakaii Dootłʼizhí Bikéyah	Pakistan
Kʼatár	Qatar
Ásáí Bikéyah Saʼoodí	Saudi-Arabia
Swii Lankʼa	Sri Lanka
Sííwiya	Syria
Tʼajiʼ Bikéyah	Tadsjikistan
Tʼáí Bikéyah	Thailand
Kǫʼ naʼałbąąsii diné bee nágéhéʼ	Jernbanetog
Tʼóokmen Bikéyah	Turkmenistan
Ásáí Bikéyah Yázhí Ałhidadiidzooígíí	De forente arabiske emirater
Biʼednam	Vietnam
Kolíya Bikéyah Shádiʼááhjí Siʼánígíí	Sør-Korea
Óola	Gull
Naʼałkaahí	Naturviter
Bangla Bikéyah	Bangladesh
Angóola	Angola
Iiʼniʼ Tłʼiishtsoh Bikéyah	Bhutan
Bwoonéí	Brunei
Tʼanzanííya	Tanzania
Béésh Tózháanii	Kvikksølv
Kéyah Dańlíinii	Filippinene
Naakaii Łizhinii Bikéyah Beʼałnííʼ	Den sentralafrikanske republikk
Hastiin Albert Einstein	Albert Einstein
Tʼóogo	Togo
Hooghan Tsé Bee Ádaalyaaí Bikéyah	Zimbabwe
Shádiʼááhjí Soodą́ą	Sør-Sudan
Tswana Dineʼé Bikéyah	Botswana
Wóndii Dineʼé Bikéyah	Burundi
Ooljééʼ Bikéyah Yázhí	Komorene
Kéyah Káango Náhookǫsjí Siʼánígíí	Republikken Kongo
Kéyah Káango Shádiʼááhjí Siʼánígíí	Den demokratiske republikken Kongo
Jibótii	Djibouti
Gíní Nahasdzáán Ałníiʼgi Siʼánígíí	Ekvatorial-Guinea
Gabǫ́ǫ́ (Kéyah)	Gabon
Géémbiya	Gambia
Gíní	Guinea
Gíní Bisó	Guinea-Bissau
Chį́į́h Yee Adilohii Bideeʼ Tónteel Bibąąh	Elfenbenskysten
Táłtłʼááh Chʼosh Daadánígíí Bitooh (Łizhinii Bikéyahdi)	Kamerun
Tónteel Bibąąh Dootłʼizhí	Kapp Verde
Sotho Dineʼé Bikéyah	Lesotho
Łíbya	Libya
Madaʼgéésgáá	Madagaskar
Malááwii	Malawi
Moowitéínya	Mauritania
Moroko	Marokko
Namííbya	Namibia
Yogénda	Uganda
Wánda Dineʼé Bikéyah	Rwanda
Seishel	Seychellene
Náshdóítsoh Bitsiijįʼ Daditłʼooʼígíí Bidził	Sierra Leone
Soomáálii Bikéyah	Somalia
Soodą́ą	Sudan
Swáazi Dineʼé Bikéyah	Swaziland
Nahasdzáán Bikáaʼgi Kéyah Naaznilgo Ałhidadiidzooígíí	De forente nasjoner
Nidaashchʼąąʼígíí	Farge
Béésh Łigaii	Sølv
Béésh Dildǫʼí	Tinn (grunnstoff)
Łéétsoh	Uran
Hastiin alą́ąjįʼ dahsidáhígíí Bill Clinton	Bill Clinton
Míshigin Hahoodzo	Michigan
Tó Nitsaa Nílį́bąąh Hahoodzo	Illinois
Náhookǫsjí Dzígaii	Nord-Dakota
Ałnííʼjí Dzígaii	Sør-Dakota
Ayání Naakaii Hahoodzo	Montana
Tóʼííbézhí	Wyoming
Nímasii Kʼidadilyéhé	Idaho
Ahééhałtį́į́h Hahoodzo	Washington
Naʼazhǫǫsh Hahoodzo	Nevada
Kayíbíyinsíí (tónteel)	Det karibiske hav
Dibé Nitsaa Hahoodzo	Colorado
Naakaii bizaad	Spansk
Naʼashjéʼii	Edderkopper
Chʼosh bijáád tseebíhígíí	Edderkoppdyr
Chʼosh bijáád dahólónígíí	Leddyr
Béeso	Penger
Bijíniyah Hahoodzo	Virginia
Eʼeʼaahjí Bijiniyah Hahoodzo	Vest-Virginia
Kin Yótʼááh Deezʼá Hahoodzo	New York (delstat)
Wóód Áalin Hahoodzo	Rhode Island
Chʼosh bijáád hastání	Insekter
Méelin Hahoodzo	Maryland
Déláwee Hahoodzo	Delaware
Oohááyoo Hahoodzo	Ohio
Pénsówéíniyah Hahoodzo	Pennsylvania
Niijéízii Hahoodzo	New Jersey
Índíʼyéenah Hahoodzo	Indiana
Chidí	Bil
Jóojah Hahoodzo	Georgia (USA)
Akałii Bikéyah	Texas
Náhookǫsjí Kééláanah Hahoodzo	Nord-Carolina
Shádiʼááhjí Kééláanah Hahoodzo	Sør-Carolina
Méhigoʼ sídii	Mexico by
Mísísípii Hahoodzo	Mississippi
Ténésii Hahoodzo	Tennessee
Yootó Hahoodzo	New Mexico
Mínisóodah Hahoodzo	Minnesota
Wiskaansin Hahoodzo	Wisconsin
Haʼaʼaahjí Dzígaii	Iowa
Nabeeskah Hahoodzo	Nebraska
Shádiʼááhjí Dzígaii	Kansas
Tó Dzígaii Nílį́	Missouri
Tónteel Chʼínílį́	Louisiana
Kentákii Hahoodzo	Kentucky
Dził Biiʼ Dzígaii	Arkansas
Halgai Hóteel Hahoodzo	Oklahoma
Ho Chi Min Sídii	Ho Chi Minh-byen
Bilagáana bizaad	Engelsk
Náhookǫsjí Hakʼaz Dineʼé Bikéyah	Nunavut
1901 – 1950	1902
Tłʼiish	Slanger
1951 – 2000	1979
Pope Benedict XVI	Benedikt XVI
Maʼii Ashkii	Geronimo
Tsin naaʼeeł táłtłʼááh naagháhígíí	Undervannsbåt
Tahoniigááh	Influensa
Tłʼízí	Geit
Kǫʼ	Ild
Tʼááłáhági átʼéego:Templates	Kategori:Maler
Dloziłchííʼ	Ekorn
Tʼááłáhági átʼéego:Ndaaʼnaʼii	Kategori:Skjellkrypdyr
Tiníléítsoh	Komodovaran
Chʼosh bijáád neeznánígíí	Tifotkreps
Aymara bizaad	Aymara (språk)
Łeeyiʼ chʼoshtsoh binááʼ hólónígíí	Ormepadder
Tʼááłáhági átʼéego:Dééł dóó Tóidoozohii	Kategori:Tranefugler
Médíwííyin Sii	Middelhavet
Jóojah (Ałtsʼáʼáztiin)	Georgia (andre betydninger)
Alóós	Ris
Tsídii	Fugler
Kéłánii bikágí yilzhólígíí	Fløyelsdyr
Kéchwa bizaad	Quechua
Ínsadoobíídiiya	Encyklopedi
Íiyisíí Naaltsoos	Portal:Forside
Dziłgaiitsoh Honeezkʼazii	Himalaya
Tʼááłáhági átʼéego:Candidates for speedy deletion	Kategori:Sider som er foreslått raskt slettet
Chʼil ahwééh	Te
Kéyah Sahééwa Eʼeʼaahjí Siʼánígíí	Vest-Sahara
1801 – 1850	1815
Łį́į́ʼ Bideeʼłáaʼii	Enhjørning
Hastiin Hernán Cortés	Hernán Cortés
Tsʼíʼii daʼaneezí	Stikkemygg
Dibé	Tamsau
Łóóʼ hashkéhé	Haier
Ghą́ą́ʼaskʼidii	Kameler
Bidił Daazdoígíí dóó Daʼałtʼoʼígíí	Pattedyr
Bíchį́į́h yee adilohii	Elefanter
Mágí dóó Mágí Ndahalinígíí	Primater
(*wálá-)	Maur
Tsísʼná	Bier
Naayízítsʼósí	Squash (frukt)
Jiłtʼoʼí	Rabarbra
Sęęschʼil	Blomkål
Ayęęzhii yiltʼąąʼí	Aubergine
Naalʼeełí	Andefamilien
Yas	Snø
Jádí dághaaʼígíí	Gnuer
1851 – 1900	1865
Biʼééʼ Łichííʼí bizaad	Russisk
1751 – 1800	1784
Bááh	Brød
Bee Hazʼą́ą Ił Chʼétʼaah	Menneskerettighetserklæringen
Kéyah haʼdéísná	Jordskjelv
Tó nitéél nitságoʼ atságáá	Tsunami
Níyoltsoh	Tornado
Saad bee alʼį́į́hni	Skriftsystem
Tʼááłáhági átʼéego:Dáághahii	Kategori:Frankrike
Mąʼii łitsooí	Rødrev
Naaltéʼ	Slaveri
Ahwééh	Kaffe
Abeʼ	Melk
Dził	Fjell
Doo Nidahałtingóó	Ørken
Cryptographic	Kryptografi
Guadalajara	Guadalajara
Tsídii naʼałkʼaiʼí	Pingviner
Kolíya Dineʼé bizaad	Koreansk
Tó niteel	Verdenshav
Hodíłchʼil Níłtsánígíí	Regnskog
HiTSʼezh	IPod
Hazéí	Ekornfamilien
Ééʼ néíshoodí	Den katolske kirke
Kwį́į́n Elizabeth II	Elisabeth II av Storbritannia
Hastiin alą́ąjįʼ dahsidáhígíí Ronald Reagan	Ronald Reagan
Hastiin Emperor Yongle	Yongle-keiseren
Naʼashjéʼiitsoh	Lycosidae
Naaldlooshii dadichʼízhii	Krypdyr
Tsin Deigházhígíí	Gnagere
Hasbídí	Duer
Tééh hóyáanii	Niser
Biyáázh Tsʼǫʼasánígíí (Táyiʼ dóó Niʼkáágóó Ndaakaaígíí)	Amfibier
Géeso	Ost
Chʼil naʼatłʼoʼii (chʼiyáán)	Druer
Tsísʼná bitłʼizh	Honning
Atsįʼ	Kjøtt
Naʼashjéʼii tsiizisí	Pholcidae
Nímasii	Potet
Áshįįh łikan	Sukker
Haʼałtsédii	Nøtt
Wááshindoon bisiláołtsooí	USAs forsvar
Naʼiiniʼ bá Hooghantsoh	Verdens handelssenter i New York
Wááshindoondi bee hazʼáanii ádeiłʼíní	Kongressen (USA)
Tsin naaʼeeł	Skip
Nidaʼąnyéézh	Vanning
Naadą́ą́ʼ	Mais
Naʼashchʼąąʼ	Malerkunst
Wótáahgoo ałnaaʼáłtʼahiʼ	Romfarer
Azhish	Dans
Naʼashjéʼii nahachaʼígíí	Hoppeedderkopper
Kéyah Daʼnaaznilígíí	Liste over stater
Shash	Bjørnefamilien
Hastiin alą́ąjįʼ dahsidáhígíí John Adams	John Adams
Hastiin alą́ąjįʼ dahsidáhígíí Thomas Jefferson	Thomas Jefferson
Hastiin alą́ąjįʼ dahsidáhígíí Andrew Jackson	Andrew Jackson
Ńdíshchííʼ	Furuslekten
Tłʼoh naadą́ą́ʼ	Hveteslekten
Naałniih yichʼą́ą́h naabaahígíí bąąh dahooʼaahgo	Aids
Abeʼ bee neezmasí	Crêpe
Jéíʼádįįh	Tuberkulose
Łóódtsoh	Kopper (sykdom)
Zelda bahaneʼ	The Legend of Zelda
Naakáí dinéʼiʼ biempire Méhigodi	Aztekere
Łéétsoh bee atsiniltłʼish álʼį́	Kjernekraft
Łéétsoh beeʼeldǫǫhtsoh beeʼalį́į́h	Kjernefysiske våpen
Chidí naaʼnaʼí beeʼeldǫǫh bikááʼ dah naaznilígíí	Stridsvogn
Dah woozh	Hagejordbær
Jalisco Hahoodzo	Jalisco
Mágí bichʼiyąʼ	Kokospalme
Dzidzétsoh	Fersken
Chʼil łitsxooí	Appelsin
Chʼil dishooí	Kiwi (frukt)
Chʼil dootłʼizhí díkʼǫ́zhígíí	Lime
Abeʼ yistiní	Iskrem
Méhigo bizaad	Nahuatl
Diné bizaad	Navajo (språk)
Jeeʼiighááh	Saksedyr
Tenochtitlan	Tenochtitlan
Ásáí Bizaad	Arabisk
Honeezílígi	Subtropisk klima
Atʼaʼ yiltʼąąʼí	Palmer
Niłchiis	Jerv
Tsin yilátah ayání	Sjiraff
Naalʼeełídaaʼí	Nebbdyr
Naʼashǫ́ʼii	Øgle
Béésh bee akʼeʼelchí áłtsisígíí	Personlig datamaskin
Wikiibíídiiya:Naaltsoos nizhónígo ádaalyaaígíí	Wikipedia:Utmerkede artikler
Bimááʼ Hahoodzo	Vermont
Hoozdoh	Phoenix
Táłkááʼ tsʼin bíchį́į́hnézí	Gangesgavial
Tsin naaʼeeł chidí naatʼaʼí bee nágéhéʼ	Hangarskip
Tsídiitsoh	Struts
Kolíya bikéyah (Ałtsʼáʼáztiin)	Korea
Mąʼiitsoh	Ulv
Chʼídeeldlóohiitsoh	Treskonebb
Hodíłchʼilgi dlǫ́ʼiitsoh	Asiatisk palmesivett
Tóidoozohii bidaaʼ łichííʼígíí	Sivhøne
Táłtłʼááh yilcháazhii	Svamper
Tónteel naʼashjéʼii	Havedderkopper
Séigoʼ bíláshgaanézí	Amblypygi
Naʼashjéʼii jáádnézí	Vevkjerringer
Séigoʼchilí bitseeʼ ádinígíí	Mosskorpioner
Séigoʼ	Skorpioner
Zahalchíʼii	Solifugae
Hastiin Emperor Qianlong	Qianlong-keiseren
Séigoʼ bitseeʼ áłtsʼózígíí	Thelyphonida
Yaaʼ doo yitʼíinii	Midder
Hodíłchʼilgi naaʼahóóhai	Tinamuer
Tłʼiishkʼosí (tsídii)	Slangehalsfugler
Télii	Afrikansk villesel
Náshdóítsoh noodǫ́zígíí	Tiger
Kʼíneeshbízhiinééz	Spaghetti
Chʼosh yoołgai bitsʼaʼígíí	Ekte østers
Tábąąhgi łeeyiʼ chʼosh	Fjæremark
Azeeʼ hókániitsoh	Veitistel
Táłkáaʼgi Tsídii	Andefugler
Tązhii dóó Naaʼahóóhai Ndahalinígíí	Hønsefugler
Naalʼeełii keelóól	Lappedykkere
Tsídii Deílʼésígíí	Storkefugler
Daʼałtʼoʼígíí Biyęęzhii Deiłchíhígíí	Kloakkdyr
Adijiłii bíchį́į́hnézí	Maurpiggsvin
Biyázhí neiyéhé	Pungrotter
Chidí bikʼah	Petroleum
Chéłchaaʼ	Biller
Łį́į́ʼ ałchiní	Przewalskihest
Shash naʼazísí	Vombater
Nahatʼeʼiitsohchilí	Rottekenguruer
Náʼagéédí łichíiʼii	Gullmoldvarper
Bįįh Danilínígíí	Hjortedyr
Tin	Is
Tłʼohchin díchʼííʼí	Hvitløk
Taʼneeskʼání áłtsʼóózígíí	Agurk
Tłʼohchin (chʼil daadánígíí)	Vanlig løk
Chʼil łichxíʼí	Tomat
Béésh Łichíiʼii Bikéyah Náhookǫsjígo Siʼanígíí	Nord-Kypros
Naʼazhǫǫsh Hátsoh	Las Vegas
Náshdóí dilwoʼí	Gepard
Tsékǫʼ	Kull
Néʼéshjaaʼ	Ugler
Bíígháán Dahólónígíí	Virveldyr
Kʼishchííʼ	Bjørkeslekten
Ǫǫbǫʼii	Hærfugl
Náshdóí Ndahalinígíí	Kattefamilien
Yádiłhił yiiyídíʼ nahosdzáán yináádáłiʼ	Den internasjonale romstasjonen
Tó wónaanídę́ę́ʼ toohjįʼ noołnahii	Gråhegre
Hashkʼaan dijéʼé	Daddelpalme
Wááshindoon (Ałtsʼáʼáztiin)	Washington (andre betydninger)
Bidił Daazdoígíí dóó Daʼalghałígíí	Rovpattedyr
Chʼoshtsoh	Kakerlakker
Dlǫ́ʼii yázhí	Snømus
Tsʼíʼii dóó Tséʼédǫ́ʼii	Tovinger
Biniiʼłigaii (néʼéshjaaʼ)	Tårnugle
Mąʼii Ndahalinígíí	Hundefamilien
Bijáád Ádaadinígíí	Bløtdyr
Chʼosh łitsxooí dóó Chʼosh łichííʼí	Marihøner
Táłkááʼ naalzheehí	Fiskeørn
Bizaʼazis Dahólónígíí	Pungdyr
Dlǫ́ʼiiłgaii	Røyskatt
Naalʼeełí bitsiiʼ dootłʼizhí	Stokkand
Sǫʼ łóóʼ	Sjøstjerner
Giníłbáhí	Hønsehauk
Tʼádootłʼizhii	Nøtteskrike
Zhį́ʼii	Ravn
Táłkááʼ tsʼin Danilínígíí	Krokodiller
Chʼosh bikágí dantłʼizí	Krepsdyr
Dééł	Traner
Chʼosh bitsʼaʼígíí	Muslinger
Atsá dóó Giní Ndahalinígíí	Rovfugler
Łóóʼ ooshgę́ęzhii	Bruskfisker
Tániilʼáí	Øyenstikkere
Wóláchííʼ yildeełí bikágí ntłʼizí	Skjelldyr
Gah Danilínígíí	Haredyr
Tsísʼnátsoh	Humler
Hazéí yiltseeʼí	Ryllik
Chʼosh bikǫʼí	Lysbiller
Zéédzísgaii	Fasan
Dlǫ́ʼii Ndahalinígíí	Mårfamilien
Tsin yiłkaałii	Hakkespetter
Bideeʼtsʼinígíí	Okser
Dééł dóó Tóidoozohii Ndahalinígíí	Tranefugler
Gáagii dóó Joogii Ndahalinígíí	Kråkefugler
Chʼiltaatʼagii	Myrhauk
Tsin naaʼeeł diné bee nágéhéʼ	Ferje
Gad	Einerslekten
Jááłánii	Mangefotinger
Biishchʼid Dahólónígíí	Placentale pattedyr
Chʼosh Deildeełii	Insektetere
Tó wónaanídę́ę́ʼ naalʼeełítsoh łibáhígíí	Grågås
Tónteel dóó Tábąąhgi Tsídii	Vade-, måse- og alkefugler
Ńdíshchíitah dlǫ́ʼii	Mår
Biyaatsʼiin Dahólónígíí	Kjevemunner
Tooh łéʼétsoh	Bisam
Chaatʼíní	Engsyre
Łóóʼ hashkéhé dootłʼizhígíí	Blåhai
Wóʼatsʼǫǫsii Ádaatʼéhígíí	Nebbmunner
Atsáłgaii	Fjellvåk
Béégashiiʼilí	Jak
Tó wónaanídę́ę́ʼ dlǫ́ʼii	Ilder
Tsxį́į́łnaalkʼįhii	Seilerfamilien
Dziłditłʼoii Bił Hahoodzo	San Juan County (Utah)
Hakʼaz naalʼeełí	Ærfugl
Naalʼeełítsoh bitsiiʼ halzhinígíí	Kanadagås
Chʼó	Granslekten
Łóóʼtsoh łizhin dóó łigaígíí	Spekkhogger
Téél dzítsooii dóó Tsétah chʼosh	Løpebiller
Naalʼeełítsoh diłhiłígíí	Ringgås
Tábąąh dlǫ́ʼii	Mink
Tábąąstííntsoh łibáhígíí	Havert
Naakaii Łizhiní Bikéyahdi Hadahóólįįdígíí	Afrotheria
Łį́į́ʼ bitsísʼná	Bremser
Tónteel tsídii	Måker
Ałtį́į́ jikʼáshí (chʼil)	Sneller
Hazaʼaleehtsoh (dííshjį́ ááłjiní)	Selleri
Kʼaalógii dóó Iichʼąhii	Sommerfugler
Díłdánii yił aheełtʼéhii	Vaktel
Chʼałdą́ą́ʼ / Jádí nátʼoh (chʼil daadánígíí)	Asparges
Tséʼédǫ́ʼii dootłʼizhí	Spyfluer
Jaaʼabaní Danilínígíí	Flaggermus
Wóónałchídii	Smellere
Tsídii bidaanézí	Storker
Lókʼaaʼ	Takrør
Tsídiiłbáhí	Spurvefamilien
Biłʼeʼeliníʼ	Bakepulver
Táłtłʼááh chʼoshchilí	Krill
Tsiiʼyiishbizhí Dinéʼiʼ Bikéyah	Kina
Naalʼeełí binááʼ łitsooígíí	Kvinand
Tábąąstíín	Oter
Jélii łóóʼ	Manet
Náshdóíłgaii łikizhígíí	Snøleopard
Tábąąstííntsoh Danilínígíí	Seler
Dlǫ́ǫ́ʼ	Præriehunder
Náshdóí bijaałizhiní	Karakal
Tsídii yáłtiʼí	Papegøyefugler
Tééh łį́į́ʼ	Sebra
Náshdóí łikizhígíí	Ozelot
Dííłdzid jeeshóóʼ	Åtselgribb
Tʼáadoo leʼé danílʼį́ bił hazʼą́	Museum
Shash łizhin dóó łigaígíí	Panda
Shash łigaígíí	Isbjørn
Gaantsʼosí	Sjøliljer
Hastiin alą́ąjįʼ dahsidáhígíí Theodore Roosevelt	Theodore Roosevelt
Neeshchʼííłgai	Kasjutre
Beeʼódleehí	Felle
Dilní bee Nidaʼanéhígíí	Musikkinstrument
Dééłgai	Svaner
Bikááʼ náʼoobałí	Helikopter
Dziʼizítsoh	Motorsykkel
Tééhoołtsódii	Vanlig flodhest
Séí	Sand (materiale)
Naakaii Łizhiní Bikéyahdę́ę́ʼ náshdóítsoh łikizhígíí	Leopard
Déélgééd	Neshorn
Beeʼeldííl Dahsinil	Albuquerque
Hashkʼaan dootłʼizhí (babáayah)	Papaya
Náshdóítsoh	Puma
Ásáí dinéʼiʼ	Arabere
Deeteel	Elg
Shádiʼááhdę́ę́ʼ náshdóítsoh łikizhígíí	Jaguar
Lókʼaatsoh	Bambus
Káango (Ałtsʼáʼáztiin)	Kongo
Kʼaiʼ	Vierslekten
Shash bizaʼazis hólóní	Koala
Náshdóí kʼos bee naashchʼąąʼígíí	Treleopard
Shashtsoh	Brunbjørn
Łéʼétsoh	Rotter
Akʼáán	Mel
Mágítsoh	Gorilla
Bitsįʼ yishtłizhii	Amerikanske urfolk og stammefolk
Chʼil akʼahí	Avokado
Neeshchʼííłbáhí	Peanøtt
Dzidzétsoh díkʼǫ́ǫzhii	Aprikos
Naʼashǫ́ʼii łahgo ánééhé	Kameleoner
Yootó	Santa Fe
Łééchąąłgaii	Greyhound
Nahatʼeʼiitsoh Bikéyahdę́ę́ʼ łééchąąʼí ałchiní	Dingo
Chʼééhjiyáán	Vannmelon
Teide	Teide
Naʼastsʼǫǫsí	Mus (slekt)
Hakʼaz bįįh	Rein
Chʼosh doo yitʼínii	Mikroorganisme
Táshchozhii	Svaler
Neeshchʼííʼ hááheeshchiiʼí	Mandel
Chʼosh bikágí ntłʼizí	Krabber
Tábąąstííntsoh bideeʼ hólónígíí	Hvalross
Mágí diʼilí	Orangutang
Atsátsoh	Kongeørn
Chʼil łitsxooí ntsxaaígíí	Grapefrukt
Kʼíníjíłʼahí (dííshjį́ ááłjiní)	Stikkelsbær
Kʼaalógiiłgaígíí	Hvitvinger
Naʼastsʼǫǫsí binááʼ áłtsʼíísígíí	Spissmus
Dzaanééz	Muldyr
Tsinlátah shash łichíʼígíí	Rød panda
Tsídii jáádnézí	Flamingoer
Tééh łééchąąʼí	Hyenefamilien
Łóóʼtsoh dootłʼizhígíí	Blåhval
Sóól	Lønneslekten
Aghaaʼ	Ull (tekstil)
Deesdoigi	Tropene
Shádiʼááhdę́ę́ʼ tłʼízí	Lama
Mósíʼilí	Perser
Lókʼaatah mósí ałchiní	Jungelkatt
Náátsʼózídę́ę́ʼ mósíłkizhii ałchinígíí	Leopardkatt
Náshdóítʼą́ʼí łikizhígíí	Serval
Tábąąh béégashii	Vannbøffel
Béégashiitsoh naʼałkǫ́ǫ́ʼígíí	Manater
Hastiin Leiw Éíwiksson	Leiv Eiriksson
Akágí yitsʼǫǫsii	Igler
Anáʼálwoʼ:TʼAN (FAQ)	Wikipedia:OSS
Táłkááʼ tsʼin	Egentlige krokodiller
Chidítsoh	Lastebil
Dlǫ́ʼiitsoh áłtsʼózígíí	Genetter
Tó wónaanídę́ę́ʼ náshdóí	Gaupe
Jááłánii (bitsiitsʼiin nteelígíí)	Skolopendere
Giní	Falker
Dahiitį́hii	Kolibrier
Tsídii biyęęzhtsohígíí	Kivier
Tązhii	Kalkuner
Chʼosh (Bíígháán Ádaadinígíí)	Virvelløse dyr
Mąʼii	Prærieulv
Dah Naatʼaʼí Sǫʼ bił Sinil	The Star-Spangled Banner
Akʼah sisíʼí tsin	Eukalyptusslekten
Gahtsoh	Harer
Bisóodi bíchį́į́h nineezí	Jordsvin
Sonora Hahoodzo	Sonora
Nahakʼízii	Ekte sirisser
Chaaʼ	Bevere
Chʼilzooł	Brokkoli
Kááʼtsʼiní	Beltedyr
Atsʼiis naałdzid	Lungekreft
Yágháhoníkáángóó ałánátʼahí	Romferge
Béésh náábałí atsiniltłʼish ííłʼínígíí	Vindkraftverk
Méhigo tééh	Mexicodalen
Shą́ą́ʼnahalghałí (naaldeehii)	Klippegrevlinger
Nahatʼeʼiitsoh łichíiʼii	Rød kjempekenguru
Azeeniłchin	Leppeblomstfamilien
Chʼał	Springpadder
Tsxilghááh	Salamandere
Shádiʼááhdę́ę́ʼ atsátsoh	Harpyørn
Shádiʼááhdę́ę́ʼ chʼał kʼaasdáhígíí	Pilgiftfrosker
Chʼał dichʼízhí	Ekte padder
Tónteel tsídiitsoh	Albatrosser
Chidí nadlééh	Kabriolet
Bisóodi ałchiní	Villsvin
Mariner 10	Mariner 10
Sǫʼ łóóʼ bigaanézí	Slangestjerner
Dághaałóóʼ	Maller
Łóóʼtʼą́hí	Flyndrefisker
Toohjįʼ ndiigaii	Snøhegre
Kʼaalógii bitseeʼ hólóní	Svalestjerter
Mágí binááʼtsohígíí	Spøkelsesaper
Tó wónaanídę́ę́ʼ dlǫ́ʼiiłkizhii	Marmorilder
Díłdánii	Tannvaktler
Táłtłʼááh łį́į́ʼ	Sjøhester
Łóóʼ bíígháántsiighąąʼ ádaadinígíí	Slimåler
Tó wónaanídę́ę́ʼ dzeeh	Hjort
Kinłání (Hoozdoh Hahoodzo)	Flagstaff
Michoacán Hahoodzo	Michoacán
Táłtłʼááh chʼosh daadánígíí	Reker
Mágíshzhin	Sjimpanser
Łóóʼntsxaaí łikizhígíí	Hvalhai
Dlǫ́ʼii yił Aheedaałtʼéhígíí	Mungofamilien
Béésh Bichʼahníí Bikéyahdę́ę́ʼ ayání	Visent
Łóóʼtsoh bitsiiʼ dikʼání	Spermhval
Waaʼ (dííshjį́ ááłjiní)	Spinat
Néʼéshjaatsoh	Amerikahubro
Shádiʼááhdę́ę́ʼ tłʼízíʼilí	Alpakka
Bijáád noodǫ́ǫzii	Okapi
Méhigo Hahoodzo	México (delstat)
Ayání	Amerikansk bison
Mąʼiiłgaii	Fjellrev
Táłtłʼááh chʼosh chʼééh digháhii bideetsohígíí	Anaspidea
Gólízhii Danilínígíí	Stinkdyrfamilien
Táłtłʼááh adijiłii	Sjøpiggsvin
Nahachagii	Gresshopper
Tsídiitsoh ditsʼozígíí	Emu
Ałhaʼdeetʼaah	Avtale
Naayééʼ tsídii	Urfugler
Tsísʼná (bitłʼizh ííłʼínígíí)	Honningbier
Chééwokii dinéʼiʼ	Cherokee
Tsin naaʼeeł hééł bee nágéhéʼ	Lastebåt
Ałtį́į́ jikʼáshí áłtsʼózígíí (chʼil)	Åkersnelle
Yéigo ałhoshii	Syvsovere
Naʼashjéʼii bijéí dah łichíiʼii	Sort enke
Mágí dághaaʼígíí	Keisertamarin
Naałání	Comanche
Oozéí / Ayahkinii	Hopi
Toohjįʼ noołnahiitsoh	Goliathegre
Bidááʼ Haʼaztʼiʼ Tsékooh	Grand Canyon
Táłtłʼááh naʼashjéʼii	Vannedderkopp
Táłtłʼááh tsisteełtsoh	Havlærskilpadde
Tsídii yáłtiʼí yázhí	Undulat
Tábąąh mąʼii	Vanlig vaskebjørn
Hołchʼíʼí	Brennesler
Tsįdláád	Strylav
Shash łizhinígíí	Amerikansk svartbjørn
Náshdóí bizaʼazis hólóní	Pungulv
Shash bitéélgaígíí	Asiatisk svartbjørn
Chʼoshtʼą́hí	Flatormer
Hashtłʼish jeeshóóʼ	Lammegribb
Jádí bíchį́į́htsohígíí	Saigaantilope
Táłtłʼááh chʼoshtsoh chʼééh digháhii	Sjøpølser
Tsísʼná bizǫ́ǫ́z ádinígíí	Broddløse bier
Chidí naatʼaʼí dilwoʼí	Jagerfly
Bíchį́į́h naatsʼǫǫdí	Tapirer
Tó wónaanídę́ę́ʼ mąʼii	Gullsjakal
Chʼóshgai (tsin)	Kvitgran
Łóóʼ Bigaan Dahólónígíí	Blekkspruter
Naʼashǫ́ʼii łóóʼ	Ålefisker
Dahbaʼ (tsin)	Askeslekten
Łóóʼ hashkéhétsoh	Hvithai
Neeshchʼííłchííʼ	Kastanjeslekten
Chį́į́hnézí nahatʼeʼígíí	Springspissmus
Táłtłʼááh ayání	Dugong
Dibé Diníí Bikéyahdę́ę́ʼ náshdóí	Pantergaupe
Toohjįʼ ndiigaiitsoh	Egretthegre
Wóóneeshchʼįįdii	Sangsikader
Dééshzhiin	Svartsvane
Naakaii náásééł	Knelere
Dlǫ́ǫ́ʼ ntsxaaígíí	Flodsvin
Mąʼii bijaaʼtsohí	Fennek
Dilchaʼ	Murmeldyr
Díwózhii	Sarcobatus
Náshdóí łibáhígíí	Rødgaupe
Chʼilhaatʼaʼii	Dvergfalk
Tééh hóyáaniitsoh	Hvithval
Jádí bideeʼ yisdizígíí	Impala
Náátsʼózídę́ę́ʼ mąʼiiłchííʼ	Asiatisk villhund
Łóóʼtsoh bighą́ą́ʼ yílkʼidígíí	Knølhval
Ghą́ą́ʼnaakiskʼidii	Baktriakamel
Tábąąh mąʼiiniiʼí	Mårhund
Naʼazhǫǫsh (ndajiné dóó adazhdikaʼgi)	Kasino
Dlǫ́tʼą́ʼí	Surikat
Kéchwa dinéʼiʼ	Quechuafolket
Mąʼii bizaʼazis hólóní	Tasmansk djevel
Shash bítááʼłgaígíí	Brillebjørn
Naatʼáanii Moctezuma II	Moctezuma II
Ásáí dinéʼiʼ bikéyah	Den arabiske verden
Shash yázhí	Malayabjørn
Shash ndilnaʼii	Leppebjørn
Chʼódeenínii	Blågran
Łéʼétsoh yiljaaʼí	Soleieslekta
Hakʼaz náshdóí	Kanadisk gaupe
Mąʼii yił Ałhidanoolinígíí Yázhí	Halvbjørnfamilien
Béésh Bichʼahii beʼakétłʼóól dijoolí	Knutekål
Tłʼoh waaʼí nahalinígíí	Hvitkløver
Tábąąstííntsoh dághaaʼígíí	Storkobbe
Atʼééké bijish yázhí	Rosenkål
Tsékooh	Canyon
Noodah	Agave
Łeeʼdoolʼeezí	Snylterotfamilien
Kinteel Bił Hahoodzo	San Juan County (New Mexico)
Beeʼeldííl Dahsinil Bił Hahoodzo	Bernalillo County
Aniłtʼánii	Nettvinger
Kʼaalógii bijáád dį́įʼii	Flikvinger
Nímasii yiyání	Coloradobille
Awééʼchíʼí (chʼil)	Klokkeslekten
Naaʼołí yiltʼąąʼí	Erteknappslekta
Chʼilátah atsʼos	Mjølkeslekta
Kʼish	Gråor
Naaztání	Korstorn
Tsinyaa tłʼoh	Rapp
Wóóseekʼidii	Svermere
Díkʼǫ́ǫ́zhí (chʼil)	Melde
Tʼąąʼdoolghasí	Gåsemure
Láʼashdlaʼ	Klatre-villvin
Tséyaa hataałí	Kålrot
Tłʼohtsʼózí	Siv (planter)
Tłʼoh dichʼíízh	Starrslekta
Shashdą́ą́ʼ	Berberis
Tłʼoh waaʼítsoh	Hvitsteinkløver
Bįįh yildeeʼí	Lyktslekta
Kʼaalógii bitʼaʼ ndikʼąʼ nahalinígíí	Glansvinger
Hosh niteelí	Opuntia
Chʼał nineezí	Amerikansk oksefrosk
Tééh hóyáanii bíchį́į́htsahí	Narhval
Mágí bíchį́į́htsohígíí	Bavianer
Bįįh łikizhígíí (Béésh Bichʼahníí Bikéyahdę́ę́ʼígíí)	Dåhjort
Nátʼostsoh	Filtkongslys
Kʼįįshzhíní	Virginiahegg
Naʼashjéʼiichʼil	Smånøkkel
Tsáʼásziʼ nteelí	Yucca gloriosa
Łóóʼ bíchį́į́h nineezí	Sverdfisk
Binááʼ Ádaałtsʼózí bichʼil łigaií	Kinakål
Azeedíchʼííʼ	Paprikaslekta
Kolíya Tááʼ Bikéyahą́ą	Koreas tre kongedømmer
Łeehdoolʼeez łichííʼí	Rødbete
Hashkʼaantsoh yiltʼeesígíí	Kokebanan
Iiʼnótʼį́į́	Infeksjon
Chʼah Diʼilii Bikéyahdę́ę́ʼ mósí ałchinígíí	Pallaskatt
Jááłánii (bikágí ntłʼizígíí)	Tusenbein
Iichʼąhii ntsxaaígíí	Atlasspinner
Łóóʼ ńdídzihígíí	Lungefisker
Chʼíshiibeezhii	Meisefamilien
Giní jáádnézí	Sekretærfugl
Hakʼaz néʼéshjaaʼ	Snøugle
Shádiʼááhdę́ę́ʼ jeeshóóʼ	Andeskondor
Chidí naatʼaʼítsoh beeʼeldǫǫh bikǫʼ neiyéhé	Bombefly
Shash bighą́ąʼgi hadzíbáhí	Grizzlybjørn
Ndíyíliitsoh	Solsikke
Naaʼahóóhaiłkizhígíí	Perlehøns
Tłʼiish yighání	Honninggrevling
Dadilhóni aheltłʼidígíí	Håndgranat
Naakaii Łizhiní Bikéyahdę́ę́ʼ łééchąąʼí ałchiní	Afrikansk villhund
Aniłtʼánii (tʼááłaʼajínígoʼígíí)	Døgnfluer
Ayánítsoh bighą́ą́ʼaskʼidígíí	Gaur (kveg)
Máaz yikááʼ nandahí Spirit	Spirit (Mars-rover)
Naʼníʼá Hótsaadi atsiniltłʼish bá hooghan	Navajo kullkraftverk
Hakʼaz giníłgaii	Jaktfalk
Tsétah jeeshóóʼ łibáhí	Gåsegribb
Tééh łééchąąʼí łikizhígíí	Flekkhyene
Yaaʼ dóó chʼosh bíchį́į́h dadichʼízhí	Krassere
Beeʼeldǫǫh	Muskett
Chʼosh bitsʼaʼígíí bigaan dahólónígíí	Armføttinger
Tʼąąʼdoolghasí (daadánígíí)	Endivie
Dlǫ́ʼii (bílaʼashdlaʼii bilį́į́ʼ)	Fritte
Łóóʼtsoh łibáhígíí	Gråhval
Chʼah Diʼilii Bikéyahdę́ę́ʼ atsátsoh	Steppeørn
Yiisnááh	Krigsfange
Dzeeh	Wapiti
Nátʼoh (chʼil)	Tobakksplante
Tsin naaʼeeł bee daʼahijighánígíí	Slagskip
Tsísʼná yiyání	Bietere
Bisóodi bizęęs dį́įʼii	Vanlig vortesvin
Nahachagii biyázhí	Bladlus
Naalkʼįhiitsoh	Skjermflygere
Łóóʼ naatʼaʼí	Flygefisker
Hakʼaz ayání	Moskusfe
Tsétah gah	Pipeharer
Mąʼiitsoh bikʼos bineʼdę́ę́ʼ łizhinígíí	Mankeulv
Iichʼąhiitsʼósí	Vårfluer
Kéyah Dańlínídę́ę́ʼ atsátsoh	Filippinsk apeørn
Tábąąstííntsoh bíchį́į́htsohígíí	Elefantsel
Łóóʼntsxaaí díníchʼahii	Brugde
Chʼosh yighání	Jordulv
Mágí bitseeʼ noodǫ́zígíí	Ringhalelemur
Táyiʼ chʼoshnézí	Slimormer
Tó naagoʼ	Dråpe
Dlǫ́ʼiitsoh Danilínígíí	Snikekattfamilien
Mágí bigaanézí	Gibboner
Bílaneezii	Fingerdyr
Séí mąʼii	Stepperev
Naalʼeełítsoh bitéél halchíʼí	Rødhalsgås
Jádí	Prærieantilope
Wónikǫsí	Spøkelsesinsekter
Tééh łééchąąʼí noodǫ́zígíí	Stripehyene
Tsídiiłchxoní	Hoatsin
Táłtłʼááh chʼoshtʼą́hí bikááʼtsʼinígíí	Leddsnegler
Mąʼii bighą́ąʼgi hadzíjiní	Svartrygget sjakal
Naakaii Łizhiní Bikéyahdę́ę́ʼ mąʼiiłchííʼ	Etiopisk ulv
Tsétah dibé	Tykkhornsau
Dibé dóó Tłʼízí Ndahalinígíí	Sauer og geiter
Mágí bíchį́į́h dootłʼizhígíí	Mandrill
Tó wónaanídę́ę́ʼ dibé ałchiní	Muflon
Bįįhyázhí biwooʼnézí	Moskushjort
Dzeeh łikizhígíí	Sikahjort
Tábąąh mósí ałchiní	Fiskerkatt
Shádiʼááhdę́ę́ʼ hodíłchʼil mąʼii	Bushhund
Hakʼaz mágí	Japanmakak
Mágí bíchį́į́h niilyoolígíí	Neseape
Shádiʼááhdę́ę́ʼ tsídiitsoh	Stornandu
Náátsʼózídę́ę́ʼ mósíłtsxooí ałchinígíí	Asiagullkatt
Łóóʼnteeltsoh	Månefisk
Gaanłáníchilí dóó Gaanłání doo yitʼíinii	Hydra (nesledyr)
Chʼoshkʼaaʼ	Pilormer
Tábąąh bįįh	Vannrådyr
Hodíłchʼil jeeshóóʼ	Kongekondor
Dlǫ́ǫ́ʼ bitseetłʼooígíí	Chinchillaer
Néʼéshjaaʼ bíńdáhii	Haukugle
Bitseeʼ yee adiłhałii	Amerikansk alligator
Níyolgi naatʼaʼígíí (tónteel tsídii)	Stormsvaler
Tádídíín yiyání	Bladbiller
Yílnoodii (łóóʼ)	Barracudaer
Chʼosh bitsʼaʼłáaʼii	Urbløtdyr
Naʼashǫ́ʼii łóóʼ hashkéhé	Kragehai
Chʼosh dilwoʼígíí	Sandjegere
Chʼosh doo yitʼíinii bee nílʼíní	Mikroskop
Joogii	Blåskrike
Łeeyiʼ nahakʼízii	Jordsirisser
Náátsʼózídę́ę́ʼ naalʼeełí	Mandarinand
Mąʼii bijaaʼabanígíí	Ørehund
Tsídiitsoh bikʼos dootłʼizhí	Kasuarer
Atsiniltłʼish ííłʼíinii (naʼashǫ́ʼii łóóʼ)	Elektrisk ål
Dįʼ	Skoghøns
Łeeyiʼ tłʼiish áłtsʼíísígíí	Ormeslanger
Niicháadii (łóóʼ)	Kulefisker
Tééhoołtsódiichilí	Dvergflodhest
Wóláchííʼ yildeełítsoh	Kjempemaursluker
Bináʼadaałtsózí bitsin naaʼeeł	Djunke
Níłtsą́goʼ (bideeneezígíí)	Trebukker
Tséʼédǫ́ʼii bitsiinézí	Skorpionfluer
Shádiʼááhdę́ę́ʼ tó hóyáanii	Amazonasdelfin
Binaʼadaałtsózí dinéʼi	Orienten
Łóóʼ adishishí	Piggrokker
Tsin yąąh dzootʼihí	Spettmeisfamilien
Atʼaʼ yiltʼąąʼí dah sidáhígíí (chʼosh ntsxaaígíí)	Kokoskrabbe
Yółeehii	Marulker
Tiníléí	Gilaøgle
Dijádídlǫ́ʼí	Fjellerke
Tłʼoh	Plen
Dinas	Melbær
Mąʼii bikʼiizgi hadzíjiní	Stripet sjakal
Bitsʼáá bidaʼhodiʼniil	Brent jords taktikk
Mágíłchííʼ	Løvetamarin
Kʼíneedlíshii adiłhashígíí	Hjortebiller
Łééh yidi tóʼígíí	Akvifer
Naʼashǫ́ʼiitsoh naʼałkǫ́ʼígíí	Haviguan
Tsídiisháshii	Sidensvanser
Yaaʼ bitsʼaʼígíí	Skjoldlus
Daateel	Båtnebbhegre
Tééh łééchąąʼí ditsʼozígíí	Brunhyene
Tsétaʼ łį́į́ʼ	Mustang (hest)
Kénézí	Bladhøns
Neeshchʼííʼ	Pinjekjerne
Naalʼeełítsoh yił aheełtʼéhii łizhin dóó łigaiígíí	Skjæregås
Yaadaaʼnézí (tónteel tsídii)	Saksenebber
Tsídii disxǫsígíí	Jakamarer
Náátsʼózídę́ę́ʼ mósíłchíiʼii ałchinígíí	Baykatt
Shádiʼááhdę́ę́ʼ tsétah mósí ałchinígíí	Fjellkatt
Jeeshóóʼ łizhinígíí	Svartkondor
Dééłdą́ą́ʼ	Einstape
Hashkʼaan yildeełígíí (tsídii)	Turakoer
Łį́į́chilí	Shetlandsponni
Daakʼį́į́ʼ	Numenius
Mąʼiiłtsooí łibáhígíí	Grårev
Naʼashǫ́ʼiitsoh dootłʼizhígíí	Grønn iguan
Chidí bikéíjį́ʼ adeizʼááhígíí	Pickup (bil)
Bįįh bitseełgaiígíí	Hvithalehjort
Wónitłʼizí	Skrukketroll
Hakʼaz mąʼiitsoh	Arktisk ulv
Dark Ages	De mørke århundrer
Łeeyiʼ jááłániichilí	Fåfotinger
Aniłtʼánii (bikʼosnézí)	Kamelhalsfluer
Dlóóʼ binaalniih	Byllepest
Naaʼołí biyaʼ	Frøbiller
Ááhooshtʼįįh	Kapitulasjon
Tséʼédǫ́ʼii dishooí	Blomsterfluer
Tsáʼásziʼ dóó Noodah	Agavefamilien
Tééh tsisteeł	Havskilpadder
Bichʼah Dootłʼizhii	FNs fredsbevarende styrker
Chʼosh ałchozhii (chéłchaaʼ)	Klannere
Łeʼesoołii (bitseeʼ naakiígíí)	Tohaler
Dlǫ́ʼátsoh	Skogmurmeldyr
Chʼééh digháhii dóó Tsisteeł	Skilpadder
Tááʼyaʼniiltʼóshii	Kardinaler
Łóóʼ bigaanłánígo bitsʼaʼígíí	Perlebåter
Łeʼesoołii (bitseeʼ tááʼígíí)	Børstehaler
Tłʼézhii	Klegger
Tániilʼáítsʼóóz	Vannymfer
Aniłtʼániitsʼóóz	Maurløver
Tó wónaanídę́ę́ʼ hazéí bíchį́į́hnézí	Trespissmus
Bįįh łikizhígíí (Naakaii Dootłʼizhii Bikéyahdę́ę́ʼígíí)	Aksishjort
Nahashchʼidí (naaldeehii)	Amerikansk grevling
Bisóodi bideeʼ názhahígíí	Hjortesvin
Shádiʼááhdę́ę́ʼ bisóodi diʼilígíí	Navlesvin
Náʼagéédí bizaʼazis hólóní	Pungmuldvarper
Tłʼézhiiłbáhí	Snyltefluer
Jádítsoh diłhiłígíí	Nyala
Tsinaʼayąʼii yildeełí	Numbat
Tsétah tłʼízí	Snøgeit
Jááłániichilí bighádzígaiígíí	Dvergfotinger
Tsiishgaii	Pygméspettmeis
Tsį́į́łkaałiichilí	Pikuletter
Dééłgai bitsiiʼ halzhinígíí	Svarthalssvane
Chʼosh nahachagii	Dvergsikader
Hóółtseiigi naʼastsʼǫǫsí	Ørkenrotter
Dibédą́ą́ʼ	Shepherdia
Tádídíín yiyání łichíʼígíí	Liljebille
Naʼazǫ́ǫzii	Maurvepser
Jáád neishoodí (naʼashjéʼii haalzheehígíí)	Veivepser
Chį́į́shłigaií (bílaʼashdlaʼii bilį́į́ʼ)	Tamgås
Nahatʼeʼiitsoh Bikéyahdę́ę́ʼ naalʼeełítsoh łibáhígíí	Hønsegås
Dahsánítsoh	Vanlig hulepinnsvin
Táłkááʼ dilwoʼí	Vannløpere
Akáshtʼóózh biyaʼ	Støvlus
Łeʼesoołii (bideeʼ ádinígíí)	Proturer
Ąąʼąʼii	Pica (fugler)
Mósí ałchiní bitsiiʼtʼąhígíí	Flathodekatt
Naakaii Łizhiní Bikéyahdę́ę́ʼ naalʼeełítsoh dibéłchíʼígíí	Niland
Tʼáá łichíʼígo náʼagéédí	Nakenrotte
Iichʼąhii noodǫ́zí	Hyles lineata
Atʼąąʼ nahalinii	Vandrende blad
Naʼashǫ́ʼii dichʼízhii	Paddeiguaner
Ásaaʼ neiyéhii	Oljebiller
Shádiʼááhdę́ę́ʼ tiníléí	Vorteøgle
Sahdii Bisí (Tsé Nástánii)	Petrified Forest nasjonalpark
Naakaii Dootłʼizhii bimósí ałchinígíí	Rustflekkatt
Níłtsą́goʼ	Pleocomidae
Tsídii naʼałkǫ́ʼígíí	Lunder
Tsisteeł diyogí	Matamata (skilpadde)
Łóóʼ adishishí ntsxaaígíí	Djevelskate
Naalʼeełí naashchʼąąʼígíí	Brudeand
Tsin naaʼeeł łóó beeʼháʼhaalʼééłiʼ	Tråler
Chʼosh biyaʼ	Viftevinger
Táłtłʼááh chʼosh	Vannkalver
Shádiʼááhdę́ę́ʼ tábąąstííntsoh	Søramerikansk sjøløve
Táłtłʼááh álééh	Herodiashegre
Táłtłʼááh naakaii náásééł yił aheełtʼéhii	Sjøknelere
Náátsʼózídę́ę́ʼ tsiiłtsooí	Gullfasan
Bisóodi Danilínígíí	Svinedyr
Chį́į́shghą́ʼiiłgaii	Hvitbrystspettmeis
Hastiin Diego de Landa	Diego de Landa Calderón
Hastiin Biʼééʼ Łichíiʼii	Kit Carson
Tségad	Dvergjamnefamilien
Naaʼołí	Bønne
Yaaʼ nahachagiígíí	Lopper
Kéʼ łizhiní	Blackfoot Confederacy
Tábąąsdísí áłtsʼíísí	Flekksnipe
Náátsʼózídę́ę́ʼ toohjįʼ ndiigaii	Kritthegre
Lókʼaatah bisóodi	Busksvin
Naayééʼ tsídiitsoh	Moafugler
Naaltsoos Mormon Wolyéhígíí	Mormons bok
Téél halchíʼí	Vandretrost
Dlǫ́ʼátah néʼéshjaaʼ	Graveugle
Naʼashǫ́ʼii bijáád ádinígíí	Ormeøgler
Naʼatłʼoʼii (chʼosh)	Spinnfotinger
Dííłdzid yiyání	Kortvinger
Yáhashjool yázhí	Pygmerørdrum
Tsʼíʼii jáádnézí	Storstankelbein
Chʼil ditsʼozíłchííʼ	Rambutan
Mágíłtsooí bináázhiní	Ekornape
Taʼneeskʼání	Cantaloupe
Tsídiiłtsooí bitʼaʼ łizhinígíí	Gulstillits
Bitseeʼ yee adiłhałii yázhí	Kaimaner
Anaasází	Anasazikulturen
Chʼééh digháhiitsoh	Elefantskilpadde
Yeenaʼałkǫ́ʼíłániichilí	Remipedia
Naʼnízhoozhí Bił Hahoodzo	McKinley County
Mąʼii Deeshgiizh Bił Hahoodzo	Sandoval County
Naatoohí Bił Hahoodzo	Cibola County
Ooljééʼ yiikááʼ nandahí	Månelanding
Toohjįʼ noołnahii yázhí	Grønnrygghegre
Báshdo	Barstow (California)
Łóóʼ hashkéhé bíchį́į́hnézí	Nesehai
Tłʼiishtsiiʼí (łóóʼ)	Slangehodefisker
Chéłchaaʼ bideeneezígíí	Herkulesbille
Tsétah chaaʼ	Beverekorn
Naalʼeełí dootłʼizhí	Blåvingeand
Tséʼédǫ́ʼii	Møkkfluer
Chʼagiitsoh	Gulhodetrupial
Gad niʼeełí	Juniperus scopulorum
Níyolgi naʼałkǫ́ʼígíí (tónteel tsídii)	Dykkpetreller
Tsinaʼayąʼii biyázhí	Jordlus
Tsooʼtsʼiní (łóóʼ)	Arowanaer
Tsinaʼayąʼii	Termitter
Beeʼeldííldahsinildi siláołtsooí bichidí naatʼaʼí ńdinibįįhígi	Kirtland Air Force Base
Kilim	Kelim
Táłtłʼááh wónitłʼizí	Gråsugge
Chąąneiłhizii	Stumpbiller
Nákʼeʼnáʼijiní	Rustspettmeis
Wáláchíʼétah nahachagiichilí	Myrmecophilidae
Yáhashjool yił aheełtʼéhii	Solrikse
Tsintah bisóoditsoh	Skogsvin
Zééjíjinii	Kragegjeterfugl
Dlǫ́ʼii yił aheełtʼéhii łibáhígíí	Indisk mungo
Chį́į́shłigaií dóó Naalʼeełítsoh	Svaner og gjess
Ásáí Dineʼé Bikéyahdę́ę́ʼ mąʼiitsoh	Arabisk ulv
Aniłtʼánii yázhí	Psyllidae
Táłkááʼ dilwoʼítsʼóóz	Vannskridere
Chʼoshtsoh bíláshgaantsohí łikizhígíí	Enoplometopus
Łeʼesoołii (nahachaʼígíí)	Archaeognatha
Chéłchaaʼtsoh	Dynastinae
Wódisxǫsí	Scutelleridae
Kʼaalógiitsoh disxǫsígíí	Morpho
Wáláchííʼ	Hage-eitermaur
Wóniłchxoní	Breiteger
Tsiikʼánii (tsídii)	Skyggefugl
Tábąąh bisóodiłchíiʼii	Penselsvin
Tiníléítsoh naʼałkǫ́ʼígíí	Båndvaran
Kézhoozhʼilí (tsin yigházhígíí)	Kamfingerrotter
Tsísʼná náʼagéédígíí	Pelsbier
Séí tiníléítsoh	Gouldvaran
Łóóʼ bigháhootʼíní	Asiatiske glassfisker
Tʼiis	Pyramidepoppel
Tónhidigaii	Silverton (Colorado)
Chʼosh áłtʼą́ą́ʼígíí	Frøteger
Kéyahígíí nidineesdzaʼ	Dust Bowl
Nahachagii dootłʼizhí	Løvgresshopper
Tsé Bíyah Aniiʼáhí	Chaco Culture nasjonalhistorisk park
Jeeshóóʼ ałchozhígíí	Palmegribb
Łóóʼ adiłdoní	Skytterfisker
Naakaii Łizhiní Bikéyahdę́ę́ʼ nahatʼeʼii	Springhare
Táłtłʼááh chʼosh chʼééh digháhii bitsʼaʼ ádinígíí	Nakensnegler
Tiníléítsoh noodǫ́zígíí	Nilvaran
Naʼashǫ́ʼii bideewozhii	Tornhaler
Yáhashjool	Amerikarørdrum
Mąʼiiłtsooí yázhí	Kitrev
Gałbáhí	Bomullshalekaniner
Tsékááʼgóó naagháhii (chʼosh)	Mantophasmatidae
Táłtłʼááh tsxilghááhtsoh	Kjempesalamandere
Chʼagii	Rødvingetrupial
Tábąądijádí	Tobeltelo
Táłtłʼááh naatʼáʼii	Flygeknurrer
Naakaii Dootłʼizhí Dabikéyah	Sør-Asia
Kinteel (Yootó Hahoodzo)	Aztec (New Mexico)
Bisóodi dághaaʼígíí	Bartesvin
Iichʼąhii biyázhí	Mellus
Hashtłʼishdi tádíʼnéehii	Slamkrypere
Biniiʼdootłʼizh	Glaucidium (ugler)
Mágí biniiłgaígíí	Hvithodesaki
Wónaʼałtéhii	Rovfluer
Tłʼoh azihii	Ephedra
Kʼaalógii bitʼaʼ disxǫsgo łikizhígíí	Riodinidae
Tiníléítsoh bikʼosnézí	Ørkenvaran
Tábąąsdísíłbáí	Bekkasinsniper
Chʼosh naʼałkǫ́ʼí	Vannkjær
Tiníléítsoh dootłʼizhígíí	Smaragdvaran
Dichin	Sult
Dilchʼóshii	Junco
Chį́į́hʼadeeʼii (łóóʼ)	Spadestører
Dah Naatʼaʼí Bééhoʼdílzin	Pledge of Allegiance
Tó bichʼosh (tsiiyaago naʼałkǫ́ʼígíí)	Ryggsvømmere
Tónteel táshchozhii	Terner
Kʼish biyaʼ dootłʼizhígíí	Blå orebladbille
Aniłtʼánii łizhinígíí	Sialidae
Tábąąh chʼosh	Strandteger
Naakaii Bikéyahdę́ę́ʼ bįįh yázhí	Spisshjorter
Chʼoshtsoh bíláshgaanʼilí	Kiwa hirsuta
Anáʼálwoʼ:Bee hadítʼéhígíí	Hjelp:Portal
Táłtłʼááh chʼoshtsoh bideeneezí	Palinuridae
Moháábii dinéʼiʼ	Mohave
Néʼéshjaaʼkálii	Alveugle
Tsísʼná dootłʼizhí	Gullvepser
Halchíítah	Painted Desert
Wóósitsʼílí	Veggedyr
Tsidiłdǫǫhii	Megascops
Kǫʼ naʼałbąąsii hééł bee nágéhéʼ	Godstog
Jaaʼabaní	Småflaggermus
Chʼosh chʼééh digháhii bideeʼ dį́įʼii	Landlungesnegler
Tséʼédǫ́ʼii łibáhígíí	Kjøttfluer
Aniłtʼánii (naakaii náásééł nahalinígíí)	Knelernettvinger
Kin Łání (Dibé Nitsaa Hahoodzo)	Durango (Colorado)
Tótaʼ	Farmington (New Mexico)
Táłtłʼááh chʼoshtsoh bideeteelí	Scyllaridae
Chʼoshtsoh bíláshgaantsohí (tónteelgiʼígíí)	Hummere
Chíshí	Chiricahua
Jáád neishoodítsʼóóz	Praktvepser
Naʼashǫ́ʼii naatʼaʼí	Flygeagamer
Gólízhii bíchį́į́h tʼáá łichíiʼii	Tryneskunker
Wóóseetsʼiniiniłhiní	Hulegresshopper
Ałchʼįʼ beʼastłʼóní	Tamal
Gólízhii yistłʼinígíí	Flekkskunker
Tsísʼnátsoh diłhiłígíí	Xylocopa
Aniłtʼánii (bideeneezígíí)	Sommerfuglnettvinger
Shádiʼááhdę́ę́ʼ chʼoshtsoh bíláshgaantsohí	Parastacidae
Sílátsoh (chʼil)	Gjerdesolhatt
Naaldlooshii Bikéshgaan Dahólónígíí	Hovdyr
Nóódaʼí	Ute (folk)
Táłkááʼ dilwoʼí yázhí	Veliidae
Gadtsagí	Juniperus monosperma
Chʼosh bitsʼaʼ doolghasígíí	Kamskjell
Hashkʼaan bichʼosh	Knoppmøll
Chaatʼíní bichʼosh	Syrebladbille
Chʼałdą́ą́ʼ bichʼosh	Crioceris
Tsídii bidaatsoh naashchʼąąʼí	Tukaner
Tó bichʼosh (ałchozhígíí)	Buksvømmere
Tsékʼi yaʼiiʼáhii	Tobakksvermer
Táłtłʼááh chʼosh chʼééh digháhii bitsiiʼ dikʼání	Cephalaspidea
Tsédááʼii	Oribatida
Tʼááłáhági átʼéego:Bééshbichʼahí	Kategori:Tyskland
Tʼááłáhági átʼéego:Wááshindoon bikéyah ałhidadiidzooígíí	Kategori:USA
Tʼááłáhági átʼéego:Dibé diníí bikéyah	Kategori:Spania
Tʼááłáhági átʼéego:Naakaii Bikéyah	Kategori:Mexico
Wóódeʼełchíhii	Kantteger
Tʼááłáhági átʼéego:Bidił daazdoígíí dóó daʼałtʼoʼígíí	Kategori:Pattedyr
Tʼááłáhági átʼéego:Naaldlooshii dadichʼízhii	Kategori:Krypdyr
Tʼááłáhági átʼéego:Biyáázh Tsʼǫʼasánígíí	Kategori:Amfibier
Tʼááłáhági átʼéego:Tsídii	Kategori:Fugler
Tʼááłáhági átʼéego:Chʼosh doo yitʼíinii dláádí dóó Ábishjaaʼ	Kategori:Sopp
Tʼááłáhági átʼéego:Chʼil	Kategori:Planter
Tʼááłáhági átʼéego:Nátʼą́ą́ʼ náháneʼ	Kategori:Historie
Tʼááłáhági átʼéego:Naʼalkaah	Kategori:Vitenskap
Tsísʼná disxǫsígíí	Euglossini
Kiisʼáanii Naakáí yikʼéʼ daʼdéísdlį́į́h	Pueblo-opprøret
Hosh yiyání (níłtsą́goʼ)	Moneilemini
Aniłtʼánii łibáhígíí	Nabidae
Wóótsʼóóz	Alydidae
Iichʼąhii	Nattsvermere
Roman dinéʼiʼ	Romerriket
Chʼoshtsoh bikágí diwozhí	Trollkreps
Tábąąh naʼashǫ́ʼii	Vannagamer
Kégiizhí	Tohono O'odham
Chʼosh ałchozhii (iichʼąhii)	Klesmøll
Wóóchį́į́hnézí	Fulgoridae
Tsiitsʼiin łichíʼítsoh	Stenopelmatidae
Tʼááłáhági átʼéego:Ałtsʼáʼáztiin	Kategori:Pekere
Gad diltáłii	Juniperus deppeana
Atsá	Ørner
Dził Łigaii (Dibé Nitsaa Hahoodzo)	San Juan-fjellene
Ndilnaʼii	Dovendyr
Tsísʼnáyázhí	Markbier
Iichʼąhiiłgai bitʼaʼnézí	Amerikansk kjempefly
Séí nahachagiichilí (chʼosh bikágí ntłʼizí)	Tangloppefamilien
Wóótʼą́hí	Barkteger
Táłchaaʼ	Phyllophaga
Tʼááłáhági átʼéego:Stubs	Kategori:Stubber
Tʼááłáhági átʼéego:Chidí naatʼaʼí	Kategori:Luftfartøyer
Bee álnééhí:User uk-2	Mal:Bruker uk-2
Náyaasęęsídi atsiniltłʼish bá hooghan	Cholla kullkraftverk
Łóóʼ biyaʼ (chʼosh bikágí ntłʼizí)	Fiskelusslekten
Tʼááłáhági átʼéego:Wikipedia bots	Kategori:Boter
Tó bichʼosh (dichʼízhígíí)	Paddeteger
Tónteel zhį́ʼii	Skarver
Niłtsínii bikétłʼóól dijoolí (daadánígíí)	Vanlig nepe
Bee álnééhí:Tl	Mal:Mal
Tʼááłáhági átʼéego:Bee Hazʼáanii	Kategori:Rettsvitenskap
Tʼááłáhági átʼéego:Kéyah daʼnaaznilígíí dóó kéyah biłhaʼdaʼhaasdzoígíí	Kategori:Land
Wikiibíídiiya:Dahwéetʼaahígíí	Wikipedia:Administratorer
Wikiibíídiiya:Botígíí beehazʼą́ąnii	Wikipedia:Roboter
Ííjip	Egypt
Bee álnééhí:Bot	Mal:Bot
Deeteel Bikéyah	Canada
Wikiibíídiiya:Baa haneʼ	Wikipedia:Om
Tʼááłáhági átʼéego:Béésh bichʼahníí bikéyah	Kategori:Land i Europa
Tʼááłáhági átʼéego:Choyoołʼįįhí Bizaad	Kategori:Wikipedia-brukere etter språk
Anáʼálwoʼ:Wikiibíídiiya beehazʼą́ąnii	Wikipedia:Regler og retningslinjer
Annie Dodge Wauneka	Annie Dodge Wauneka
Bee álnééhí:Softredirect	Mal:Softredirect
Chʼosh chʼééh digháhii	Snegler
Tʼááłáhági átʼéego:Saad	Kategori:Språk
Wikiibíídiiya:General disclaimer	Wikipedia:Generelle forbehold
Wikiibíídiiya:Statistics	Wikipedia:Statistikk
Nahatʼeʼiitsoh	Kenguruer
Łóóʼ hashkéhéchilí	Helhodefisker
Tʼááłáhági átʼéego:Living people	Kategori:Biografier om levende personer
Bee álnééhí:!	Mal:!
Bee álnééhí:Bots	Mal:Bots
Tʼááłáhági átʼéego:Naaltsoos	Kategori:Bøker
Bee álnééhí:Wikisource	Mal:Wikisource
Bee álnééhí:Babel	Mal:Babel
Bee álnééhí:Commons	Mal:Commons
Bee álnééhí:Reflist	Mal:Referanser
Bee álnééhí:Stub	Mal:Stubb
Bee álnééhí:User af-1	Mal:Bruker af-1
Bee álnééhí:User als-1	Mal:Bruker als-1
Bee álnééhí:User ar-1	Mal:Bruker ar-1
Bee álnééhí:User az	Mal:Bruker az
Bee álnééhí:User bar-1	Mal:Bruker bar-1
Bee álnééhí:User eo-1	Mal:Bruker eo-1
Bee álnééhí:See also	Mal:Se også
Bee álnééhí:User da-2	Mal:Bruker da-2
Bee álnééhí:User da	Mal:Bruker da
Bee álnééhí:User ca-1	Mal:Bruker ca-1
Bee álnééhí:User ca-4	Mal:Bruker ca-4
Bee álnééhí:User be-2	Mal:Bruker be-2
Bee álnééhí:User da-1	Mal:Bruker da-1
Bee álnééhí:User cs-1	Mal:Bruker cs-1
Bee álnééhí:User eo-3	Mal:Bruker eo-3
Bee álnééhí:User de	Mal:Bruker de
Bee álnééhí:User de-1	Mal:Bruker de-1
Bee álnééhí:User eu	Mal:Bruker eu
Bee álnééhí:User et-1	Mal:Bruker et-1
Bee álnééhí:User el	Mal:Bruker el
Bee álnééhí:User es	Mal:Bruker es
Bee álnééhí:User de-3	Mal:Bruker de-3
Bee álnééhí:User en-3	Mal:Bruker en-3
Bee álnééhí:User el-1	Mal:Bruker el-1
Bee álnééhí:User en-1	Mal:Bruker en-1
Bee álnééhí:User en-2	Mal:Bruker en-2
Bee álnééhí:User fa-1	Mal:Bruker fa-1
Bee álnééhí:User eo-2	Mal:Bruker eo-2
Bee álnééhí:User en-4	Mal:Bruker en-4
Bee álnééhí:User fi	Mal:Bruker fi
Bee álnééhí:User en-0	Mal:Bruker en-0
Bee álnééhí:User es-4	Mal:Bruker es-4
Bee álnééhí:User en	Mal:Bruker en
Bee álnééhí:User de-2	Mal:Bruker de-2
Bee álnééhí:User es-1	Mal:Bruker es-1
Bee álnééhí:User fa	Mal:Bruker fa
Bee álnééhí:User fi-1	Mal:Bruker fi-1
Bee álnééhí:User fr-1	Mal:Bruker fr-1
Bee álnééhí:User ia-2	Mal:Bruker ia-2
Bee álnééhí:User hr	Mal:Bruker hr
Bee álnééhí:User he-2	Mal:Bruker he-2
Bee álnééhí:User he-1	Mal:Bruker he-1
Bee álnééhí:User hu	Mal:Bruker hu
Bee álnééhí:User id-3	Mal:Bruker id-3
Bee álnééhí:User io-3	Mal:Bruker io-3
Bee álnééhí:User it-3	Mal:Bruker it-3
Bee álnééhí:User grc-1	Mal:Bruker grc-1
Bee álnééhí:User ja-4	Mal:Bruker ja-4
Bee álnééhí:User sk	Mal:Bruker sk
Bee álnééhí:User tr-2	Mal:Bruker tr-2
Bee álnééhí:User fr-2	Mal:Bruker fr-2
Bee álnééhí:User tr	Mal:Bruker tr
Bee álnééhí:User ja	Mal:Bruker ja
Bee álnééhí:User ja-1	Mal:Bruker ja-1
Bee álnééhí:User it-1	Mal:Bruker it-1
Bee álnééhí:User hr-1	Mal:Bruker hr-1
Bee álnééhí:User fr	Mal:Bruker fr
Bee álnééhí:User he	Mal:Bruker he
Tʼááłáhági átʼéego:Chʼosh bijáád hastánígíí	Kategori:Insekter
Tʼááłáhági átʼéego:Choyoołʼįįhí uk	Kategori:Bruker uk
Tʼááłáhági átʼéego:Choyoołʼįįhí uk-N	Kategori:Bruker uk-N
Tʼááłáhági átʼéego:Chʼiyáán	Kategori:Mat
Bee álnééhí:User sv	Mal:Bruker sv
Bee álnééhí:User it	Mal:Bruker it
Bee álnééhí:User uk	Mal:Bruker uk
Bee álnééhí:User es-2	Mal:Bruker es-2
Tʼááłáhági átʼéego:Choyoołʼįįhí ms	Kategori:Bruker ms
Tʼááłáhági átʼéego:Choyoołʼįįhí fr-1	Kategori:Bruker fr-1
Bee álnééhí:Image label	Mal:Image label
Tʼááłáhági átʼéego:Atsá dóó Giní Ndahalinígíí	Kategori:Rovfugler
Tʼááłáhági átʼéego:Choyoołʼįįhí en-4	Kategori:Bruker en-4
Tʼááłáhági átʼéego:Choyoołʼįįhí en	Kategori:Bruker en
Tʼááłáhági átʼéego:Choyoołʼįįhí zh	Kategori:Bruker zh
Tʼááłáhági átʼéego:Choyoołʼįįhí zh-N	Kategori:Bruker zh-N
Tʼááłáhági átʼéego:Choyoołʼįįhí en-2	Kategori:Bruker en-2
Bee álnééhí:User eo	Mal:Bruker eo
Bee álnééhí:User zh	Mal:Bruker zh
Bee álnééhí:User ru-4	Mal:Bruker ru-4
Bee álnééhí:GeoTemplate	Mal:GeoTemplate
Bee álnééhí:User nl-1	Mal:Bruker nl-1
Bee álnééhí:User nl-2	Mal:Bruker nl-2
Tʼááłáhági átʼéego:Néʼéshjaaʼ	Kategori:Ugler
Tʼááłáhági átʼéego:Choyoołʼįįhí hi	Kategori:Bruker hi
Tʼááłáhági átʼéego:Dził	Kategori:Fjell
Bee álnééhí:User ru	Mal:Bruker ru
Tʼááłáhági átʼéego:Kéyah dah siʼánígíí	Kategori:Amerika
Tʼááłáhági átʼéego:Choyoołʼįįhí bizaad-Templates	Kategori:Babel-maler
Bee álnééhí:Archive	Mal:Arkiv
Tʼááłáhági átʼéego:Siláołtsooí	Kategori:Militærvesen
Tʼááłáhági átʼéego:Naʼashǫ́ʼii	Kategori:Øgler
Bee álnééhí:User pt-1	Mal:Bruker pt-1
Bee álnééhí:Tb	Mal:Svar
Bee álnééhí:Pt elements	Mal:Periodesystemet
Bee álnééhí:User nl	Mal:Bruker nl
Bee álnééhí:User no-2	Mal:Bruker no-2
Bee álnééhí:Userpage	Mal:Brukerside
Bee álnééhí:Emergency-bot-shutoff	Mal:Emergency-bot-shutoff
Bee álnééhí:User pl-1	Mal:Bruker pl-1
Bee álnééhí:Image label small	Mal:Image label small
Bee álnééhí:User fr-3	Mal:Bruker fr-3
Bee álnééhí:User lt	Mal:Bruker lt
Bee álnééhí:User nds-1	Mal:Bruker nds-1
Tʼááłáhági átʼéego:Hosh	Kategori:Kaktusfamilien
Bee álnééhí:User ar-2	Mal:Bruker ar-2
Bee álnééhí:User ar-3	Mal:Bruker ar-3
Bee álnééhí:User ar	Mal:Bruker ar
Tʼááłáhági átʼéego:Choyoołʼįįhí ja-N	Kategori:Bruker ja-N
Bee álnééhí:User als	Mal:Bruker als
Bee álnééhí:@	Mal:@
Tʼááłáhági átʼéego:Tłʼoh	Kategori:Gressfamilien
Bee álnééhí:Ałtsʼáʼáztiin	Mal:Peker
Bee álnééhí:User no-3	Mal:Bruker no-3
Bee álnééhí:User no	Mal:Bruker no
Bee álnééhí:Chʼiyáánbiiʼ	Mal:Næringsinnhold
Bee álnééhí:User sv-2	Mal:Bruker sv-2
Tʼááłáhági átʼéego:Choyoołʼįįhí gsw-1	Kategori:Bruker gsw-1
Bee álnééhí:User it-2	Mal:Bruker it-2
Tʼááłáhági átʼéego:Kǫʼ naʼałbąąsii	Kategori:Jernbane
Bee álnééhí:User lb-1	Mal:Bruker lb-1
Bee álnééhí:User fr-4	Mal:Bruker fr-4
Bee álnééhí:User lv	Mal:User lv
Tʼááłáhági átʼéego:Choyoołʼįįhí vi-3	Kategori:Bruker vi-3
Bee álnééhí:User la-1	Mal:Bruker la-1
Tʼááłáhági átʼéego:Templates/doc	Kategori:Maldokumentasjonssider
Tʼááłáhági átʼéego:Choyoołʼįįhí yue	Kategori:Bruker yue
Tʼááłáhági átʼéego:Choyoołʼįįhí pdc	Kategori:Bruker pdc
Tʼááłáhági átʼéego:Choyoołʼįįhí mzn	Kategori:Bruker mzn
Tʼááłáhági átʼéego:Choyoołʼįįhí az	Kategori:Bruker az
Tʼááłáhági átʼéego:Choyoołʼįįhí be	Kategori:Bruker be
Tʼááłáhági átʼéego:Choyoołʼįįhí nb-N	Kategori:Bruker nb-N
Tʼááłáhági átʼéego:Choyoołʼįįhí bs	Kategori:Bruker bs
Tʼááłáhági átʼéego:Choyoołʼįįhí chr	Kategori:Bruker chr
Tʼááłáhági átʼéego:Choyoołʼįįhí hr	Kategori:Bruker hr
Tʼááłáhági átʼéego:Choyoołʼįįhí sk	Kategori:Bruker sk
Tʼááłáhági átʼéego:Choyoołʼįįhí sl	Kategori:Bruker sl
Tʼááłáhági átʼéego:Choyoołʼįįhí eo	Kategori:Bruker eo
Tʼááłáhági átʼéego:Choyoołʼįįhí et	Kategori:Bruker et
Tʼááłáhági átʼéego:Choyoołʼįįhí fr	Kategori:Bruker fr
Tʼááłáhági átʼéego:Choyoołʼįįhí gl	Kategori:Bruker gl
Tʼááłáhági átʼéego:Choyoołʼįįhí cy	Kategori:Bruker cy
Tʼááłáhági átʼéego:Choyoołʼįįhí hu-N	Kategori:Bruker hu-N
Tʼááłáhági átʼéego:Choyoołʼįįhí id	Kategori:Bruker id
Tʼááłáhági átʼéego:Choyoołʼįįhí ia	Kategori:Bruker ia
Tʼááłáhági átʼéego:Choyoołʼįįhí ga	Kategori:Bruker ga
Tʼááłáhági átʼéego:Choyoołʼįįhí ja	Kategori:Bruker ja
Tʼááłáhági átʼéego:Choyoołʼįįhí km	Kategori:Bruker km
Tʼááłáhági átʼéego:Choyoołʼįįhí rn	Kategori:Bruker rn
Tʼááłáhági átʼéego:Choyoołʼįįhí la	Kategori:Bruker la
Tʼááłáhági átʼéego:Choyoołʼįįhí li	Kategori:Bruker li
Tʼááłáhági átʼéego:Choyoołʼįįhí lt	Kategori:Bruker lt
Tʼááłáhági átʼéego:Choyoołʼįįhí mk	Kategori:Bruker mk
Tʼááłáhági átʼéego:Choyoołʼįįhí mg	Kategori:Bruker mg
Tʼááłáhági átʼéego:Choyoołʼįįhí mwl	Kategori:Bruker mwl
Tʼááłáhági átʼéego:Choyoołʼįįhí nn	Kategori:Bruker nn
Tʼááłáhági átʼéego:Choyoołʼįįhí nah	Kategori:Bruker nah
Tʼááłáhági átʼéego:Choyoołʼįįhí oc	Kategori:Bruker oc
Tʼááłáhági átʼéego:Choyoołʼįįhí pt	Kategori:Bruker pt
Tʼááłáhági átʼéego:Choyoołʼįįhí ro	Kategori:Bruker ro
Tʼááłáhági átʼéego:Choyoołʼįįhí sc	Kategori:Bruker sc
Tʼááłáhági átʼéego:Choyoołʼįįhí sh	Kategori:Bruker sh
Tʼááłáhági átʼéego:Choyoołʼįįhí sv	Kategori:Bruker sv
Tʼááłáhági átʼéego:Choyoołʼįįhí sw	Kategori:Bruker sw
Tʼááłáhági átʼéego:Choyoołʼįįhí sa	Kategori:Bruker sa
Tʼááłáhági átʼéego:Choyoołʼįįhí th	Kategori:Bruker th
Tʼááłáhági átʼéego:Choyoołʼįįhí ta	Kategori:Bruker ta
Tʼááłáhági átʼéego:Choyoołʼįįhí vo	Kategori:Bruker vo
Tʼááłáhági átʼéego:Choyoołʼįįhí az-3	Kategori:Bruker az-3
Tʼááłáhági átʼéego:Choyoołʼįįhí be-3	Kategori:Bruker be-3
Tʼááłáhági átʼéego:Choyoołʼįįhí cs-3	Kategori:Bruker cs-3
Tʼááłáhági átʼéego:Choyoołʼįįhí sl-3	Kategori:Bruker sl-3
Tʼááłáhági átʼéego:Choyoołʼįįhí et-3	Kategori:Bruker et-3
Tʼááłáhági átʼéego:Choyoołʼįįhí fr-3	Kategori:Bruker fr-3
Tʼááłáhági átʼéego:Choyoołʼįįhí cy-3	Kategori:Bruker cy-3
Tʼááłáhági átʼéego:Choyoołʼįįhí hi-3	Kategori:Bruker hi-3
Tʼááłáhági átʼéego:Choyoołʼįįhí ia-3	Kategori:Bruker ia-3
Tʼááłáhági átʼéego:Choyoołʼįįhí it-3	Kategori:Bruker it-3
Tʼááłáhági átʼéego:Choyoołʼįįhí ja-3	Kategori:Bruker ja-3
Tʼááłáhági átʼéego:Choyoołʼįįhí li-3	Kategori:Bruker li-3
Tʼááłáhági átʼéego:Choyoołʼįįhí lt-3	Kategori:Bruker lt-3
Tʼááłáhági átʼéego:Choyoołʼįįhí nl-3	Kategori:Bruker nl-3
Tʼááłáhági átʼéego:Choyoołʼįįhí no-3	Kategori:Bruker no-3
Tʼááłáhági átʼéego:Choyoołʼįįhí pl-3	Kategori:Bruker pl-3
Tʼááłáhági átʼéego:Choyoołʼįįhí sw-3	Kategori:Bruker sw-3
Tʼááłáhági átʼéego:Choyoołʼįįhí tr-3	Kategori:Bruker tr-3
Tʼááłáhági átʼéego:Choyoołʼįįhí ar-3	Kategori:Bruker ar-3
Tʼááłáhági átʼéego:Choyoołʼįįhí pdc-1	Kategori:Bruker pdc-1
Tʼááłáhági átʼéego:Choyoołʼįįhí an-1	Kategori:Bruker an-1
Tʼááłáhági átʼéego:Choyoołʼįįhí be-1	Kategori:Bruker be-1
Tʼááłáhági átʼéego:Choyoołʼįįhí cs-1	Kategori:Bruker cs-1
Tʼááłáhági átʼéego:Choyoołʼįįhí da-1	Kategori:Bruker da-1
Tʼááłáhági átʼéego:Choyoołʼįįhí sl-1	Kategori:Bruker sl-1
Tʼááłáhági átʼéego:Choyoołʼįįhí et-1	Kategori:Bruker et-1
Tʼááłáhági átʼéego:Choyoołʼįįhí fi-1	Kategori:Bruker fi-1
Tʼááłáhági átʼéego:Choyoołʼįįhí cy-1	Kategori:Bruker cy-1
Tʼááłáhági átʼéego:Choyoołʼįįhí hi-1	Kategori:Bruker hi-1
Tʼááłáhági átʼéego:Choyoołʼįįhí ia-1	Kategori:Bruker ia-1
Tʼááłáhági átʼéego:Choyoołʼįįhí ga-1	Kategori:Bruker ga-1
Tʼááłáhági átʼéego:Choyoołʼįįhí jv-1	Kategori:Bruker jv-1
Tʼááłáhági átʼéego:Choyoołʼįįhí lv-1	Kategori:Bruker lv-1
Tʼááłáhági átʼéego:Choyoołʼįįhí li-1	Kategori:Bruker li-1
Tʼááłáhági átʼéego:Choyoołʼįįhí lt-1	Kategori:Bruker lt-1
Tʼááłáhági átʼéego:Choyoołʼįįhí mk-1	Kategori:Bruker mk-1
Tʼááłáhági átʼéego:Choyoołʼįįhí nl-1	Kategori:Bruker nl-1
Tʼááłáhági átʼéego:Choyoołʼįįhí nah-1	Kategori:Bruker nah-1
Tʼááłáhági átʼéego:Choyoołʼįįhí oc-1	Kategori:Bruker oc-1
Tʼááłáhági átʼéego:Choyoołʼįįhí pl-1	Kategori:Bruker pl-1
Tʼááłáhági átʼéego:Choyoołʼįįhí ro-1	Kategori:Bruker ro-1
Tʼááłáhági átʼéego:Choyoołʼįįhí sc-1	Kategori:Bruker sc-1
Tʼááłáhági átʼéego:Choyoołʼįįhí sw-1	Kategori:Bruker sw-1
Tʼááłáhági átʼéego:Choyoołʼįįhí sa-1	Kategori:Bruker sa-1
Tʼááłáhági átʼéego:Choyoołʼįįhí tr-1	Kategori:Bruker tr-1
Tʼááłáhági átʼéego:Choyoołʼįįhí ar-1	Kategori:Bruker ar-1
Tʼááłáhági átʼéego:Choyoołʼįįhí fr-4	Kategori:Bruker fr-4
Tʼááłáhági átʼéego:Choyoołʼįįhí it-4	Kategori:Bruker it-4
Tʼááłáhági átʼéego:Choyoołʼįįhí oc-4	Kategori:Bruker oc-4
Tʼááłáhági átʼéego:Choyoołʼįįhí pl-4	Kategori:Bruker pl-4
Tʼááłáhági átʼéego:Choyoołʼįįhí ar-4	Kategori:Bruker ar-4
Tʼááłáhági átʼéego:Choyoołʼįįhí als-2	Kategori:Bruker als-2
Tʼááłáhági átʼéego:Choyoołʼįįhí mzn-2	Kategori:Bruker mzn-2
Tʼááłáhági átʼéego:Choyoołʼįįhí be-2	Kategori:Bruker be-2
Tʼááłáhági átʼéego:Choyoołʼįįhí bs-2	Kategori:Bruker bs-2
Tʼááłáhági átʼéego:Choyoołʼįįhí cs-2	Kategori:Bruker cs-2
Tʼááłáhági átʼéego:Choyoołʼįįhí da-2	Kategori:Bruker da-2
Tʼááłáhági átʼéego:Choyoołʼįįhí sk-2	Kategori:Bruker sk-2
Tʼááłáhági átʼéego:Choyoołʼįįhí sl-2	Kategori:Bruker sl-2
Tʼááłáhági átʼéego:Choyoołʼįįhí et-2	Kategori:Bruker et-2
Tʼááłáhági átʼéego:Choyoołʼįįhí fr-2	Kategori:Bruker fr-2
Tʼááłáhági átʼéego:Choyoołʼįįhí cy-2	Kategori:Bruker cy-2
Tʼááłáhági átʼéego:Choyoołʼįįhí hi-2	Kategori:Bruker hi-2
Tʼááłáhági átʼéego:Choyoołʼįįhí hu-2	Kategori:Bruker hu-2
Tʼááłáhági átʼéego:Choyoołʼįįhí ia-2	Kategori:Bruker ia-2
Tʼááłáhági átʼéego:Choyoołʼįįhí it-2	Kategori:Bruker it-2
Tʼááłáhági átʼéego:Choyoołʼįįhí ja-2	Kategori:Bruker ja-2
Tʼááłáhági átʼéego:Choyoołʼįįhí rn-2	Kategori:Bruker rn-2
Tʼááłáhági átʼéego:Choyoołʼįįhí la-2	Kategori:Bruker la-2
Tʼááłáhági átʼéego:Choyoołʼįįhí lt-2	Kategori:Bruker lt-2
Tʼááłáhági átʼéego:Choyoołʼįįhí mwl-2	Kategori:Bruker mwl-2
Tʼááłáhági átʼéego:Choyoołʼįįhí nl-2	Kategori:Bruker nl-2
Tʼááłáhági átʼéego:Choyoołʼįįhí oc-2	Kategori:Bruker oc-2
Tʼááłáhági átʼéego:Choyoołʼįįhí pl-2	Kategori:Bruker pl-2
Tʼááłáhági átʼéego:Choyoołʼįįhí sh-2	Kategori:Bruker sh-2
Tʼááłáhági átʼéego:Choyoołʼįįhí sv-2	Kategori:Bruker sv-2
Tʼááłáhági átʼéego:Choyoołʼįįhí sw-2	Kategori:Bruker sw-2
Tʼááłáhági átʼéego:Choyoołʼįįhí tr-2	Kategori:Bruker tr-2
Tʼááłáhági átʼéego:Choyoołʼįįhí ar-2	Kategori:Bruker ar-2
Tʼááłáhági átʼéego:Choyoołʼįįhí ast-N	Kategori:Bruker ast-N
Tʼááłáhági átʼéego:Choyoołʼįįhí be-N	Kategori:Bruker be-N
Tʼááłáhági átʼéego:Choyoołʼįįhí cs-N	Kategori:Bruker cs-N
Tʼááłáhági átʼéego:Choyoołʼįįhí ko-N	Kategori:Bruker ko-N
Tʼááłáhági átʼéego:Choyoołʼįįhí hr-N	Kategori:Bruker hr-N
Tʼááłáhági átʼéego:Choyoołʼįįhí sl-N	Kategori:Bruker sl-N
Tʼááłáhági átʼéego:Choyoołʼįįhí et-N	Kategori:Bruker et-N
Tʼááłáhági átʼéego:Choyoołʼįįhí fr-N	Kategori:Bruker fr-N
Tʼááłáhági átʼéego:Choyoołʼįįhí fy-N	Kategori:Bruker fy-N
Tʼááłáhági átʼéego:Choyoołʼįįhí gl-N	Kategori:Bruker gl-N
Tʼááłáhági átʼéego:Choyoołʼįįhí cy-N	Kategori:Bruker cy-N
Tʼááłáhági átʼéego:Choyoołʼįįhí hi-N	Kategori:Bruker hi-N
Tʼááłáhági átʼéego:Choyoołʼįįhí id-N	Kategori:Bruker id-N
Tʼááłáhági átʼéego:Choyoołʼįįhí is-N	Kategori:Bruker is-N
Tʼááłáhági átʼéego:Choyoołʼįįhí it-N	Kategori:Bruker it-N
Tʼááłáhági átʼéego:Choyoołʼįįhí jv-N	Kategori:Bruker jv-N
Tʼááłáhági átʼéego:Choyoołʼįįhí ku-N	Kategori:Bruker ku-N
Tʼááłáhági átʼéego:Choyoołʼįįhí lv-N	Kategori:Bruker lv-N
Tʼááłáhági átʼéego:Choyoołʼįįhí li-N	Kategori:Bruker li-N
Tʼááłáhági átʼéego:Choyoołʼįįhí lt-N	Kategori:Bruker lt-N
Tʼááłáhági átʼéego:Choyoołʼįįhí lb-N	Kategori:Bruker lb-N
Tʼááłáhági átʼéego:Choyoołʼįįhí mg-N	Kategori:Bruker mg-N
Tʼááłáhági átʼéego:Choyoołʼįįhí nl-N	Kategori:Bruker nl-N
Tʼááłáhági átʼéego:Choyoołʼįįhí no-N	Kategori:Bruker no-N
Tʼááłáhági átʼéego:Choyoołʼįįhí nn-N	Kategori:Bruker nn-N
Tʼááłáhági átʼéego:Choyoołʼįįhí or-N	Kategori:Bruker or-N
Tʼááłáhági átʼéego:Choyoołʼįįhí ru-N	Kategori:Bruker ru-N
Tʼááłáhági átʼéego:Choyoołʼįįhí sh-N	Kategori:Bruker sh-N
Tʼááłáhági átʼéego:Choyoołʼįįhí sw-N	Kategori:Bruker sw-N
Tʼááłáhági átʼéego:Choyoołʼįįhí ta-N	Kategori:Bruker ta-N
Tʼááłáhági átʼéego:Choyoołʼįįhí ar-N	Kategori:Bruker ar-N
Bee álnééhí:User pdc-1	Mal:Bruker pdc-1
Tʼááłáhági átʼéego:Choyoołʼįįhí eu-3	Kategori:Bruker eu-3
Tʼááłáhági átʼéego:Choyoołʼįįhí eu-N	Kategori:Bruker eu-N
Tʼááłáhági átʼéego:Choyoołʼįįhí af	Kategori:Bruker af
Tʼááłáhági átʼéego:Choyoołʼįįhí af-1	Kategori:Bruker af-1
Tʼááłáhági átʼéego:Choyoołʼįįhí af-2	Kategori:Bruker af-2
Tʼááłáhági átʼéego:Choyoołʼįįhí af-3	Kategori:Bruker af-3
Tʼááłáhági átʼéego:Choyoołʼįįhí af-4	Kategori:Bruker af-4
Tʼááłáhági átʼéego:Choyoołʼįįhí af-N	Kategori:Bruker af-N
Tʼááłáhági átʼéego:Choyoołʼįįhí als	Kategori:Bruker als
Tʼááłáhági átʼéego:Choyoołʼįįhí als-1	Kategori:Bruker als-1
Tʼááłáhági átʼéego:Choyoołʼįįhí an	Kategori:Bruker an
Tʼááłáhági átʼéego:Choyoołʼįįhí ar	Kategori:Bruker ar
Tʼááłáhági átʼéego:Choyoołʼįįhí as	Kategori:Bruker as
Tʼááłáhági átʼéego:Choyoołʼįįhí as-N	Kategori:Bruker as-N
Tʼááłáhági átʼéego:Choyoołʼįįhí ast	Kategori:Bruker ast
Tʼááłáhági átʼéego:Choyoołʼįįhí ay	Kategori:Bruker ay
Tʼááłáhági átʼéego:Choyoołʼįįhí ay-4	Kategori:Bruker ay-4
Tʼááłáhági átʼéego:Choyoołʼįįhí az-1	Kategori:Bruker az-1
Tʼááłáhági átʼéego:Choyoołʼįįhí az-N	Kategori:Bruker az-N
Tʼááłáhági átʼéego:Choyoołʼįįhí bar	Kategori:Bruker bar
Tʼááłáhági átʼéego:Choyoołʼįįhí bar-1	Kategori:Bruker bar-1
Tʼááłáhági átʼéego:Choyoołʼįįhí bg	Kategori:Bruker bg
Tʼááłáhági átʼéego:Choyoołʼįįhí bg-1	Kategori:Bruker bg-1
Tʼááłáhági átʼéego:Choyoołʼįįhí bg-2	Kategori:Bruker bg-2
Tʼááłáhági átʼéego:Choyoołʼįįhí bg-3	Kategori:Bruker bg-3
Tʼááłáhági átʼéego:Choyoołʼįįhí bg-N	Kategori:Bruker bg-N
Tʼááłáhági átʼéego:Choyoołʼįįhí ca	Kategori:Bruker ca
Tʼááłáhági átʼéego:Choyoołʼįįhí ca-1	Kategori:Bruker ca-1
Tʼááłáhági átʼéego:Choyoołʼįįhí ca-2	Kategori:Bruker ca-2
Tʼááłáhági átʼéego:Tádídíín deiyání	Kategori:Bladbiller
Tʼááłáhági átʼéego:Choyoołʼįįhí ca-3	Kategori:Bruker ca-3
Tʼááłáhági átʼéego:Choyoołʼįįhí ca-4	Kategori:Bruker ca-4
Tʼááłáhági átʼéego:Choyoołʼįįhí ca-N	Kategori:Bruker ca-N
Tʼááłáhági átʼéego:Choyoołʼįįhí chr-1	Kategori:Bruker chr-1
Tʼááłáhági átʼéego:Choyoołʼįįhí cs	Kategori:Bruker cs
Tʼááłáhági átʼéego:Choyoołʼįįhí da	Kategori:Bruker da
Tʼááłáhági átʼéego:Choyoołʼįįhí sk-N	Kategori:Bruker sk-N
Tʼááłáhági átʼéego:Choyoołʼįįhí da-3	Kategori:Bruker da-3
Tʼááłáhági átʼéego:Choyoołʼįįhí da-4	Kategori:Bruker da-4
Tʼááłáhági átʼéego:Choyoołʼįįhí de	Kategori:Bruker de
Tʼááłáhági átʼéego:Choyoołʼįįhí de-2	Kategori:Bruker de-2
Tʼááłáhági átʼéego:Choyoołʼįįhí de-3	Kategori:Bruker de-3
Tʼááłáhági átʼéego:Choyoołʼįįhí de-4	Kategori:Bruker de-4
Tʼááłáhági átʼéego:Choyoołʼįįhí de-N	Kategori:Bruker de-N
Tʼááłáhági átʼéego:Choyoołʼįįhí dsb	Kategori:Bruker dsb
Tʼááłáhági átʼéego:Choyoołʼįįhí dsb-1	Kategori:Bruker dsb-1
Tʼááłáhági átʼéego:Choyoołʼįįhí el	Kategori:Bruker el
Tʼááłáhági átʼéego:Choyoołʼįįhí el-1	Kategori:Bruker el-1
Tʼááłáhági átʼéego:Choyoołʼįįhí el-2	Kategori:Bruker el-2
Tʼááłáhági átʼéego:Choyoołʼįįhí el-3	Kategori:Bruker el-3
Tʼááłáhági átʼéego:Choyoołʼįįhí el-N	Kategori:Bruker el-N
Tʼááłáhági átʼéego:Choyoołʼįįhí en-0	Kategori:Bruker en-0
Tʼááłáhági átʼéego:Choyoołʼįįhí en-3	Kategori:Bruker en-3
Tʼááłáhági átʼéego:Choyoołʼįįhí en-N	Kategori:Bruker en-N
Tʼááłáhági átʼéego:Choyoołʼįįhí eo-1	Kategori:Bruker eo-1
Tʼááłáhági átʼéego:Choyoołʼįįhí eo-2	Kategori:Bruker eo-2
Tʼááłáhági átʼéego:Choyoołʼįįhí eo-3	Kategori:Bruker eo-3
Tʼááłáhági átʼéego:Choyoołʼįįhí eo-4	Kategori:Bruker eo-4
Tʼááłáhági átʼéego:Choyoołʼįįhí eo-N	Kategori:Bruker eo-N
Tʼááłáhági átʼéego:Choyoołʼįįhí es	Kategori:Bruker es
Tʼááłáhági átʼéego:Choyoołʼįįhí es-1	Kategori:Bruker es-1
Tʼááłáhági átʼéego:Choyoołʼįįhí es-2	Kategori:Bruker es-2
Tʼááłáhági átʼéego:Choyoołʼįįhí es-3	Kategori:Bruker es-3
Tʼááłáhági átʼéego:Choyoołʼįįhí es-4	Kategori:Bruker es-4
Tʼááłáhági átʼéego:Choyoołʼįįhí es-N	Kategori:Bruker es-N
Tʼááłáhági átʼéego:Choyoołʼįįhí eu	Kategori:Bruker eu
Tʼááłáhági átʼéego:Choyoołʼįįhí eu-1	Kategori:Bruker eu-1
Tʼááłáhági átʼéego:Choyoołʼįįhí eu-2	Kategori:Bruker eu-2
Tʼááłáhági átʼéego:Choyoołʼįįhí fa	Kategori:Bruker fa
Tʼááłáhági átʼéego:Choyoołʼįįhí fa-1	Kategori:Bruker fa-1
Tʼááłáhági átʼéego:Choyoołʼįįhí fa-2	Kategori:Bruker fa-2
Tʼááłáhági átʼéego:Choyoołʼįįhí fa-3	Kategori:Bruker fa-3
Tʼááłáhági átʼéego:Choyoołʼįįhí fa-N	Kategori:Bruker fa-N
Tʼááłáhági átʼéego:Choyoołʼįįhí fi	Kategori:Bruker fi
Tʼááłáhági átʼéego:Choyoołʼįįhí fi-2	Kategori:Bruker fi-2
Tʼááłáhági átʼéego:Choyoołʼįįhí fi-3	Kategori:Bruker fi-3
Tʼááłáhági átʼéego:Choyoołʼįįhí fi-4	Kategori:Bruker fi-4
Tʼááłáhági átʼéego:Choyoołʼįįhí fi-N	Kategori:Bruker fi-N
Tʼááłáhági átʼéego:Choyoołʼįįhí fy	Kategori:Bruker fy
Tʼááłáhági átʼéego:Choyoołʼįįhí fy-1	Kategori:Bruker fy-1
Tʼááłáhági átʼéego:Choyoołʼįįhí ga-2	Kategori:Bruker ga-2
Tʼááłáhági átʼéego:Choyoołʼįįhí ga-3	Kategori:Bruker ga-3
Tʼááłáhági átʼéego:Choyoołʼįįhí ga-N	Kategori:Bruker ga-N
Tʼááłáhági átʼéego:Choyoołʼįįhí grc	Kategori:Bruker grc
Tʼááłáhági átʼéego:Choyoołʼįįhí grc-1	Kategori:Bruker grc-1
Tʼááłáhági átʼéego:Choyoołʼįįhí grc-2	Kategori:Bruker grc-2
Tʼááłáhági átʼéego:Choyoołʼįįhí grc-3	Kategori:Bruker grc-3
Tʼááłáhági átʼéego:Choyoołʼįįhí gsw	Kategori:Bruker gsw
Tʼááłáhági átʼéego:Choyoołʼįįhí he	Kategori:Bruker he
Tʼááłáhági átʼéego:Choyoołʼįįhí he-1	Kategori:Bruker he-1
Tʼááłáhági átʼéego:Choyoołʼįįhí he-2	Kategori:Bruker he-2
Tʼááłáhági átʼéego:Choyoołʼįįhí he-3	Kategori:Bruker he-3
Tʼááłáhági átʼéego:Choyoołʼįįhí he-N	Kategori:Bruker he-N
Tʼááłáhági átʼéego:Choyoołʼįįhí hr-1	Kategori:Bruker hr-1
Tʼááłáhági átʼéego:Choyoołʼįįhí hr-2	Kategori:Bruker hr-2
Tʼááłáhági átʼéego:Choyoołʼįįhí hr-3	Kategori:Bruker hr-3
Tʼááłáhági átʼéego:Choyoołʼįįhí hsb	Kategori:Bruker hsb
Tʼááłáhági átʼéego:Choyoołʼįįhí hsb-1	Kategori:Bruker hsb-1
Tʼááłáhági átʼéego:Choyoołʼįįhí hu	Kategori:Bruker hu
Tʼááłáhági átʼéego:Choyoołʼįįhí hu-1	Kategori:Bruker hu-1
Tʼááłáhági átʼéego:Choyoołʼįįhí hu-3	Kategori:Bruker hu-3
Tʼááłáhági átʼéego:Choyoołʼįįhí hy	Kategori:Bruker hy
Tʼááłáhági átʼéego:Choyoołʼįįhí hy-1	Kategori:Bruker hy-1
Tʼááłáhági átʼéego:Choyoołʼįįhí id-1	Kategori:Bruker id-1
Tʼááłáhági átʼéego:Choyoołʼįįhí id-2	Kategori:Bruker id-2
Tʼááłáhági átʼéego:Choyoołʼįįhí id-3	Kategori:Bruker id-3
Tʼááłáhági átʼéego:Choyoołʼįįhí io	Kategori:Bruker io
Tʼááłáhági átʼéego:Choyoołʼįįhí io-1	Kategori:Bruker io-1
Tʼááłáhági átʼéego:Choyoołʼįįhí io-2	Kategori:Bruker io-2
Tʼááłáhági átʼéego:Choyoołʼįįhí io-3	Kategori:Bruker io-3
Tʼááłáhági átʼéego:Choyoołʼįįhí is	Kategori:Bruker is
Tʼááłáhági átʼéego:Choyoołʼįįhí is-1	Kategori:Bruker is-1
Tʼááłáhági átʼéego:Choyoołʼįįhí is-2	Kategori:Bruker is-2
Tʼááłáhági átʼéego:Choyoołʼįįhí is-3	Kategori:Bruker is-3
Tʼááłáhági átʼéego:Choyoołʼįįhí is-4	Kategori:Bruker is-4
Tʼááłáhági átʼéego:Choyoołʼįįhí als-N	Kategori:Bruker als-N
Bee álnééhí:User la-3	Mal:Bruker la-3
Tʼááłáhági átʼéego:Choyoołʼįįhí pt-3	Kategori:Bruker pt-3
Tʼááłáhági átʼéego:Choyoołʼįįhí pl-N	Kategori:Bruker pl-N
Tʼááłáhági átʼéego:Choyoołʼįįhí pt-1	Kategori:Bruker pt-1
Tʼááłáhági átʼéego:Choyoołʼįįhí ka-1	Kategori:Bruker ka-1
Bee álnééhí:Hooʼááłígíí	Mal:Administrator
Tʼááłáhági átʼéego:Choyoołʼįįhí it	Kategori:Bruker it
Tʼááłáhági átʼéego:Choyoołʼįįhí it-1	Kategori:Bruker it-1
Tʼááłáhági átʼéego:Choyoołʼįįhí ja-1	Kategori:Bruker ja-1
Tʼááłáhági átʼéego:Choyoołʼįįhí jv	Kategori:Bruker jv
Tʼááłáhági átʼéego:Choyoołʼįįhí jv-2	Kategori:Bruker jv-2
Tʼááłáhági átʼéego:Choyoołʼįįhí jv-3	Kategori:Bruker jv-3
Tʼááłáhági átʼéego:Choyoołʼįįhí ka	Kategori:Bruker ka
Tʼááłáhági átʼéego:Choyoołʼįįhí kl	Kategori:Bruker kl
Tʼááłáhági átʼéego:Choyoołʼįįhí kl-1	Kategori:Bruker kl-1
Tʼááłáhági átʼéego:Choyoołʼįįhí km-1	Kategori:Bruker km-1
Tʼááłáhági átʼéego:Choyoołʼįįhí km-2	Kategori:Bruker km-2
Tʼááłáhági átʼéego:Choyoołʼįįhí km-3	Kategori:Bruker km-3
Tʼááłáhági átʼéego:Choyoołʼįįhí km-N	Kategori:Bruker km-N
Tʼááłáhági átʼéego:Choyoołʼįįhí kn	Kategori:Bruker kn
Tʼááłáhági átʼéego:Choyoołʼįįhí kn-1	Kategori:Bruker kn-1
Tʼááłáhági átʼéego:Choyoołʼįįhí ko	Kategori:Bruker ko
Tʼááłáhági átʼéego:Wááshindoon bikéyah bił haʼdaʼhaasdzoígíí	Kategori:USAs delstater
Tʼááłáhági átʼéego:Choyoołʼįįhí ko-1	Kategori:Bruker ko-1
Tʼááłáhági átʼéego:Choyoołʼįįhí ko-2	Kategori:Bruker ko-2
Tʼááłáhági átʼéego:Choyoołʼįįhí ko-3	Kategori:Bruker ko-3
Tʼááłáhági átʼéego:Choyoołʼįįhí ksh	Kategori:Bruker ksh
Tʼááłáhági átʼéego:Choyoołʼįįhí ksh-1	Kategori:Bruker ksh-1
Tʼááłáhági átʼéego:Choyoołʼįįhí ksh-2	Kategori:Bruker ksh-2
Tʼááłáhági átʼéego:Choyoołʼįįhí ksh-3	Kategori:Bruker ksh-3
Tʼááłáhági átʼéego:Choyoołʼįįhí ksh-N	Kategori:Bruker ksh-N
Tʼááłáhági átʼéego:Choyoołʼįįhí ku	Kategori:Bruker ku
Tʼááłáhági átʼéego:Choyoołʼįįhí la-1	Kategori:Bruker la-1
Tʼááłáhági átʼéego:Choyoołʼįįhí la-3	Kategori:Bruker la-3
Tʼááłáhági átʼéego:Choyoołʼįįhí lb	Kategori:Bruker lb
Tʼááłáhági átʼéego:Choyoołʼįįhí lb-1	Kategori:Bruker lb-1
Tʼááłáhági átʼéego:Choyoołʼįįhí lb-2	Kategori:Bruker lb-2
Tʼááłáhági átʼéego:Choyoołʼįįhí lb-3	Kategori:Bruker lb-3
Tʼááłáhági átʼéego:Dibé Nitsaa Hahoodzodi kin naaznilígíí	Kategori:Byer i Colorado
Tʼááłáhági átʼéego:Choyoołʼįįhí nn-2	Kategori:Bruker nn-2
Tʼááłáhági átʼéego:Choyoołʼįįhí ru-1	Kategori:Bruker ru-1
Bee álnééhí:User af-4	Mal:Bruker af-4
Yaaʼ bijáád hastánígíí	Pels- og fjærlus
Bee álnééhí:User sv-1	Mal:Bruker sv-1
Tʼááłáhági átʼéego:Choyoołʼįįhí lv	Kategori:Bruker lv
Tʼááłáhági átʼéego:Choyoołʼįįhí ms-1	Kategori:Bruker ms-1
Nahasdzáán bimagnetic field	Jordens magnetfelt
Tsiiʼyiishbizhí dinéʼiʼ	Kinesere
Tʼááłáhági átʼéego:Choyoołʼįįhí als-3	Kategori:Bruker als-3
Bee álnééhí:User jv	Mal:User jv
Bee álnééhí:User id	Mal:User id
Tʼááłáhági átʼéego:Choyoołʼįįhí nds	Kategori:Bruker nds
Tʼááłáhági átʼéego:Choyoołʼįįhí nds-1	Kategori:Bruker nds-1
Tʼááłáhági átʼéego:Choyoołʼįįhí nds-2	Kategori:Bruker nds-2
Tʼááłáhági átʼéego:Choyoołʼįįhí nds-3	Kategori:Bruker nds-3
Tʼááłáhági átʼéego:Choyoołʼįįhí nds-N	Kategori:Bruker nds-N
Tʼááłáhági átʼéego:Choyoołʼįįhí nds-nl	Kategori:Bruker nds-nl
Tʼááłáhági átʼéego:Kéyah Ałhidadiidzooígíí dóó Ahiih Yikaígíí	Kategori:Internasjonale organisasjoner
Tʼááłáhági átʼéego:Chʼosh bijáád dahólónígíí	Kategori:Leddyr
Tʼááłáhági átʼéego:Tó	Kategori:Vann
Tʼááłáhági átʼéego:Bidił daazdoígíí dóó daʼalghałígíí	Kategori:Rovdyr
Tʼááłáhági átʼéego:Choyoołʼįįhí nn-1	Kategori:Bruker nn-1
Tʼááłáhági átʼéego:Choyoołʼįįhí nb	Kategori:Bruker nb
Bee álnééhí:User sw-1	Mal:Bruker sw-1
Bee álnééhí:User af	Mal:Bruker af
Tʼááłáhági átʼéego:Naakaii Łizhiní Bikéyah	Kategori:Land i Afrika
Bee álnééhí:User da-3	Mal:Bruker da-3
Bee álnééhí:User ja-2	Mal:Bruker ja-2
Bee álnééhí:User ko-1	Mal:Bruker ko-1
Bee álnééhí:User cs	Mal:User cs
Bee álnééhí:User ru-2	Mal:Bruker ru-2
Bee álnééhí:User es-3	Mal:Bruker es-3
Bee álnééhí:User eu-1	Mal:Bruker eu-1
Bee álnééhí:User ko-3	Mal:Bruker ko-3
Tʼááłáhági átʼéego:Tsin bineestʼąʼ dadíkʼǫ́zhígíí	Kategori:Sitrusfrukt
Tʼááłáhági átʼéego:Choyoołʼįįhí pt-2	Kategori:Bruker pt-2
Tʼááłáhági átʼéego:Choyoołʼįįhí pt-N	Kategori:Bruker pt-N
Tʼááłáhági átʼéego:Choyoołʼįįhí ro-2	Kategori:Bruker ro-2
Tʼááłáhági átʼéego:Choyoołʼįįhí ro-3	Kategori:Bruker ro-3
Tʼááłáhági átʼéego:Choyoołʼįįhí ro-N	Kategori:Bruker ro-N
Tʼááłáhági átʼéego:Choyoołʼįįhí ru	Kategori:Bruker ru
Tʼááłáhági átʼéego:Choyoołʼįįhí ru-2	Kategori:Bruker ru-2
Tʼááłáhági átʼéego:Choyoołʼįįhí ru-3	Kategori:Bruker ru-3
Tʼááłáhági átʼéego:Choyoołʼįįhí ru-4	Kategori:Bruker ru-4
Tʼááłáhági átʼéego:Choyoołʼįįhí sk-1	Kategori:Bruker sk-1
Tʼááłáhági átʼéego:Choyoołʼįįhí sr	Kategori:Bruker sr
Tʼááłáhági átʼéego:Choyoołʼįįhí sr-1	Kategori:Bruker sr-1
Tʼááłáhági átʼéego:Choyoołʼįįhí sr-2	Kategori:Bruker sr-2
Tʼááłáhági átʼéego:Choyoołʼįįhí sr-3	Kategori:Bruker sr-3
Tʼááłáhági átʼéego:Choyoołʼįįhí sr-N	Kategori:Bruker sr-N
Tʼááłáhági átʼéego:Choyoołʼįįhí sv-1	Kategori:Bruker sv-1
Tʼááłáhági átʼéego:Choyoołʼįįhí sv-3	Kategori:Bruker sv-3
Tʼááłáhági átʼéego:Choyoołʼįįhí sv-4	Kategori:Bruker sv-4
Tʼááłáhági átʼéego:Choyoołʼįįhí sv-N	Kategori:Bruker sv-N
Tʼááłáhági átʼéego:Choyoołʼįįhí sxu	Kategori:Bruker sxu
Tʼááłáhági átʼéego:Choyoołʼįįhí sxu-1	Kategori:Bruker sxu-1
Tʼááłáhági átʼéego:Choyoołʼįįhí ta-1	Kategori:Bruker ta-1
Tʼááłáhági átʼéego:Choyoołʼįįhí th-1	Kategori:Bruker th-1
Tʼááłáhági átʼéego:Choyoołʼįįhí th-N	Kategori:Bruker th-N
Tʼááłáhági átʼéego:Choyoołʼįįhí tr	Kategori:Bruker tr
Tʼááłáhági átʼéego:Choyoołʼįįhí tr-4	Kategori:Bruker tr-4
Tʼááłáhági átʼéego:Choyoołʼįįhí tr-N	Kategori:Bruker tr-N
Tʼááłáhági átʼéego:Choyoołʼįįhí uk-1	Kategori:Bruker uk-1
Tʼááłáhági átʼéego:Choyoołʼįįhí uk-2	Kategori:Bruker uk-2
Tʼááłáhági átʼéego:Choyoołʼįįhí uk-4	Kategori:Bruker uk-4
Tʼááłáhági átʼéego:Choyoołʼįįhí vi	Kategori:Bruker vi
Tʼááłáhági átʼéego:Choyoołʼįįhí vi-1	Kategori:Bruker vi-1
Tʼááłáhági átʼéego:Choyoołʼįįhí vi-2	Kategori:Bruker vi-2
Tʼááłáhági átʼéego:Choyoołʼįįhí vi-N	Kategori:Bruker vi-N
Tʼááłáhági átʼéego:Choyoołʼįįhí vls	Kategori:Bruker vls
Tʼááłáhági átʼéego:Choyoołʼįįhí vls-1	Kategori:Bruker vls-1
Tʼááłáhági átʼéego:Choyoołʼįįhí yue-1	Kategori:Bruker yue-1
Tʼááłáhági átʼéego:Choyoołʼįįhí yue-N	Kategori:Bruker yue-N
Bee álnééhí:User ro-1	Mal:Bruker ro-1
Tʼááłáhági átʼéego:Tsin ííʼáhígíí	Kategori:Tresorter
Náshdóítsoh (Ałtsʼáʼáztiin)	Store katter
Bee álnééhí:User ca	Mal:Bruker ca
Tʼááłáhági átʼéego:Mágí: Diné Ndahalinígíí	Kategori:Menneskeaper
Tʼááłáhági átʼéego:Mágí	Kategori:Primater
Bee álnééhí:LivingP	Mal:Blp
Bee álnééhí:User sv-3	Mal:Bruker sv-3
Bee álnééhí:User hy-1	Mal:Bruker hy-1
Bee álnééhí:User af-3	Mal:Bruker af-3
Tʼááłáhági átʼéego:Naaki góneʼ yéigo daʼahijoogą́ą́ʼ	Kategori:Andre verdenskrig
Tʼááłáhági átʼéego:Mósí dóó Náshdóí	Kategori:Kattedyr
Tʼááłáhági átʼéego:Tó Kéyah Bináhaazyínígíí	Kategori:Øystater
Bee álnééhí:User ar-4	Mal:Bruker ar-4
Bee álnééhí:User be	Mal:Bruker be
Bee álnééhí:User ca-2	Mal:Bruker ca-2
Bee álnééhí:User ca-3	Mal:Bruker ca-3
Bee álnééhí:User el-2	Mal:Bruker el-2
Bee álnééhí:User et-3	Mal:Bruker et-3
Bee álnééhí:User fi-2	Mal:Bruker fi-2
Bee álnééhí:User fi-3	Mal:Bruker fi-3
Bee álnééhí:User he-3	Mal:Bruker he-3
Bee álnééhí:User ko	Mal:Bruker ko
Bee álnééhí:User la-2	Mal:Bruker la-2
Bee álnééhí:User mk-1	Mal:Bruker mk-1
Bee álnééhí:User nn-2	Mal:Bruker nn-2
Bee álnééhí:User no-1	Mal:Bruker no-1
Bee álnééhí:User pt	Mal:Bruker pt
Bee álnééhí:User ru-1	Mal:Bruker ru-1
Bee álnééhí:User sk-2	Mal:Bruker sk-2
Bee álnééhí:User sr-1	Mal:Bruker sr-1
Bee álnééhí:User sxu-1	Mal:Bruker sxu-1
Bee álnééhí:User uk-1	Mal:Bruker uk-1
Bee álnééhí:User uk-4	Mal:Bruker uk-4
Bee álnééhí:User vo-1	Mal:Bruker vo-1
Bee álnééhí:User zh-1	Mal:Bruker zh-1
Bee álnééhí:User zh-2	Mal:Bruker zh-2
Tʼááłáhági átʼéego:Naakaii Łizhiní Bikéyahdę́ę́ʼ Ndaaldeehii	Kategori:Afrikas fauna
Tʼááłáhági átʼéego:Choyoołʼįįhí nl	Kategori:Bruker nl
Tʼááłáhági átʼéego:Choyoołʼįįhí nn-3	Kategori:Bruker nn-3
Tʼááłáhági átʼéego:Choyoołʼįįhí no-1	Kategori:Bruker no-1
Tʼááłáhági átʼéego:Choyoołʼįįhí no-2	Kategori:Bruker no-2
Tʼááłáhági átʼéego:Choyoołʼįįhí no	Kategori:Bruker no
Tʼááłáhági átʼéego:Choyoołʼįįhí pi-1	Kategori:Bruker pi-1
Tʼááłáhági átʼéego:Choyoołʼįįhí nds-nl-1	Kategori:Bruker nds-nl-1
Tʼááłáhági átʼéego:Choyoołʼįįhí zh-1	Kategori:Bruker zh-1
Tʼááłáhági átʼéego:Choyoołʼįįhí zh-4	Kategori:Bruker zh-4
Tʼááłáhági átʼéego:Choyoołʼįįhí zh-3	Kategori:Bruker zh-3
Tʼááłáhági átʼéego:Choyoołʼįįhí zh-2	Kategori:Bruker zh-2
Tʼááłáhági átʼéego:Chʼał	Kategori:Springpadder
Tʼááłáhági átʼéego:Atłʼóóh	Kategori:Veving
Tʼááłáhági átʼéego:Mąʼii yił Ałhidanoolinígíí Yázhí	Kategori:Halvbjørner
Tʼááłáhági átʼéego:Chéłchaaʼ	Kategori:Biller
Tʼááłáhági átʼéego:Naakáí dootłʼizhí dóó Bééshbichʼahii dabizaad ndahalinígíí	Kategori:Indoeuropeiske språk
Tʼááłáhági átʼéego:Hazéí	Kategori:Ekornfamilien
Tʼááłáhági átʼéego:Chidí naatʼaʼí ńdinibįįhígi	Kategori:Flyplasser
Tʼááłáhági átʼéego:Áʼádaatʼéhígíí	Kategori:Grunnstoffer
Bee álnééhí:User als-2	Mal:Bruker als-2
Bee álnééhí:User de-4	Mal:Bruker de-4
Tʼááłáhági átʼéego:Biwooʼ Ádaałtsʼíísígíí dóó Kááʼtsʼiní	Kategori:Gomlere
Tʼááłáhági átʼéego:Abeʼ bitsʼą́ą́dóó ádaalyaaígíí	Kategori:Meieriprodukter
Tʼááłáhági átʼéego:Tsin dóó chʼil bineestʼąʼ	Kategori:Frukt
Tʼááłáhági átʼéego:Kʼaalógii dóó Iichʼąhii	Kategori:Sommerfugler
Tʼááłáhági átʼéego:Chʼosh bijáád ádaadinígíí	Kategori:Bløtdyr
Tʼááłáhági átʼéego:Deeteel Bikéyah bił haʼdaʼhaasdzoígíí	Kategori:Canadas provinser og territorier
Tʼááłáhági átʼéego:Shádiʼááhdę́ę́ʼ Mágí	Kategori:Vestaper
Tʼááłáhági átʼéego:Gáagii dóó Joogii Ndahalinígíí	Kategori:Kråkefugler
Tʼááłáhági átʼéego:Mąʼii dóó Łééchąąʼí	Kategori:Hundedyr
Tʼááłáhági átʼéego:Tó Wónaanídę́ę́ʼ Mágí	Kategori:Dyreaper
Tʼááłáhági átʼéego:Naayízí dóó taʼneeskʼání	Kategori:Gresskarfamilien
Tʼááłáhági átʼéego:Dlǫ́ʼii Ndahalinígíí	Kategori:Mårdyr
Tʼááłáhági átʼéego:Łóóʼtsoh biwooʼ dantłʼizígíí	Kategori:Tannhvaler
Tʼááłáhági átʼéego:Łóóʼtsoh biwooʼ daditsʼózígíí	Kategori:Bardehvaler
Tʼááłáhági átʼéego:Naaldeehii	Kategori:Dyr
Tʼááłáhági átʼéego:Shádiʼááhdę́ę́ʼ Ndaaldeehii	Kategori:Sør-Amerikas fauna
Tʼááłáhági átʼéego:Bizaʼazis Dahólónígíí	Kategori:Pungdyr
Tʼááłáhági átʼéego:Choyoołʼįįhí pfl-1	Kategori:Bruker pfl-1
Tʼááłáhági átʼéego:Chʼosh chʼééh diikáhii	Kategori:Snegler
Tʼááłáhági átʼéego:Chʼosh bitsʼaʼígíí	Kategori:Muslinger
Tʼááłáhági átʼéego:Gah	Kategori:Haredyr
Tʼááłáhági átʼéego:Łóóʼtsoh dóó Tééh hóyáanii	Kategori:Hvaler
Tʼááłáhági átʼéego:Eʼeʼaahjí Tónteel bikáaʼgi Kéyah dah Ndaaʼeełígíí	Kategori:Øyer i Stillehavet
Tʼááłáhági átʼéego:Łóóʼ Bigaan Dahólónígíí	Kategori:Blekkspruter
Tʼááłáhági átʼéego:Chʼééh digháhii dóó Tsisteeł	Kategori:Skilpadder
Tʼááłáhági átʼéego:Béésh	Kategori:Metaller
Tʼááłáhági átʼéego:Naayééʼ	Kategori:Dinosaurer
Tʼááłáhági átʼéego:Choyoołʼįįhí pi	Kategori:Bruker pi
Tʼááłáhági átʼéego:Choyoołʼįįhí pl	Kategori:Bruker pl
Tʼááłáhági átʼéego:Chʼosh bikágí dantłʼizí	Kategori:Krepsdyr
Tʼááłáhági átʼéego:Jaaʼabaní	Kategori:Flaggermus
Tʼááłáhági átʼéego:Tłʼiish	Kategori:Slanger
Tʼááłáhági átʼéego:Beʼekʼid	Kategori:Innsjøer
Kʼíshíshjį́į́zh	Giftsumak
Bee álnééhí:User nn-4	Mal:Bruker nn-4
Tʼááłáhági átʼéego:Bįįh	Kategori:Hjortedyr
Tʼááłáhági átʼéego:Łóóʼ hashkéhé	Kategori:Haier
Tʼááłáhági átʼéego:Łóóʼ ooshgę́ęzhii	Kategori:Bruskfisker
Tʼááłáhági átʼéego:Chidí	Kategori:Biler
Bee álnééhí:User lb	Mal:Bruker lb
Bee álnééhí:User af-2	Mal:Bruker af-2
Chąąshtʼezhiitsoh	Gulrot
Tʼááłáhági átʼéego:Kéyah bił haʼdaʼhaasdzoígíí	Kategori:Undernasjonale områder
Tséyooʼáałii	Snutebiller
Tʼááłáhági átʼéego:Łį́į́ʼ Ndahalinígíí	Kategori:Hestefamilien
Tʼááłáhági átʼéego:Wóʼatsʼǫǫsii Ádaatʼéhígíí	Kategori:Nebbmunner
Tʼááłáhági átʼéego:Tsin Deigházhígíí	Kategori:Gnagere
Bee álnééhí:User sl-1	Mal:Bruker sl-1
Tʼááłáhági átʼéego:Choyoołʼįįhí ab	Kategori:Bruker ab
Tʼááłáhági átʼéego:Choyoołʼįįhí ab-3	Kategori:Bruker ab-3
Bee álnééhí:User pl-3	Mal:User pl-3
Bee álnééhí:User an-1	Mal:Bruker an-1
Bee álnééhí:User vo-4	Mal:Bruker vo-4
Bee álnééhí:User vo-3	Mal:Bruker vo-3
Bee álnééhí:User vo-2	Mal:Bruker vo-2
Bee álnééhí:User vo	Mal:Bruker vo
Bee álnééhí:User nb	Mal:Bruker nb
Bee álnééhí:User nah-1	Mal:Bruker nah-1
Bee álnééhí:User lt-1	Mal:Bruker lt-1
Bee álnééhí:User grc-2	Mal:Bruker grc-2
Bee álnééhí:User fi-4	Mal:Bruker fi-4
Bee álnééhí:User el-3	Mal:Bruker el-3
Bee álnééhí:User cs-4	Mal:Bruker cs-4
Bee álnééhí:User eu-3	Mal:Bruker eu-3
Bee álnééhí:User ast	Mal:Bruker ast
Tʼááłáhági átʼéego:Dlǫ́ʼii yił Aheedaałtʼéhígíí	Kategori:Mungofamilien
Bee álnééhí:User eu-2	Mal:Bruker eu-2
Tʼááłáhági átʼéego:Chʼosh Deildeełii	Kategori:Insektetere
Tʼááłáhági átʼéego:Tábąąstííntsoh	Kategori:Seler
Tʼááłáhági átʼéego:Táłkáaʼgi Tsídii	Kategori:Andefugler
Tʼááłáhági átʼéego:Chʼosh bijáád tseebíhígíí	Kategori:Edderkoppdyr
Tʼááłáhági átʼéego:Shash	Kategori:Bjørner
Tʼááłáhági átʼéego:Tsékooh	Kategori:Juv
Tó bichʼoshtsoh	Kjempevannteger
Tʼááłáhági átʼéego:Chʼosh bijáád neeznánígíí	Kategori:Tifotkreps
Tʼááłáhági átʼéego:Dziil / Atsiniltłʼish álʼį́	Kategori:Energi
Tʼááłáhági átʼéego:Shádiʼááh biyaadi dóó Kéyah Yistinígíí bikáaʼgi Ndaaldeehii	Kategori:Antarktis' fauna
Tʼááłáhági átʼéego:Nahatʼeʼiitsoh Bikéyahdę́ę́ʼ Ndaaldeehii	Kategori:Australias fauna
Tʼááłáhági átʼéego:Tsʼíʼii dóó Tséʼédǫ́ʼii	Kategori:Fluer
Tʼááłáhági átʼéego:Tązhii dóó Naaʼahóóhai Ndahalinígíí	Kategori:Hønsefugler
Tʼááłáhági átʼéego:Tééh łééchąąʼí	Kategori:Hyener
Tʼááłáhági átʼéego:Kǫʼ naʼałbąąsii ninádaaltłiʼígi	Kategori:Jernbanestasjoner
Tʼááłáhági átʼéego:Daʼałtʼoʼígíí biyęęzhii deiłchíhígíí	Kategori:Kloakkdyr
Tʼááłáhági átʼéego:Chéłchaaʼ bigaantéłígíí	Kategori:Skarabider
Tʼááłáhági átʼéego:Tábąąsdísí	Kategori:Snipefugler
Tʼááłáhági átʼéego:Séigoʼ	Kategori:Skorpioner
Tʼááłáhági átʼéego:Táłtłʼááhdę́ę́ʼ dóó tónteel biyiʼdę́ę́ʼ chʼiyáán	Kategori:Sjømat
Tʼááłáhági átʼéego:Tsin naaʼeeł	Kategori:Skip
Tʼááłáhági átʼéego:Naʼashjéʼii	Kategori:Edderkopper
Tʼááłáhági átʼéego:Jááłánii	Kategori:Mangefotinger
Tʼááłáhági átʼéego:Bisóodi	Kategori:Tamsvinraser
Tʼááłáhági átʼéego:Choyoołʼįįhí pfl	Kategori:Bruker pfl
Tʼááłáhági átʼéego:Choyoołʼįįhí nn-4	Kategori:Bruker nn-4
Tʼááłáhági átʼéego:Choyoołʼįįhí no-4	Kategori:Bruker no-4
Tʼááłáhági átʼéego:Azeeʼ	Kategori:Medisinplanter
Tʼááłáhági átʼéego:Choyoołʼįįhí nl-4	Kategori:Bruker nl-4
Tʼááłáhági átʼéego:Naʼastsʼǫǫsí dóó Łéʼétsoh	Kategori:Musefamilien
Bee álnééhí:User cs-2	Mal:Bruker cs-2
Bee álnééhí:Image label begin	Mal:Image label begin
Tʼááłáhági átʼéego:Yootó Hahoodzodi kin naaznilígíí	Kategori:Byer i New Mexico
Tʼááłáhági átʼéego:Choyoołʼįįhí fa-4	Kategori:Bruker fa-4
Bee álnééhí:User vi	Mal:Bruker vi
Tʼááłáhági átʼéego:Choyoołʼįįhí en-1	Kategori:Bruker en-1
Tʼááłáhági átʼéego:Choyoołʼįįhí de-1	Kategori:Bruker de-1
Tʼááłáhági átʼéego:Choyoołʼįįhí hess-N	Kategori:Bruker hess-N
Tʼááłáhági átʼéego:Choyoołʼįįhí da-N	Kategori:Bruker da-N
Tʼááłáhági átʼéego:Choyoołʼįįhí gl-2	Kategori:Bruker gl-2
Tʼááłáhági átʼéego:Choyoołʼįįhí or	Kategori:Bruker or
Yaaʼ bijáád tseebíhígíí	Flåtter
Bee álnééhí:User vls-1	Mal:Bruker vls-1
Tsiiyázhí (dééł)	Trompetfugler
Bee álnééhí:User nl-4	Mal:Bruker nl-4
Bee álnééhí:User no-4	Mal:Bruker no-4
Bee álnééhí:User ru-3	Mal:Bruker ru-3
Bee álnééhí:User nl-3	Mal:Bruker nl-3
Bee álnééhí:User als-3	Mal:Bruker als-3
Bee álnééhí:User sh-2	Mal:Bruker sh-2
Kʼaalógii	Rhopalocera
Akétłʼóól łichxííʼí yázhí	Reddik
Special:RecentChanges	Spesial:Siste endringer
Tʼááłáhági átʼéego:Choyoołʼįįhí ja-4	Kategori:Bruker ja-4
Kʼaalógii ntsxaaígíí	Fuglevinger
