ئافرىقا	Afrika
ياپونىيە	Japan
جەنۇبىي ئامېرىكا	Sør-Amerika
نورۋېگىيە	Norge
Shotlandiye	Skottland
Wélsh	Wales
ۋېنگرىيە	Ungarn
ئىسپانىيە	Spania
ئامېرىكا قوشما شىتاتلىرى	USA
بېلگىيە	Belgia
ليۇكسېمبۇرگ	Luxembourg
يەر شارى	Jorden
گېئورگى ۋاشىنگتون	George Washington
فىنلاندىيە	Finland
شۋېتسىيە	Sverige
دانىيە	Danmark
لەھىستان	Polen
لىتۋا	Litauen
ئىتالىيە	Italia
شۋېتسارىيە	Sveits
ئاۋستىرىيە	Østerrike
گرېتسىيە	Hellas
تۈركىيە جۇمھۇرىيىتى	Tyrkia
پورتۇگالىيە	Portugal
ياۋروپا	Europa
ئاسىيا	Asia
شىمالىي ئامېرىكا	Nord-Amerika
ۋىكىپېدىيە	Wikipedia
گوللاندىيە	Nederland
Nyu York Shehiri	New York
ۋاشىنگتون	Washington, D.C.
San Fransisko	San Francisco
Bérlin	Berlin
Los Anjélés	Los Angeles
كومپيۇتېر	Datamaskin
بېرن	Bern
Jenwe	Genève
سيۇرىخ	Zürich
خەلقارالىق تور	Internett
باراك ئوباما	Barack Obama
ئۇرۇگۋاي	Uruguay
London	London
كايرو	Kairo
ئالما	Epleslekten
پارىژ	Paris
مېكسىكا	Mexico
Kaliforniye Shitati	California
Boston	Boston
مارس	Mars (planet)
كېنىيە	Kenya
ئېفىئوپىيە	Etiopia
گانا جۇمھۇرىيىتى	Ghana
شىر	Løve
فرانسىيە	Frankrike
ئېسپېرانتو	Esperanto
ئىت	Tamhund
بۈيۈك بېرىتانىيە	Storbritannia
مۈشۈك	Tamkatt
جۇڭخۇا خەلق جۇمھۇرىيىتى	Folkerepublikken Kina
فرانسۇز تىلى	Fransk
برازىلىيە	Brasil
روسىيە	Russland
قارا دېڭىز	Svartehavet
Toronto	Toronto
Alabama Shitati	Alabama
San Pawlo	São Paulo
Kwébék	Québec
ۋىكىپېدىيە ۋەخپى	Wikimedia Foundation
جىمى ۋالىس	Jimmy Wales
گېرمانىيە	Tyskland
بېلورۇسسىيە	Hviterussland
نېمىس تىلى	Tysk
ئىسلاندىيە	Island
ئېستونىيە	Estland
ساتۇرن	Saturn
ئايروپىلان	Fly
جورج ۋولكېر بۇش	George W. Bush
لاتۋىيە	Latvia
ئۇكرائىنا	Ukraina
چېخ جۇمھۇرىيەتى	Tsjekkia
سلوۋاكىيە	Slovakia
سلوۋېنىيە	Slovenia
مولدوۋا	Moldova
رۇمىنىيە	Romania
بۇلغارىيە	Bulgaria
Rim	Roma
ماكېدونىيە	Republikken Makedonia
ئالبانىيە	Albania
گرېنلاندىيە	Grønland
كرودىيە	Kroatia
بوسنىيە ۋە ھېرسېگوۋىنا	Bosnia-Hercegovina
ئەزەربەيجان	Aserbajdsjan
ئاندوررا	Andorra
سىپرۇس	Republikken Kypros
گرۇزىيە	Georgia
قازاقىستان	Kasakhstan
مالتا	Malta
موناكو	Monaco
چېرنوگورىيە	Montenegro
ۋاتىكان شەھىرى	Vatikanstaten
سان مارىنو	San Marino
Bryussél	Brussel
كۇبا	Cuba
بېلىز	Belize
باربادوس	Barbados
ئاممىباپ ئاپتوموبىل	Volkswagen
ھىندونېزىيە	Indonesia
Wolfgang Amadeus Mozart	Wolfgang Amadeus Mozart
بىتخوۋىن	Ludwig van Beethoven
تۈرك تىلى	Tyrkisk
جەنۇبىي ئافرىقا	Sør-Afrika
ئالجىرىيە	Algerie
ئۆزبېكىستان	Usbekistan
Poznan	Poznań
Tashkent	Tasjkent
Warshawa	Warszawa
ياۋروۋىزىيون ناخشا مۇسابىقىسى	Eurovision Song Contest
تېلېۋىزور	Fjernsyn
ئىسلاندىيە تىلى	Islandsk
چىلى	Chile
ئەيسا مەسىھ	Jesus Kristus
گالىلېي	Galileo Galilei
مېركۇرىي	Merkur
تارىخ	Historie
ئالما شىركىتى	Apple
ۋېنېرا	Venus
مۇھاببەت	Kjærlighet
يۇپىتېر	Jupiter
سامان يولى سىستىمېسى	Melkeveien
ئۇران (پلانىت)	Uranus
نىكولا ساركوزى	Nicolas Sarkozy
نېپتۇن	Neptun (planet)
ئاسترونومىيە	Astronomi
سىنگاپور	Singapore
پلۇتون	Pluto
Montréal	Montréal
لىختېنشتېين	Liechtenstein
Kambrij	Cambridge
Facebook	Facebook
بىرىنچى دۇنيا ئۇرۇشى	Første verdenskrig
Kolon	Köln
سكوپليې	Skopje
Shchétsin	Szczecin
لاتىن تىلى	Latin
بەھرېيىن	Bahrain
ئەرمېنىيە	Armenia
سېربىيە	Serbia
Istanbul	Istanbul
ئاۋستىرالىيە	Australia
فىزىكا	Fysikk
ئارگېنتىنا	Argentina
پېرۇ	Peru
بىئولوگىيە	Biologi
شىمالىي چاۋشيەن	Nord-Korea
كامبوجا	Kambodsja
قۇرئان كەرىم	Koranen
دىنوزاۋر	Dinosaurer
ئىسلام دىنى	Islam
ليۇبليانا	Ljubljana
Lion	Lyon
ياۋروپا ئىتتىپاقى	Den europeiske union
سوفىيە	Sofia
شېئىر	Poesi
Milan	Milano
Turin	Torino
سوڭ	Anus
ئېۋېرېست	Mount Everest
ﻧﺎﭘﻮﻟﯧﺌﻮﻥ ﺑﻮﻧﺎﭘﺎﺭﺕ	Napoléon Bonaparte
ۋېزۇۋىي	Vesuv
قۇياش	Solen
قۇياش سىستېمىسى	Solsystemet
ھىدروگېن	Hydrogen
گېلىي	Helium
لىتىي	Litium
بېرىللىي	Beryllium
شەرقىي تىمور	Øst-Timor
ئوسلو	Oslo
Bonn	Bonn
سېرېرا	Ceres (dvergplanet)
لىسبون	Lisboa
ئېرىدا	Eris (dvergplanet)
دۇبائى	Dubai
بور	Bor (grunnstoff)
Wérsayl	Versailles
كاربون	Karbon
ۋولگا دەرياسى	Volga
ئازوت	Nitrogen
ئوكسىگېن	Oksygen
مۇزىكا	Musikk
Wénitsiye	Venezia
Rénn Shehiri	Rennes
Lil	Lille
Moskwa	Moskva
فىتور	Fluor
ئىتاليان تىلى	Italiensk
نىئون گازى	Neon
Sankt-Pétérburg	St. Petersburg
چاد	Tsjad
ناترىي	Natrium
ماگنىي	Magnesium
ئاليۇمىن	Aluminium
يېڭى زېلاندىيە	New Zealand
ھىندىستان	India
سىلىتسىي	Silisium
فرانسىي	Francium
Tuwalu	Tuvalu
فوسفور	Fosfor
تۆمۈر	Jern
Ton’ga	Tonga
گۈڭگۈرت	Svovel
ساموئا	Samoa
سولومون تاقىم ئاراللىرى	Salomonøyene
ۋانۇئاتۇ	Vanuatu
خلور گازى	Klor
پاپۇئا يېڭى گۋىنېيە	Papua Ny-Guinea
پالاۋ	Palau
ئارگون	Argon
ناۋرۇ	Nauru
مىكرونېزىيە فېدېراتسىيىسى	Mikronesiaføderasjonen
كالىي	Kalium
كالتىسىي	Kalsium
قوغۇشۇن	Bly
مارشال تاقىم ئاراللىرى	Marshalløyene
كىرىباتى	Kiribati
موڭغۇلىيە	Mongolia
فىجى	Fiji
سكاندىي	Scandium
تىتان	Titan (grunnstoff)
ۋېنېسۇئېلا	Venezuela
چىڭگىزخان	Djengis Khan
ۋانادىي	Vanadium
Méané Shitati	Maine
خروم	Krom
ئات	Hest
ئامستېردام	Amsterdam
ھايۋانات	Dyr
سۇرىنام	Surinam
مانگان	Mangan
پاراگۋاي	Paraguay
گايانا	Guyana
ئېكۋادور	Ecuador
رېنىي	Rhenium
كولومبىيە	Colombia
كوبالت	Kobolt
ۋولفرام	Wolfram
نىكېل	Nikkel
بۇددا دىنى	Buddhisme
بولىۋىيە	Bolivia
مىس	Kobber
ترىنىداد ۋە توباگو	Trinidad og Tobago
سېنت ۋىنسېنت ۋە گرېنادىن ئاراللىرى	Saint Vincent og Grenadinene
سىنك	Sink
Yéngi Xampishir Shitati	New Hampshire
سېنت ليۇسىيە	Saint Lucia
داۋېىنچى	Leonardo da Vinci
سېنت كىتس ۋە نېۋىس	Saint Kitts og Nevis
زەمبۇرۇغ	Sopper
يامايكا	Jamaica
گرېنادا	Grenada
Massachuséts Shitati	Massachusetts
گۋاتېمالا	Guatemala
باھاما	Bahamas
Konnéktikat Shitati	Connecticut
ئانتىگۇئا ۋە باربۇدا	Antigua og Barbuda
Haway Shitati	Hawaii
ھوندۇراس	Honduras
دومىنىكا	Dominica
دومىنىكان جۇمھۇرىيەتى	Den dominikanske republikk
ھايتى	Haiti
ئەل سالۋادور	El Salvador
ئىران	Iran
ئىراق	Irak
Alyaska Shitati	Alaska
كوستارىكا	Costa Rica
ئىسرائىلىيە	Israel
پاناما	Panama
يەمەن	Jemen
پولەك تىلى	Polsk
ئىئوردانىيە	Jordan
نىكاراگۇئا	Nicaragua
Florida Shitati	Florida
قىرغىزىستان	Kirgisistan
Arizona Shitati	Arizona
كۇۋەيت	Kuwait
لائوس	Laos
لىۋان	Libanon
Orégon Shitati	Oregon
مالدىۋ ئاراللىرى	Maldivene
ئامېرىكا قىتئەسى	Amerika
Yuta Shitati	Utah
مالايسىيا	Malaysia
بىرما	Myanmar
نېپال	Nepal
ئومان	Oman
پاكىستان	Pakistan
قاتار	Qatar
سەئۇدى ئەرەبىستان	Saudi-Arabia
سرىلانكا	Sri Lanka
ستالىن	Josef Stalin
سۇرىيە	Syria
بىراتۇ	Platon
گاللىي	Gallium
تاجىكىستان	Tadsjikistan
تەيۋەن	Republikken Kina
گېرمانىي	Germanium
تايلاند	Thailand
ئارسېن	Arsen
تۈركمەنىستان	Turkmenistan
سېلېن	Selen
ئەرەب بىرلەشمە خەلىپىلىكى	De forente arabiske emirater
بروم	Brom
Platina	Platina
ۋيېتنام	Vietnam
Nowosibirski	Novosibirsk
جەنۇبىي چاۋشيەن	Sør-Korea
كرىپتون	Krypton
ئافغانىستان	Afghanistan
رۇبىدىي	Rubidium
ئالتۇن	Gull
قازان	Kazan
بانگلادېش	Bangladesh
مالى	Mali
ئانگولا	Angola
بۇتان	Bhutan
برۇنېي	Brunei
تانزانىيە	Tanzania
فىلىپپىن	Filippinene
ئوتتۇرا ئافرىقا جۇمھۇرىيىتى	Den sentralafrikanske republikk
جەنۇبى قۇتۇپ	Sydpolen
شىمالى قۇتۇپ	Nordpolen
ئىسساك نيوتۇن	Isaac Newton
ئالبېرىت ئېينىشتېين	Albert Einstein
سترونتسىي	Strontium
ئىتترىي	Yttrium
ۋىسمۇت	Vismut
سېرىق رەڭ	Gul
توگو	Togo
تۇنىس	Tunisia
زامبىيە	Zambia
زىمبابۋې	Zimbabwe
بېيجىڭ شەھىرى	Beijing
تۇۋا	Tuva (republikk)
بېنىن	Benin
بوتسۋانا	Botswana
بۇركىنا فاسو	Burkina Faso
بۇرۇندى	Burundi
كومور ئاراللىرى	Komorene
كونگو جۇمھۇرىيىتى	Republikken Kongo
كونگو دېموكراتىك جۇمھۇرىيىتى	Den demokratiske republikken Kongo
San Antonio	San Antonio
جىبۇتى	Djibouti
پولونىي	Polonium
ئېكۋاتور گۋىنېيىسى	Ekvatorial-Guinea
ئېرىترېيە	Eritrea
Yéngi Déhli	New Delhi
تبىلىسى	Tbilisi
ئاستاتىن	Astat
گابون	Gabon
گامبىيە	Gambia
ۋىنېيە	Guinea
گۋىنېيە بىسسائۇ	Guinea-Bissau
پىل چىشى قىرغىغى	Elfenbenskysten
كامېرۇن	Kamerun
يېشىل تۇمشۇق ئاراللىرى	Kapp Verde
لېسوتو	Lesotho
لىبېرىيە	Liberia
لىۋىيە	Libya
ماداگاسكار	Madagaskar
مالاۋى	Malawi
Shtutgart	Stuttgart
ماۋرىتانىيە	Mauritania
ماۋرىتىئۇس	Mauritius
ماراكەش	Marokko
موزامبىك	Mosambik
نامىبىيە	Namibia
نىگېر	Niger
نىگېرىيە	Nigeria
دارۋىن	Charles Darwin
ئۇگاندا	Uganda
رۋاندا	Rwanda
سىركونىي	Zirkonium
San Tomé we Prinsipé	São Tomé og Príncipe
سېنېگال	Senegal
سېيشېل ئاراللىرى	Seychellene
سيېررا لېئونې	Sierra Leone
سومالى	Somalia
نىئوبىي	Niob
جولیس سیزر	Julius Cæsar
سۇدان	Sudan
سۋازىلېند	Swaziland
مولبېدىن	Molybden
تېخېتىسىي	Technetium
Hamburg	Hamburg
گۇجارات	Gujarat
بىرلەشكەن دۆلەتلەر تەشكىلاتى	De forente nasjoner
گېئولوگىيە	Geologi
Exmetabad	Ahmedabad
يۈرەك	Hjerte
تېرە	Hud
پراگا	Praha
كۆك رەڭ	Blå
كۈمۈش	Sølv
قەلەي	Tinn (grunnstoff)
ئۇران	Uran
سۈرمە	Antimon
پلوتونىي	Plutonium
نېپتونىي	Neptunium
كسېنون	Xenon
سېزىي	Cesium
پروتاكتىنىي	Protactinium
بارىي	Barium
تورىي	Thorium
گافنىي	Hafnium
ئاكتىنىي	Actinium
تانتال	Tantal
بىل كلىنتون	Bill Clinton
رادىي	Radium
رادون	Radon
Bombay	Mumbai
Michigan Shitati	Michigan
پوئېرتو رىكو	Puerto Rico
Illinoyiz Shitati	Illinois
Shimaliy Dakota Shitati	Nord-Dakota
لومبارد	Lombardia
Jenubiy Dakota Shitati	Sør-Dakota
Montana Shitati	Montana
Wyoming Shitati	Wyoming
قۇدس	Jerusalem
Aydaxo Shitati	Idaho
Washin'giton Shitati	Washington
رۇزېرفوردىي	Rutherfordium
Néwada shitati	Nevada
دۇبنىي	Dubnium
سىبورگىي	Seaborgium
بوھرىي	Bohrium
ھاسسىي	Hassium
مېيتنېرىي	Meitnerium
Kolorado Shitati	Colorado
دارمستادتىي	Darmstadtium
رۆنتگېنىي	Røntgenium
كوپېرنىي	Copernicium
تۈر:تۈرلەر يولباشچىسى	Kategori:Kategorier
ئاپېنىن تاغ تىزمىسى	Appenninene
ئالپ تاغلىرى	Alpene
پاسكال	Blaise Pascal
Gant	Gent
Chikago	Chicago
ئۇنۇنترىي	Ununtrium
فلېروۋىي	Flerovium
ئۇنۇنپېنتىي	Ununpentium
لىۋىرمورىي	Livermorium
ئۇنۇنسېپتىي	Ununseptium
ئۇنۇنئوكتىي	Ununoctium
Arném	Arnhem
ئىسپان تىلى	Spansk
مونتېۋىدېئو	Montevideo
Filadélfiye	Philadelphia
Kalkutta	Kolkata
Déhli	Delhi
داكا	Dhaka
Ban'galor	Bangalore
Ömüchük	Edderkopper
ئىسلامئاباد	Islamabad
ظاصتاص يئضةن مئؤة	Frukt
مايمۇن	Apekatter
Wirginiye Shitati	Virginia
غەربىي ۋىرگىنىيە شىتاتى	Vest-Virginia
Nyuyork Shitati	New York (delstat)
سېرىي	Cerium
پرازېئودىمىي	Praseodym
Rodé Arili Shitati	Rhode Island
نېئودىي	Neodym
Maryland Shitati	Maryland
Délawiyer Shitati	Delaware
يېۋروپىي	Europium
Oxayo Shtati	Ohio
Pénsilwaniye Shitati	Pennsylvania
Yéngi Jérséy Shtati	New Jersey
فىنلاندىيە تىلى	Finsk
Indiyanna Shitati	Indiana
ئاپتوموبىل	Bil
Giorgiye Shitati	Georgia (USA)
Zagréb	Zagreb
Téksas Shitati	Texas
Jenubiy Karolina Shitati	Sør-Carolina
سىتسىلىيە	Sicilia
مانىلا	Manila
ساردىنىيە ئارىلى	Sardinia
Bordo	Bordeaux
Buénos Ayrés	Buenos Aires
مېكسىكا شەھىرى	Mexico by
توكيو	Tokyo
Barsélona	Barcelona
Missisipi Shitati	Mississippi
Ténnéssi Shitati	Tennessee
Astana	Astana
Yéngi Méksika Shitati	New Mexico
ئافېنا	Athen
Minnésota Shitati	Minnesota
باغداد	Bagdad
Karakas	Caracas
Wiskonsin Shitati	Wisconsin
Puna	Pune
AC مىلان	AC Milan
Lowa Shitati	Iowa
Nébraska Shitati	Nebraska
گۋاتېمالا شەھىرى	Guatemala by
Kanzas Shitati	Kansas
ھىندى تىلى	Hindi
ماراتىچە	Marathi
Missori Shitati	Missouri
Loyizanna Shitati	Louisiana
Kéntukki Shitati	Kentucky
Arkanzas Shtati	Arkansas
ئوردو تىلى	Urdu
Oklaxoma Shitati	Oklahoma
Potsdam	Potsdam
Hanofér	Hannover
Myunxén	München
Drézdén	Dresden
ۋالىبول	Volleyball
Wyéna	Wien
Kopénhagén	København
Stokgolm	Stockholm
Xélsinki	Helsingfors
دۇبلىن	Dublin
رېيكياۋىك	Reykjavík
Tallin	Tallinn
رىگا	Riga
براتىسلاۋا	Bratislava
Budapésht	Budapest
Danzig	Gdańsk
Frankfort	Frankfurt am Main
Wroklaw	Wrocław
لانتان	Lantan
جۈي	Promethium
چالغا	Samarium
گادولنىي	Gadolinium
تېربىي	Terbium
Katolik dini	Katolisisme
ليۇكسېمبۇرگ شەھىرى	Luxembourg (by)
دىسپروزىي	Dysprosium
ۋادۇز	Vaduz
ئىنجىل	Bibelen
گولمىي	Holmium
ئېربىي	Erbium
فنوم پېن	Phnom Penh
تۇلىي	Thulium
سايگون	Ho Chi Minh-byen
ئىتتېربىي	Ytterbium
لۇتېتسىي	Lutetium
خانوي	Hanoi
ئىنگىلىز تىلى	Engelsk
Bangkok	Bangkok
ئاندوررا كەنتى	Andorra la Vella
كۇئالالۇمپۇر	Kuala Lumpur
تەيبېي شەھىرى	Taipei
ئامېرىتسىي	Americium
كىيۇرىي	Curium
Concepción, Chile	Concepción
بېركېلىي	Berkelium
كالىفورنىي	Californium
ئېينشتېينىي	Einsteinium
فېرمىي	Fermium
مېندېلېيېۋىي	Mendelevium
كىيېۋ	Kiev
نوبېلىي	Nobelium
لاۋرېنسىي	Lawrencium
كارېلىيە	Karelia
Ottawa	Ottawa
Manitoba Ölkisi	Manitoba
Albérta	Alberta
Nowa Skotiye Ölkisi	Nova Scotia
يېرېۋان	Jerevan
دارېسسالام	Dar-es-Salaam
خارتۇم	Khartoum
Yéngi Brunswik Ölkisi	New Brunswick
Britani Kolumbiye	Britisk Columbia
Saskachéwan	Saskatchewan
Néwfundland Ölkisi	Newfoundland og Labrador
Gherbiy Shimal Rayoni	Nordvestterritoriene
Yukon Rayoni	Yukon
Florénsa	Firenze
Ésén	Essen
كومى	Komi
Léypzig	Leipzig
Nyurnbérg	Nürnberg
Édmonton	Edmonton
Man'géym	Mannheim
Wiktoriye, Britani Kolumbiye	Victoria (Britisk Columbia)
Winnipég	Winnipeg
Halifaks	Halifax (Nova Scotia)
Kwébék Shehiri	Québec (by)
ئېلېكترون	Elektron
Birmin'gxam	Birmingham
مىنىسكى	Minsk
مىكروسوفىت شىركىتى	Microsoft
پروتون	Proton
Kurow	Kurów
Naplés	Napoli
Braunshwéyg	Braunschweig
Madrid	Madrid
سۇ ئاستى كېمىسى	Undervannsbåt
مايكېل جېكسۇن	Michael Jackson
Bogota	Bogotá
لىما	Lima
Santiyago	Santiago de Chile
كىتو	Quito
سۇكرې	Sucre (Bolivia)
ئاسۇنسىئون	Asunción
Öçke	Geit
Héydélbérg	Heidelberg
كاتماندۇ	Katmandu
سان خوسې (كوستارىكا)	San José
سان سالۋادور	San Salvador
Kanbérra	Canberra
Sidnéy	Sydney
يېشىل رەڭ	Grønn
Mélburn	Melbourne
قىزىل رەڭ	Rød
ماناگۇئا	Managua
رابات	Rabat
قۇيرۇقلۇق يۇلتۇز	Komet
ئالجىر	Alger
تۇنىس شەھىرى	Tunis
ترىپولى	Tripoli
تېھران	Teheran
جاكارتا	Jakarta
Enqere	Ankara
رىياد	Riyadh
بېلگراد	Beograd
ئادىگېيە	Adygia
پرايا	Praia
دەمەشىق	Damaskus
يامۇسسۇكرو	Yamoussoukro
فرانسىيىگە قاراشلىق گۋىئانا	Fransk Guyana
لومې	Lomé
ئاممان	Amman
بېيرۇت	Beirut
مۇسكات	Muskat (Oman)
نىكوسىيە	Nikosia
دوھا	Doha
نايروبى	Nairobi
لۇساكا	Lusaka
ئامازون	Amazon.com
قۇياش تۇتۇلۇشى	Solformørkelse
كامپالا	Kampala
Mektep	Skole
ھارارې	Harare
Prétoriye	Pretoria
Astiraxan	Astrakhan
Tiktak top	Bordtennis
Wikipedia:Sandbox	Wikipedia:Sandkasse
قالماقىستان	Kalmykia
Osasko	Osasco
Glasgow	Glasgow
Kuritiba	Curitiba
Orman	Skog
كۇڭزى	Konfucius
كوربين بيلو	Corbin Bleu
Surat	Surat
ياۋرۇ	Euro
ئامېرىكا دولىرى	Amerikansk dollar
يەر ئوتتۇرا دېڭىزى	Middelhavet
خاڭجۇ شەھىر	Hangzhou
مەسىھچىلىك	Kristendom
Séatl	Seattle
Baltimor	Baltimore
ئادېلايدې	Adelaide
داغىستان	Dagestan
Monzón	Monzón
گۇجارات تىل	Gujarati
پورتۇگال تىلى	Portugisisk
مۇستاپا كامال	Mustafa Kemal Atatürk
چېچېنىيە	Tsjetsjenia
كۋېچۇئا تىلى	Quechua
ئىنگۇشېتىيە	Ingusjetia
شىمالىي ئوسېتىيە	Nord-Ossetia
كاباردىنو-بالقارىستان	Kabardino-Balkaria
ئالماس	Diamant
ياپون تىلى	Japansk
Énsklopédiye	Encyklopedi
ئۇيغۇرچە ۋىكىپىدىيە	Portal:Forside
Latex	LaTeX
كوندېنساتور	Kondensator (elektrisk)
قاراچاي-چېركېسىيە	Karatsjajevo-Tsjerkessia
موردوۋىيە	Mordovia
ۋاسكېتبول	Basketball
چاڭجياڭ دەرياسى	Chang Jiang
ئۇدمۇرتىيە	Udmurtia
مارى	Mari El
ھىمالايا تاغ تىزمىسى	Himalaya
ئاند تاغلىرى	Andes
قىيىلىق تاغلار	Rocky Mountains
Kapétown	Cape Town
چۇۋاشىيە	Tsjuvasjia
تەڭرىتاغ	Tian Shan
كاۋكاز تاغ تىزمىسى	Kaukasus
تاتارىستان	Tatarstan
1279-يىلى	1279
ۋېىنىست	Vincent van Gogh
باشقۇرتىستان	Basjkortostan
Semerqend	Samarkand
Buxara	Bukhara
بېتلېخېم	Betlehem
Andalusiye	Andalucía
كايمان تاقىم ئاراللىرى	Caymanøyene
Kordowa	Córdoba (Spania)
شىئەن شەھىرى	Xi'an
كابۇل	Kabul
لاسا شەھىرى	Lhasa
غىلاپ	Vagina
تامىل تىلى	Tamilsk
پەلسەپە	Filosofi
ئالەم ئايرۇپىلانى	Romfart
ئالتاي تاغ تىزمىسى	Altaj (fjellkjede)
تۈر:Candidates for speedy deletion	Kategori:Sider som er foreslått raskt slettet
ئالتاي	Altaj
پىئانىنو	Piano
Hebe Camargo	Hebe Camargo
Portland, Orégon	Portland
ئانارخىزم	Anarkisme
لىبېرالىزىم	Liberalisme
فاشىسىت	Fascisme
مىللەتچىلىك	Nasjonalisme
غەربىي ساھارا	Vest-Sahara
ھىلاري كلىنتون	Hillary Clinton
خاكاسىيە	Khakasia
Strasburg	Strasbourg
ياكۇتىيە	Sakha
كرودىيە تىلى	Kroatisk
گائۇس	Carl Friedrich Gauss
بۇرياتىيە	Burjatia
جامىس جويىس	James Joyce
كاتالان تىلى	Katalansk
دىنسىزلىق	Ateisme
لى بەي	Li Bai
دۇنيا بانكىسى	Verdensbanken
كونسېرۋاتىپ	Konservatisme
شىمالىي ئاتلانتىك ئەھدى تەشكىلاتى	NATO
نوبېل مۇكاپاتى	Nobelprisen
چىن شىخۇاڭ	Qin Shi Huangdi
خەن سۇلالىسى	Han-dynastiet
فېمىنىزم	Feminisme
ئىدېئولوگىيە	Ideologi
پەي توپ	Badminton
يۈەن سۇلالىسى	Yuan-dynastiet
كولۇمبو	Christofer Columbus
يەھۇدىلار	Jøder
سېرىق دەريا	Den gule flod
قۇلاق	Øre
بۇرۇن	Nese
كۆز	Øye
مۇسكۇل	Muskel
Töge	Kameler
پىل	Elefanter
چۈمۈلە	Maur
سۈي سۇلالىسى	Sui-dynastiet
گوللاندىيە تىلى	Nederlandsk
ماگرىت ساچىر	Margaret Thatcher
ياڭ جىيەن	Keiser Wen av Sui
دېئوكسىرىبونۇكلېئىك كىسلاتا	DNA
سۇڭ سۇلالىسى	Song-dynastiet
Çeyze	Aubergine
رۇس تىلى	Russisk
ساخالىن	Sakhalin
نېفىت ئېكىسپورت قىلغۇچى دۆلەتلەر تەشكىلاتى (OPEC)	OPEC
خەلقئارا پۇل فوندى تەشكىلاتى	Det internasjonale pengefondet
دۇنيا سودا تەشكىلاتى	Verdens handelsorganisasjon
سۋاھىلىچە	Swahili
توكيو ئۇنىۋېرستېتى	Universitetet i Tokyo
خەنزۇ تىلى	Kinesisk
ئۆپكە	Lunge
نەپەسلىنىش سىستېمى	Åndedrettssystemet
رۇمىنىيە تىلى	Rumensk
بۇلغارىيە تىلى	Bulgarsk
يەر تەۋرەش	Jordskjelv
ماگادان	Magadan
تەبىئىي پەن	Naturvitenskap
فرانكلىن روزۋېلت	Franklin D. Roosevelt
ﺋﯩﺒﯩﻦ ﺳﯩﻨﺎ	Avicenna
نىلسۇن ماندىلا	Nelson Mandela
مارتىن لوتىر كىڭ	Martin Luther King jr.
Yanardag	Vulkan
ئىسسىق بەلباغ سىكلونى	Tropisk syklon
تېلۇگۇ تىلى	Telugu
گرۇزىن تىلى	Georgisk
ئىقتىسادشۇناسلىق	Samfunnsøkonomi
يېن	Japansk yen
قىزىل تۈلكە	Rødrev
ئىسكىرىپكا	Fiolin
چوڭ ئىسكىروپكا	Cello
ئىسكەندەر زۇلقەرنەيىن	Aleksander den store
ئۆمەر ئىبنى خەتتاب	Umar ibn al-Khattab
ئامۇ دەرياسى	Amu-Darja
سۈت	Melk
سۇن جۇڭشەن	Sun Yat-sen
شياڭگاڭ	Hongkong
Miami	Miami
كاراچى	Karachi
Rio dé Janéyro	Rio de Janeiro
سوغۇق ئۇرۇش	Den kalde krigen
شاڭخەي شەھىرى	Shanghai
Bilbaw	Bilbao
Séwéliye	Sevilla
چىڭ سۇلالىسى	Qing-dynastiet
توماس ئىدىسون	Thomas Edison
ئالبان تىلى	Albansk
باسكى تىلى	Baskisk
ئاراگون تىلى	Aragonesisk
ئەرمەن تىلى	Armensk
ئۇكرائىن تىلى	Ukrainsk
Walénsiye	Valencia
Malaga	Málaga
شۋېتسىيە تىلى	Svensk
دانىش تىلى	Dansk
نورۋېگىيە تىلى	Norsk
ليۇكسېمبۇرگ تىلى	Luxembourgsk
چېخ تىلى	Tsjekkisk
سلوۋاك تىلى	Slovakisk
كارل ماركىس	Karl Marx
سلوۋېن تىلى	Slovensk
ماجار تىلى	Ungarsk
ۋولتىر	Voltaire
ئېستون تىلى	Estisk
لاتۋىيە تىلى	Latvisk
لىتۋا تىلى	Litauisk
ھىندى دىنى	Hinduisme
بېلورۇس تىل	Hviterussisk
يېلىن	Bryst
ئاتوم	Atom
گرېك تىلى	Gresk
ئرېلاندىيە تىلى	Irsk
مالتا تىلى	Maltesisk
پارس تىلى	Persisk
ئىسلام	Religion
كورىيەچە	Koreansk
Injilning birinchi tomi	Første Mosebok
كانتونچە	Standard kantonesisk
ئېكسودۇس	Andre Mosebok
ۋيېتنام تىلى	Vietnamesisk
كخمېر تىلى	Khmer (språk)
لائوس تىلى	Laotisk
تايلاندچە	Thai
بىرما تىلى	Burmesisk
مالاي تىلى	Malayisk
ھىندونېزىيە تىلى	Indonesisk
موڭغۇل تىلى	Mongolsk
Baku	Baku
قازاق تىلى	Kasakhisk
قىرغىز تىلى	Kirgisisk
تاجىك تىلى	Tadsjikisk
ئۆزبېك تىلى	Usbekisk
تۈركمەن تىلى	Turkmensk
يەھۇدى دىنى	Jødedom
تىمپۇ	Thimpu
باندار سەرى بەگاۋان	Bandar Seri Begawan
ئىبرانى تىلى	Hebraisk
ئەزەربەيجان تىلى	Aserbajdsjansk
ماكېدون تىلى	Makedonsk
سېرب تىلى	Serbisk
سېربو-كرودىيىلىكلەر تىلى	Serbokroatisk
بوسنىيە تىلى	Bosnisk
گالىسىيەچە	Galisisk
ۋېلش تىلى	Walisisk
دىلى	Dili
شوتلاندىيە گائېل تىلى	Skotsk-gælisk
Wyéntyan	Vientiane
مالې	Malé
Bishkek	Bisjkek
Düshenbe	Dusjanbe
جىگەر	Lever
تلا	Milt
بۆرەك	Nyre
دوۋساق	Urinblære
نېرۋا سىستىمېسى	Nervesystem
ئوكيانىيە	Verdenshav
مۇھەممەد ئەلەيھىسسالام	Muhammed
ئىمام ئەلغازالىي	Abu Hamid Ghazali
رىچارد نىكسون	Richard Nixon
قورساق قىسم	Abdomen
داۋجياۋ دىنى	Taoisme
سوپىزم (تەسەۋۋۇپ)	Sufisme
ۋېنا تومۇرى	Vene
بېنگال تىلى	Bengali
تىل	Tunge
پانكرېئاتىت	Bukspyttkjertel
بويۇن	Hals
ئېغىز بوشلۇقى	Munn
بوغۇز	Strupehode
فالكلاند تاقىم ئاراللىرى	Falklandsøyene
ئېلىزابېت II	Elisabeth II av Storbritannia
تاڭ سۇلالىسى	Tang-dynastiet
كېننېدى	John F. Kennedy
تاڭ تەيزوڭ	Keiser Taizong av Tang
بالزاك	Honoré de Balzac
مىڭ سۇلالىسى	Ming-dynastiet
جۇ يۈەنجاڭ	Hongwu-keiseren
رېگان	Ronald Reagan
زۇلۇچە	Zulu (språk)
زازا تىلى	Zazaisk
پلازما	Plasma
رىم گىلادىئاتورلار مەيدانى	Colosseum
Saragossa	Zaragoza
Bélfast	Belfast
ئېلېمېنتلارنىڭ دەۋرىي جەەدۋىلى	Periodesystemet
قۇرۇق ئۈزۈم	Druer
ھەسەل	Honning
شېكەر	Sukker
روبوت	Robot
ماشىنىسازلىق	Maskin
ئايلىنىش سىستېمىسى	Sirkulasjonssystem
ئىچكى ئاجراتما سىستېمىسى	Det endokrine system
كىسلاتا	Syre
سارايېۋو	Sarajevo
فۇنكسىيە	Funksjon (matematikk)
مولېكۇلا	Molekyl
ئېنېرگىيە	Energi
ئىنفرا قىزىل نۇر	Infrarød stråling
ماسسا	Masse
مېتال	Metall
پولات	Stål
نانو تېخنىكىسى	Nanoteknologi
ئەينەك	Glass (materiale)
ۋاكۇئۇم	Vakuum
ئېلېكترون ئىلمى	Elektronikk
.توك (توك ئېقىمى)	Elektrisk strøm
ئىككى پۇتلۇق لامپا	Diode
ئامېرىكىغا قاراشلىق ۋىرگىن تاقىم ئاراللىرى	De amerikanske jomfruøyene
شېنياڭ شەھىرى	Shenyang
چۇڭچىڭ شەھىرى	Chongqing
تيەنجىن شەھىرى	Tianjin
Lahor	Lahore
ۋۇخەن شەھىرى	Wuhan
نۆۋەتتىكى ھادىسە	Liste over stater
ناگويا	Nagoya
تاش قورال دەۋرى	Steinalderen
ئېيىق	Bjørnefamilien
فوتوسىنتېز رولى	Fotosyntese
برېتون تىلى	Bretonsk
پىرېنېي تاغلىرى	Pyreneene
Détroyt	Detroit
بۇرج دۇبەي	Burj Khalifa
Sedichin Sépili	Den kinesiske mur
ئاياسوڧيا	Hagia Sofia
ئابباسىيلار خاندانلىقى	Abbasidene
سەلىپنىڭ شەرققە يۈرۈش قىلىشى	Korstog
موڭغۇل ئىمپېرىيىسى	Mongolriket
ئوسمان ئىمپېرىيىسى	Det osmanske rike
ئىسپانىيە-ئامېرىكا ئۇرۇشى	Den spansk-amerikanske krigen
مىللى دارامەت	Bruttonasjonalprodukt
ئېلېكتر	Elektrisitet
يادرو ئېنېرگىيىسى	Kjernekraft
ھور ماشىنىسى	Dampmaskin
Antwérp	Antwerpen
باش سۆڭىكى	Skalle
ئانار	Granateple
ئاپېلسىن	Appelsin
دۇنيا تىلى	Retoromansk
جۇاڭزۇ تىلى	Zhuang (språk)
ئۇيغۇر تىلى	Uigurisk
سىنگال تىلى	Singalesisk
ناخۇئاتل تىلى	Nahuatl
مونتسەررات	Montserrat
خارۋارد ئۇنىۋېرسىتېتى	Harvard University
Pisa	Pisa
باشقۇرتچە	Basjkirsk
قېلىپ:Location map Earth	Mal:Kartposisjon Verden
باغلانغان ئۆردەك	Le Canard enchaîné
ئەرەب تىلى	Arabisk
كيۇسيۇ ئارىلى	Kyushu
خونسيو ئارىلى	Honshu
شىكوكۇ	Shikoku
كورسىكا ئارىلى	Korsika
ئاڧرىقانچە	Afrikaans
بۆرە بورسۇق	Jerv
ئاۋمېن	Macao
خۇ جىنتاۋ	Hu Jintao
شى جىنپىڭ	Xi Jinping
زىراپە	Sjiraff
شېنجېن شەھىرى	Shenzhen
گۇئاڭدوڭ ئۆلكىسى	Guangdong
گۇاڭشى جۇاڭزۇ ئاپتونۇم رايونى	Guangxi
سوۋېت ئىتتىپاقى	Sovjetunionen
شياڭگاڭ ئۇنىۋېرستېتى	University of Hong Kong
رۇبلى	Rubel
پۇت	Fot (kroppsdel)
دولا	Skulder
قالقانبەز	Skjoldkjertel
Wikipedia:Tor Jamiyeti	Wikipedia:Tinget
Wérmont Shitati	Vermont
San Diyégo	San Diego
San Xosé	San Jose
Dénwér	Denver
Hyuston	Houston
Féniks	Phoenix
Dallas	Dallas
Austin	Austin
Mémfis, Ténnéssi	Memphis
Sharlot	Charlotte (Nord-Carolina)
Kolumbu, Oxéo	Columbus (Ohio)
گۇاڭجۇ شەھىرى	Guangzhou
جىياڭ جىشى	Chiang Kai-shek
ۋېن جىياباۋ	Wen Jiabao
Guam Aril	Guam
ئامېرىكىغا قاراشلىق ساموئا	Amerikansk Samoa
شىمالىي مارىئانا فېدېراتسىيىسى	Nord-Marianene
نەنجىڭ شەھىرى	Nanjing
بېيجىڭ ئۇنىۋېرسىتېتى	Pekinguniversitetet
ئۈرۈمچى شەھىرى	Ürümqi
جياڭسۇ ئۆلكىسى	Jiangsu
جېجياڭ ئۆلكىسى	Zhejiang
گۇئادەلوپە	Guadeloupe
مارتىنىكا	Martinique
شىزاڭ ئاپتونوم رايونى	Den autonome region Tibet
دالاي لاما	Tenzin Gyatso
تۆگىقۇش	Struts
Sakraménto	Sacramento
چاۋشيەن	Korea
لى كېچياڭ	Li Keqiang
Manchéstér	Manchester
تۇركس ۋە كايكوس تاقىم ئاراللىرى	Turks- og Caicosøyene
ۋىتامىن A	Vitamin A
ياۋروپا چىمپيونلۇق لوڭقىسى	UEFA Champions League
پالمىزارلىق ئىپار مۈشۈكى	Asiatisk palmesivett
Pyongyang	Pyongyang
New Testament	Det nye testamente
ئادالەت ۋە تەرەققىيات پارتىيىسى	Rettferdighets- og utviklingspartiet
گۈللىنىش پارتىيىسى	Det republikanske folkepartiet
مىللى دارامەت بويىچە دۆلەت تەرتىپى	Liste over land etter BNP
خېيلوڭجياڭ ئۆلكىسى	Heilongjiang
ما يىنجىئۇ	Ma Ying-jeou
بۇخارېست	București
پوئىرتورىكان مۇستەقىللىق پارتىيىسى	Partido Independentista Puertorriqueño
Tirana	Tirana
ئېشەك	Afrikansk villesel
سىچۈەن ئۆلكىسى	Sichuan
مۇھەممەر قەززافى	Muammar al-Gaddafi
بارس	Tiger
چۆپ ئاش	Vermicelli
سامسۇڭ گۇرۇھى	Samsung
شىمالىي ياۋروپا	Skandinavia
كىشىنېۋ	Chișinău
بیلگیسايار مۈھەندیسلیغی	Informatikk
Şalom	Şalom
ئارۇبا	Aruba
خېبېي ئۆلكىسى	Hebei
پرىنسېتون ئۇنىۋېرستېتى	Princeton University
نېفىت	Petroleum
پېنسىلۋانىيە نېمىس تىلى	Pennsylvaniatysk
پرژىۋالسكى ياۋا ئات	Przewalskihest
قوي	Sauer
ئىرلاندىيە	Irland (øy)
Chéshir	Cheshire
Nortumbér Wilayiti	Northumberland
Staffordshir	Staffordshire
ﻟﯘﺷﯜﻥ	Lu Xun
Shimaliy Amptonshir	Northamptonshire
Bédfordshir	Bedfordshire
Kornwél	Cornwall
Bristol	Bristol
Déwonshir	Devon
Nashwil	Nashville
Xampishir	Hampshire
Bérkshir	Berkshire
Bukkinxamshir	Buckinghamshire
Ésséks	Essex
Ként	Kent
Ulanbatur	Ulan Bator
ئېرنېست ھېمىڭۋاي	Ernest Hemingway
Idinburg	Edinburgh
ئاشخاباد	Asjkhabad
پىياز	Vanlig løk
پەمىدۇر	Tomat
جورج بۇش	George H.W. Bush
بالقانلار	Balkan
پروتېستانت دىنى	Protestantisme
سەلەنا	Selena
Atlanta	Atlanta
بېرمۇدا	Bermuda
باش	Hode
ۋېللىنگتون	Wellington
ئالفېرد نوبىل	Alfred Nobel
لیلا چڑھاو	Lila Downs
907-يىلى	907
Wankuwér	Vancouver
Liwérpol	Liverpool
Brémén	Bremen (by)
يېڭى نورۋېگىيە تىلى	Nynorsk
پوند ستېرلىڭ	Britisk pund
ئانگۋىللا	Anguilla
فائېروس تىل	Færøysk
مۈشۈك ئائىلىسى	Kattefamilien
ISO 3166-1	ISO 3166-1
تاتار تىلى	Tatarisk
ئەنگلىيىگە قاراشلىق ۋىرگىن تاقىم ئاراللىرى	De britiske jomfruøyene
كىچىك سېسىق كۈزەنى	Snømus
فرىزانچە	Frisisk
ئاق ئاغمىخان	Røyskatt
قارشىلىق	Motstand (resistans)
ناۋاسسا ئاراللىرى	Navassaøya
سېنت بارتھېلەمي ئاراللىرى	Saint-Barthélemy
شىمالىي گېرمانىيە دىئالېكتى	Nedertysk
ئاغمىخان ئائىلىسى	Mårfamilien
ساينت مارتىن	Saint Martin
بۆكەن	Antiloper
قارا بۇلغۇن	Sobel
سۈنئىي ھەمراھ	Kunstig satellitt
قوتاز	Jak
ب م ۋ	BMW
Kuk Taqim Aralliri	Cookøyene
شەرقىي ئاسىيا	Øst-Asia
ئوتتۇرا ئاسىيا	Sentral-Asia
ياۋا ئات	Villhest
ئامخارا تىلى	Amharisk
Képinek	Sommerfugler
چاچ	Hår
ھىجرىيە كالېندارى	Islamsk kalender
جيامۇسى شەھىرى	Jiamusi
ئاستۇرىيە تىلى	Asturiansk
خىتاي	Kina
قاما	Oter
چېڭدۇ شەھىر	Chengdu
يىلپىز	Snøleopard
جېڭجۇ شەھىرى	Zhengzhou
تېرېسا ئانا	Moder Teresa
DELL شىركىتى	Dell
فرانسىيىگە قاراشلىق پولىنېزىيە	Fransk Polynesia
618-يىلى	618
روژدېستۋو ئاراللىرى	Christmasøya
Krakow	Kraków
بېيجىڭ پايتەخت ئايروپورتى	Beijing internasjonale lufthavn
ۋېنىسىيە تىلى	Venetiansk
تەيۋەن ئۇنۋېرسىتې	Taiwans nasjonale universitet
جامى	Moské
كورسىكا تىلى	Korsikansk
فىلىپىنچە	Filippinsk
چۇۋاش تىلى	Tsjuvasjisk
قرىم تاتار تىلى	Krimtatarisk
ھايتى كرېئول تىلى	Haitisk kreol
ياۋا تىلى	Javanesisk
مۈشۈكئېيىق	Panda
قالماق تىلى	Kalmykisk
مانجۇ تىلى	Mandsjuisk
كانناداچە	Kannada
مۇڭغۇل تىللىرى	Mongolske språk
پوچېركا	Hånd
دۇفۇ	Du Fu
يېڭى كالېدونىيە	Ny-Caledonia
ئورىياچە	Oriya
نېپال تىلى	Nepali
نېئاپول تىلى	Napolitansk-kalabresisk språk
نورمان تىلى	Normannisk
تېئودور روزېۋېلت	Theodore Roosevelt
تېلاۋىف	Tel Aviv
Nis	Nice
سالار تىلى	Salar
سىتسىلىيە تىلى	Siciliansk
ساردىنىيە تىلى	Sardisk
ژىيۇل ۋېرن	Jules Verne
سىندى تىلى	Sindhi (språk)
سۇندا تىلى	Sundanesisk
شونا تىلى	Shona (språk)
Niué Arili	Niue
تاگالوگ تىلى	Tagalog
تۈركى تىللار ئائىلىسى	Tyrkiske språk
تونگاچە	Tongansk
ئۇرال تىللىرى	Uralske språk
تىگرىنىيەچە	Tigrinja (språk)
Oksford	Oxford
تۇنگۇس مانجۇ تىللىرى	Tungusiske språk
زاڭزۇ تىلى	Tibetansk
سارى ئۇغۇر	Yugurer
ۋۇ تىلى	Wu (språk)
ۋىلسون	Woodrow Wilson
ياقۇت تىلى	Jakutisk
يورۇباچە	Joruba (språk)
سېسوتوچە	Sesotho
Rottérdam	Rotterdam
Yéngi Orléan	New Orleans
فۇشەن شەھىر	Foshan
ئوكسفورد ئۇنىۋېرسىتېتى	University of Oxford
ئەھمىدى نىجات	Mahmoud Ahmadinejad
Saynt Xéléna Arili	St. Helena
ساينت پىئېر ئارىلى ۋە مىكېلون تاقىم ئاراللىرى	Saint-Pierre og Miquelon
ئون پەرھىز	De ti bud
Yohannésburg	Johannesburg
قاپلان	Leopard
Saltzburg	Salzburg
X نۇرى	Røntgenstråling
شىنجاڭ ئۇيغۇر ئاپتونوم رايونى	Xinjiang
Albukwér kwé	Albuquerque
Oklaxoma Shehiri	Oklahoma City
برىسبان	Brisbane
ئىسساك ئاسىموۋ	Isaac Asimov
جەنۇبىي گىئورگىيە ۋە ساندۋىچ ئاراللىرى	Sør-Georgia og Sør-Sandwichøyene
كۇۋائىت شەھىرى	Kuwait (by)
ئەرەبلەر	Arabere
سۇمېرلار	Sumer
كولومبو	Colombo
ئالمۇتا	Almaty
قانداغاي	Elg
ۋاللىس ۋە فۇتۇنا تاقىم ئاراللىرى	Wallis- og Futunaøyene
تاتار مىللىتى	Tatarer
خوككايدو ئارىلى	Hokkaido
ئۇرال تاغلىرى	Uralfjellene
ماددا	Materie
ئوساكا	Osaka
كامبرىج ئۇنىۋېرستېتى	University of Cambridge
ئاكا-ئۇكا رايتلار	Brødrene Wright
گۇئارانچە	Guaraní (språk)
شور دېڭىز	Aralsjøen
ئىستانبۇل بوغازى	Bosporos
Izmir	Izmir
كەئەلىڭ كوكوس تاقىم ئاراللىرى	Kokosøyene
مېرسېدېس - بېنز	Mercedes-Benz
كۋېنسلاند	Queensland
Minnéapolis	Minneapolis
دەرەخ خالتىلىق ئېيىقى	Koala
2011-يىلدىكى ياپونىيە يەر تەۋرەش ۋە دېڭىز تاشقىنى	Jordskjelvet ved Tōhoku 2011
لىنگالاچە	Lingala
مالايالامچە	Malayalam
يىپەك يولى	Silkeveien
Kalgari	Calgary
ئوستىيىن	Jane Austen
قوڭۇر ئېيىق	Brunbjørn
كۇرد تىلى	Kurdisk
مولداۋىيە تىلى	Moldovsk
يېڭى تاش قۇرال دەۋرى	Neolittisk tid
مورېسبى پورتى	Port Moresby
خىمىيىلىك رېئاكسىيە	Kjemisk reaksjon
لاھەي	Haag
جۇاڭزۇ مىللىتى	Zhuang (folk)
ئوسمانلى تۈركچىسى	Osmantyrkisk
يۇھاننا بايان قىلغان خۇش خەۋەر	Evangeliet etter Johannes
توكېلاۋ تاقىم ئاراللىرى	Tokelau
چاغاتاي ئۇيغۇر يېزىقى	Chagatai
تۋىچە	Twi
چېڭلۇڭ	Jackie Chan
توخار تىلى	Tokariske språk
ئېلان	Reklame
Zeytun	Oliven
ئاۋكلاند	Auckland
سەككىز دۆلەت گۇرۇھى (G8)	G8
ئاۋكادۇر	Avokado
قىزىل قان دانىچىلىرى	Rød blodcelle
ئوقۇتقۇچى	Lærer
تىز	Kne
ئۆرۈك	Aprikos
گلۇكوزا	Glukose
Sint-Truiden	Sint-Truiden
ئالتاي تىللىرى سىستېمىسى	Altaiske språk
ناتالىيە پورتمەن	Natalie Portman
Ran'gon	Yangôn
ناگاساكى	Nagasaki
يوكوخاما	Yokohama
ئادانا	Adana
لازېر نۇرى	Laser
Lyuju shehiri	Liuzhou
خەلق پۇلى يۈەنى	Kinesisk renminbi
Ritis	Leeds
رەجەپ تاييىپ ئەردوغان	Recep Tayyip Erdoğan
قىزغۇچ سېرىق	Oransje
شىمال بۇغىسى	Rein
لۇقا بايان قىلغان خۇش خەۋەر	Evangeliet etter Lukas
كونا تاش قۇرال دەۋرى	Paleolitikum
ئانتاليا ۋىلايىتى	Antalya (provins)
ھەزرىتى ئەيسا ئەلچىلىرىنىڭ پائالىيەتلىرى	Apostlenes gjerninger
پەرۋەز مۇشەررەڧ	Pervez Musharraf
ئادانا ۋىلايىتى	Adana (provins)
تاشقا ئايلانغان جىسىم	Fossil
بۇرسا	Bursa
ئۇرۇق	Frø
ئەنخۇي ئۆلكىسى	Anhui
خەلقئارا ئولىمپىك كومىتىتى	Den internasjonale olympiske komité
ماڭلاي	Panne
ئىچكى موڭغۇل ئاپتونوم رايونى	Indre Mongolia
Nottingxam	Nottingham
راكېتا	Rakett
كۇردىستان	Kurdistan
ستانفورد ئۇنىۋېرستېتى	Stanford University
فۇجيەن ئۆلكىسى	Fujian
Kanzas Shehiri, Missuri	Kansas City (Missouri)
كىچىك مۈشۈكئېيىق	Rød panda
موڭغۇل مىللىتى	Mongolene
ۋەھىيلەر	Johannes' åpenbaring
Sirtlan	Hyenefamilien
كاسا	Rumpeball
خەينەن ئۆلكىسى	Hainan
رىمان	Bernhard Riemann
گەنسۇ ئۆلكىسى	Gansu
ئاق قان ھۈجەيرىسى	Hvit blodcelle
ئەنگلىيىلىكلەر	Engelskmenn
ئاناتول فرانس	Anatole France
ئوتلاق ياۋا مۈشۈكى	Afrikansk villkatt
جەينەك	Albue
سۇجۇ شەھىرى	Suzhou
جاڭگال مولۇنى	Jungelkatt
بېنگال مولۇنى تاغ مۈشۈكى	Leopardkatt
Wénju shehiri	Wenzhou
ۋۇشى شەھىرى	Wuxi
Shawshin shehiri	Shaoxing
خەنزۇ مىللىتى	Han-kinesere
نىڭبو شەھىرى	Ningbo
ئابدۇللاھ گۈل	Abdullah Gül
نېمىسلار	Tyskere
خاربىن شەھىرى	Harbin
Orkéstr	Orkester
تۈرك قەھۋەسى	Tyrkisk kaffe
قىزىل ياقۇت	Rubin
كەشمىر	Kashmir
كەۋىن رۇد	Kevin Rudd
يۈننەن ئۆلكىسى	Yunnan
مالكولم X	Malcolm X
مەۋلانا جالالىددىن رۇمى	Rumi
Plimowt	Plymouth
شەندۇڭ ئۆلكىسى	Shandong
قول	Arm
Dérbi	Derby (Derbyshire)
ياقۇت رەڭلىك	Smaragd
كىرىستال	Krystall
خېنەن ئۆلكىسى	Henan
بۇرسا ۋىلايىتى	Bursa (provins)
ئارتۋىن ۋىلايىتى	Artvin (provins)
كىندىك	Navle
ئادىيامان ۋىلايىتى	Adıyaman (provins)
لياۋنىڭ ئۆلكىسى	Liaoning
خىمىيىلىك باغ	Kjemisk binding
GNU	GNU
توچىگى ناھىيىسى	Tochigi (prefektur)
سېمونت	Sement
جىلىن ئۆلكىسى	Jilin (provins)
ئافيون قاراھىسار ۋىلايىتى	Afyonkarahisar (provins)
بېربېرلار	Berbere
خۇنەن ئۆلكىسى	Hunan
ھونلار	Hunere
چىڭخەي ئۆلكىسى	Qinghai
ئۇيغۇر مىللىتى	Uighurer
بىلەجىك ۋىلايىتى	Bilecik (provins)
خۇبېي ئۆلكىسى	Hubei
شەنشى ئۆلكىسى	Shanxi
يۈز	Kinn (anatomi)
قوڭۇر رەڭلىك	Brun
گۇيلىن ئۆلكىسى	Guizhou
بالىكەسىر ۋىلايىتى	Balıkesir (provins)
كيوتو كىلىشىمنامىسى	Kyoto-avtalen
ئانىلار بايرىمى	Morsdag
خەلقئارا ئىسلام كېڭىشى تەشكىلاتى	Organisasjonen for islamsk samarbeid
چاناققالە ۋىلايىتى	Çanakkale (provins)
مىياگى ناھىيىسى	Miyagi (prefektur)
Luknow	Lucknow
شېنشى ئۆلكىسى	Shaanxi
رىملىقلارغا يېزىلغان خەت	Paulus' brev til romerne
مالىكىي مەزھىبى	Maliki
ئوقۇغۇچى	Student
Kobe	Kobe
ئىۋاتە ناھىيىسى	Iwate (prefektur)
كولۇمبىيە ئۇنىۋېرستېتى	Columbia University
بوستون ئۇنىۋېرستېتى	Boston University
يالې ئۇنىۋېرسىتېتى	Yale University
پېنسىلۋانىيە ئۇنىۋېرستېتى	University of Pennsylvania
Portland, Méané	Portland (Maine)
نيۇيورك ئۇنىۋېرستېتى	New York University
پارىژ مېتروسى	Métro de Paris
پىرىت	Svovelkis
فىلىپىلىكلەرگە يېزىلغان خەت	Paulus' brev til filipperne
ئېگىزلىك گېرمان تىلى	Høytysk
قېلىپ:Taxobox	Mal:Taksoboks
قارا ئېقىم	Kuroshiostrømmen
خەلق گېزىتى	Renmin Ribao
جياڭشى ئۆلكىسى	Jiangxi
ئىلھام ئالىيېۋ	İlham Əliyev
زاردارى	Asif Ali Zardari
نۇرسۇلتان نازاربايېۋ	Nursultan Nazarbajev
نىڭشيا خۇيزۇ ئاپتونۇم رايونى	Ningxia
ئىسلام كەرىموۋ	Islom Karimov
شۈجو شەھىرى	Xuzhou
Lyenyün'gang shehiri	Lianyungang
ساۋكات مىرزىيويەۋ	Sjavkat Mirzijajev
خۇەيئەن شەھىرى	Huai'an (Jiangsu)
Yangjo shehiri	Yangzhou
Teyju shehiri, Jyangsu	Taizhou (Jiangsu)
Nentung shehiri	Nantong
جاڭجياڭ شەھىرى	Zhenjiang
چاڭجو شەھىر	Changzhou
ئەھمەد داۋۇد ئوغلۇ	Ahmet Davutoğlu
تەيجۇ شەھىرى	Taizhou (Zhejiang)
جۇشەن شەھىرى	Zhoushan
شىجياجۇاڭ شەھىرى	Shijiazhuang
تاڭشەن شەھىرى	Tangshan
Chinxuangdaw shehiri	Qinhuangdao
خەندەن شەھىرى	Handan
Bawding shehiri	Baoding
پەنجاب تىلى	Panjabi
پاشتوچە	Pashto
ساڭجو شەھىرى	Cangzhou
Langfang shehiri	Langfang
Juxey shehiri	Zhuhai
شەنتۇ شەھىرى	Shantou
Xuyjo shehiri	Huizhou (Guangdong)
Dongwen shehiri	Dongguan
Jongshen shehiri	Zhongshan (Guangdong)
مىقدار سۆز	Tallord
ئۆت خالتىسى	Galleblære
Jaypur	Jaipur
فۇجو شەھىرى	Fuzhou
Nenping shehiri	Nanping
Putyen shehiri	Putian
Senming shehiri	Sanming
Chüenju shehiri	Quanzhou
شيامېن شەھىرى	Xiamen
Jyangju shehiri	Zhangzhou
Longyen shehiri	Longyan
Ningdé shehiri	Ningde
Shining shehiri	Xining
تاغىل سېسىق كۈزەن	Marmorilder
خۇئاڭشى شەھىرى	Huangshi
ئائومورى ناھىيىسى	Aomori (prefektur)
فۇكۇشىما ناھىيىسى	Fukushima (prefektur)
تەييۈەن شەھىرى	Taiyuan
داتۇڭ شەھىر	Datong (Shanxi)
داليەن شەھىرى	Dalian
ئەنشەن شەھىرى	Anshan
يىڭكۇ شەھىرى	Yingkou
لياۋياڭ شەھەر	Liaoyang
يوزگات ۋىلايىتى	Yozgat (provins)
چوڭ مېڭە پوستلاق ماددىسى	Hjernebark
ئوڭچى	Høyresiden
كارل ۋون دونىتىز	Karl Dönitz
سۆسۈنە ياقۇت	Ametyst
بىنگۆل ۋىلايىتى	Bingöl (provins)
تايغان بۇغا	Hjort
ئارداھان ۋىلايىتى	Ardahan (provins)
ئايدىن ۋىلايىتى	Aydın (provins)
ئاماسيا ۋىلايىتى	Amasya (provins)
قازاق مىللىتى	Kasaker
ئاغرى ۋىلايىتى	Ağrı (provins)
بۇردۇر ۋىلايىتى	Burdur (provins)
كورىنتلىقلارغا يېزىلغان بىرىنچى خەت	Paulus' første brev til korinterne
باتمان ۋىلايىتى	Batman (provins)
كۇرىل ئاراللىرى	Kurilene
يېڭى يەر	Novaja Semlja
Patna	Patna
سۇلتان ئاخمەت جامىي	Sultan Ahmed-moskeen
ۋان ۋىلايىتى	Van (provins)
كونيا ۋىلايىتى	Konya (provins)
ئاكىتا ناھىيىسى	Akita (prefektur)
سېگولەن رويال	Ségolène Royal
بولۇ ۋىلايىتى	Bolu (provins)
دېنىزلى ۋىلايىتى	Denizli (provins)
شافىئىي مەزھىپى	Shafi'i
گىپىس	Gips
ئېڭەك	Hake
ئامېرىكا ياۋا كالىسى	Amerikansk bison
Léyséstér	Leicester
ساكاريا ۋىلايىتى	Sakarya (provins)
ئاقساراي ۋىلايىتى	Aksaray (provins)
قارس ۋىلايىتى	Kars (provins)
دىيارباقىر ۋىلايىتى	Diyarbakır (provins)
مور	Fruktlegeme
تەيبېي 101	Taipei 101
ئەدىرنە ۋىلايىتى	Edirne (provins)
بىتلىس ۋىلايىتى	Bitlis (provins)
ئىباراكى ناھىيىسى	Ibaraki (prefektur)
ھاتاي ۋىلايىتى	Hatay (provins)
يۇگوسلاۋىيە سوتسىيالىست فېدېرال جۇمھۇرىيىتى	Den sosialistiske føderale republikken Jugoslavia
تۈرك	Tyrkere
بارتىن ۋىلايىتى	Bartin (provins)
باش بارماق	Tommel
كوجائەلى ۋىلايىتى	Kocaeli (provins)
سازاڭسىمان مەددە	Caenorhabditis elegans
چاڭچۈن شەھىرى	Changchun
جىلىن شەھىرى	Jilin (Jilin)
ئېمۇ قۇشى	Emu
خاككارى ۋىلايىتى	Hakkâri (provins)
راۋالپىندى	Rawalpindi
Emir Kusturica	Emir Kusturica
ئاينۇ مىللىتى	Ainuer
ئورانگوتان	Menneskeaper
يېشىل ياقۇت	Beryll
Markus bayan qilghan xush xewer	Evangeliet etter Markus
بېلىز شەھىرى	Belize City
مارشال	Marskalk
Chuju shehiri	Chuzhou
Rékazé shehiri	Xigazê (Xigazê)
قىرىم	Krim-tatarer
كىلون تېخنىكىسى	Kloning
پروڧېسسور	Professor
كورىنتلىقلارغا يېزىلغان ئىككىنچى خەت	Paulus' andre brev til korinterne
مۇغلا ۋىلايىتى	Muğla (provins)
ئاسىيا قارا ئېيىق	Asiatisk svartbjørn
گۈلچىلىك	Hagebruk
ئىغدىر ۋىلايىتى	Iğdır (provins)
ياماگاتا ناھىيىسى	Yamagata (prefektur)
قاڭشارلىق بۆكەن	Saigaantilope
كۈتاھيا ۋىلايىتى	Kütahya (provins)
كۆك ياقۇت	Safir
كۈرەشچى ئايروپىلان	Jagerfly
ئېرتىش دەرياسى	Irtysj
ئىبرانىيلارغا يېزىلغان خەت	Brevet til hebreerne
گالاتىيلىقلارغا يېزىلغان خەت	Paulus' brev til galaterne
شاڭ سۇلالىسى	Shang-dynastiet
كىلىس ۋىلايىتى	Kilis (provins)
تەكىرداغ ۋىلايىتى	Tekirdağ (provins)
سان	Lår
مانىسا ۋىلايىتى	Manisa (provins)
كىچىك مېڭە	Lillehjernen
كولوسىلىقلارغا يېزىلغان خەت	Paulus' brev til kolosserne
ياقۇپ يازغان خەت	Jakobs brev
يۇھاننا يازغان بىرىنچى خەت	Johannes' første brev
فىلىمۇنغا يېزىلغان خەت	Paulus' brev til Filemon
سالونىكىلىقلارغا يېزىلغان ئىككىنچى خەت	Paulus' andre brev til tessalonikerne
پاۋىل كرۇگمەنن	Paul Krugman
سالونىكىلىقلارغا يېزىلغان بىرىنچى خەت	Paulus' første brev til tessalonikerne
پېترۇس يازغان بىرىنچى خەت	Peters første brev
پېترۇس يازغان ئىككىنچى خەت	Peters andre brev
تىموتىيغا يېزىلغان بىرىنچى خەت	Paulus' første brev til Timoteus
ئېسكىموسلار	Eskimo
IMMAGINE&POESIA	IMMAGINE&POESIA
چىكاگو ئۇنىۋېرستېتى	University of Chicago
ماردىن ۋىلايىتى	Mardin (provins)
مالاتيا ۋىلايىتى	Malatya (provins)
مۇش ۋىلايىتى	Muş (provins)
يۇھاننا يازغان ئىككىنچى خەت	Johannes' andre brev
يۇھاننا يازغان ئۈچىنچى خەت	Johannes' tredje brev
يەھۇدا يازغان خەت	Judas' brev
تىموتىيغا يېزىلغان ئىككىنچى خەت	Paulus' andre brev til Timoteus
تىتۇسغا يېزىلغان خەت	Paulus' brev til Titus
قىرقلارەلى ۋىلايىتى	Kırklareli (provins)
ئاليۇمىن ئوكسىدى	Korund
مەرسىن ۋىلايىتى	Mersin (provins)
ئوتتۇرا ئاسىيا ياۋا تۆگىسى	Baktriakamel
بۇشەھر ۋىلايىتى	Bushehr (provins)
تەكلىماكان قۇملۇقى	Taklamakan
قاشقىئوغلاق	Mårhund
ئاشمورە ۋە كارتىئەر ئاراللىرى	Ashmore og Cartierøyene
قىرشەھەر ۋىلايىتى	Kırşehir (provins)
ئەردەبىل ۋىلايىتى	Ardabil (provins)
سىنوپ ۋىلايىتى	Sinop (provins)
Ajax	Ajax (programmering)
ئاتىلار بايرىمى	Farsdag
شۆلگەي بېزى	Spyttkjertel
سېرىق قاشتېشى	Topas
بىھارى تىلى	Bihari
Teynen shehiri	Tainan
ۋىتامىنE	Vitamin E
سۇلتان توغرۇلبەگ	Toghrül
Xéngyang shehiri	Hengyang
مالاي ئېيىقى	Malayabjørn
زامان گېزىتى	Zaman (avis)
مانجۇ مىللىتى	Mandsjuer
تېرەك	Osp
ھېيدېلبېرگ ئۇنىۋېرستېتى	Universitetet i Heidelberg
سۇلايمان دېمىرەل	Süleyman Demirel
ۋەيران بولۇش	Konkurs
ج.ۋىللارد گىببس	Josiah Willard Gibbs
پۇت بارمىقى	Tå
ياغاچچى	Tømrer
نىغدە ۋىلايىتى	Niğde (provins)
قارا دېڭىز رايونى	Svartehavsregionen
يەر ئوتتۇرا دېڭىزى رايونى	Middelhavsregionen (Tyrkia)
مارمارا رايونى	Marmararegionen
شەرقىي جەنۇبىي ئاناتولىيە رايونى	Sørøst-Anatolia
لېيدېن ئۇنىۋېرستېتى	Universitetet i Leiden
مېڭە ئاستى بېزى	Hypofyse
تۈر:سىياسىي جۇغراپىيە	Geopolitikk
مۇرادئۈچ	Murad III
ئىدىنبۇرگ ئۇنىۋېرستېتى	University of Edinburgh
فارابى	Al-Farabi
كۆك قۇتان	Purpurhegre
گەۋدە	Torso
پامىر ئېگىزلىكى	Pamir
تولۇق كۇرس	Bachelor
تۆش بېزى	Brissel
دۆڭچە مېڭىنىڭ ئاستى	Hypothalamus
ئېلېكتر سىغىمى	Kapasitans
سولچى	Venstresiden
چاناق قەلئە ئۇرۇشى	Slaget om Gallipoli
بىريۇزا(ياقۇت)	Turkis (edelsten)
ئەخمەت نەدجەت سەزەر	Ahmet Necdet Sezer
ۋيېنا ئۇنىۋېرسىتېتى	Universitetet i Wien
توشقانسىمان سۈلەيسۈن	Pallaskatt
ئافيون قاراھىسار	Afyonkarahisar
ئوتتۇرا بارماق	Langfinger
ئەبۇ مۇسا جابىر بىن ھەييام	Geber
ئوشۇق	Ankelledd
ئادىياما	Adıyaman
تاغ ئۆچكىسى	Alpesteinbukk
پەنجاب	Punjab
شىيا سۇلالىسى	Xia-dynastiet
باشكەنت ئۇنىۋېرستېتى	Başkent Üniversitesi
جىنەن شەھىرى	Jinan (Shandong)
يول بەلگىسى	Trafikkskilt
چىڭداۋ شەھىرى	Qingdao
كالسېدونىيە	Kalsedon
ئاسىيا تېنچ ئوكيان ئىقتىسادىي ھەمكارلىق تەشكىلاتى	APEC
Glutséstér	Gloucester
قەشقەر شەھرى	Kashgar (Kashgar)
ئىلام ۋىلايىتى	Ilam (provins)
نەنچاڭ شەھىرى	Nanchang
بېشىكتاش گىمناستىكا كۇلۇبى	Beşiktaş
تۈرك لىراسى	Tyrkisk lira
ئۆچكە	Geiter
بورمودىلى	Bohrs atommodell
ھەزىم يولى	Spiserør
چاڭشا شەھىر	Changsha
ئۆكچە	Hæl
كېكىردەك	Svelg
ئۇيغقاشتېشى	Jade
ۋىتامىن D	Vitamin D
قۇتۇبى ناھىيىسى	Hutubi
2010 دۇنيا لوڭقىسى	VM i fotball 2010
نەسىرىدىن ئەپەندى	Nasreddin Hodja
كاۋاپ	Kebab
Wéstminstér Shehiri	City of Westminster
نەننىڭ شەھىرى	Nanning
Durham	Durham (England)
تۇرغۇت ئۆزال	Turgut Özal
ﮔﺎﮔﺎﯞﯗﺯ	Gagausere
بادام بەز	Mandler (anatomi)
مۇھەممەد خاتەمى	Muhammed Khatami
ساردونىكس	Onyx
تروچكىزم	Trotskisme
ياڭ جىننىڭ	Chen Ning Yang
Gawshyung	Kaohsiung
بىرىكمە ماتېرىيال	Komposittmateriale
مېڭە غولى	Hjernestamme
تاموژنا	Toll
كۈنمىڭ شەھىرى	Kunming
ۋىتامىنB	Vitamin B
ئىسمەت ئىنۆنۈ	İsmet İnönü
مارگارېت ئاتۋود	Margaret Atwood
خۇيزۇ مىللىتى	Huikinesere
لەنجۇ شەھىرى	Lanzhou
لى جىڭداۋ	Tsung-Dao Lee
ماگىستىر	Mastergrad
كۆرسەتكۈچ بارماق	Pekefinger
ئوتتۇرا مېڭە	Mesencephalon
ئۇپسالا ئۇنىۋېرستېتى	Uppsala universitet
خېفېي شەھىر	Hefei
ئىپار مۈشۈك ئائىلىسى	Snikekattfamilien
ئارقار	Argalisau
كوپېنھاگېن ئۇنىۋېرستېتى	Københavns Universitet
قارساق	Stepperev
لوياڭ شەھىرى	Luoyang
كۇئېنلۇن تاغ تىزمىسى	Kunlunfjellene
تىبەت مىللىتى	Tibetanere
لوندون ئىمپېرىيە ئىنستېتۇت	Imperial College London
گۇيلىن شەھىرى	Guilin
گېئوتىت	Goethitt
Xeyko shehir	Haikou
مولتىمىتىر	Multimeter
مەركىزىي مىللەتلەر ئۇنىۋېرسىتېتى	Minzu-universitetet
چىپار بۇغا	Sikahjort
بەل	Lem (kroppsdel)
يۇگوسلاۋىيە پادىشاھلىقى	Kongeriket Jugoslavia
ئېۋېنكى مىللىتى	Evenker
راھىبە	Nonne
سېرىق ياۋا مۈشۈك	Asiagullkatt
گۇيياڭ شەھىرى	Guiyang
نامسىز بارماق	Ringfinger
لىمبىك سىستېما	Limbiske systemet
تۇرپان	Turfan (Turfan)
ئىلى دەرياسى	Ili (elv)
دەريا بۇغىسى	Vannrådyr
ﺑﺎﻟﻘﺎﺭ ﻣﯩﻠﻠﯩﺘﻰ	Balkarer
كالا گۆشى	Storfekjøtt
گلاسگوۋ ئۇنىۋېرستېتى	University of Glasgow
توخارلار	Tokharere
بۇرما مۈڭگۈزلۈك بۆكەن	Takin
ئېلېكترون قەۋەت	Elektronskall
مىكروسكوپ	Mikroskop
كېمىنىڭ يان تىرەكلىرى	Ribbein
جاڭ خىڭ	Zhang Heng
جاڭ چيەن	Zhang Qian
موڭغۇلكۈرە ناھىيىسى	Zhaosu
Juko shehiri	Zhoukou
جۇگىلىياڭ	Zhuge Liang
زىبو شەھىرى	Zibo
ۋىتامىن C	Vitamin C
سۇلتان ئالىپ ئارىسلان	Alp Arslan
گوللاندىيىلىكلەر	Nederlendere
مەن، ماشىنا ئادەم (كىنو)	I, Robot (film)
جۇڭخۇا خەلق جۇمھۇرىيىتىنىڭ ئاساسىي قانۇنى	Folkerepublikken Kinas forfatning
قاشتېشى	Jaspis
تگرین اعظم	Tigranes I av Armenia
چۆل مۈشۈكى	Kinesisk fjellkatt
جۇڭگو شىنخۇا ئاگېنتلىقى	Xinhua
لىجياڭ شەھىرى	Lijiang (Yunnan)
چىچىخار شەھىرى	Qiqihar
گەبزە	Gebze
ئەلنى ئىدارە قىلىشقا پايدىلىق ئومۇمىي ئۆرنەكلەر	Zizhi Tongjian
ئۇزۇن قۇيرۇق بۇغا	Davidshjort
سېرىق تەنلىكلەر	Den mongoloide rase
Keyféng shehiri	Kaifeng
مياۋزۇ مىللىتى	Miao
بېيخەي شەھىرى	Beihai
يەنتەي شەھىرى	Yantai
يىنچۈئەن شەھىرى	Yinchuan
سەئىد قۇتوب	Sayyid Qutb
ئامستېردام ئۇنىۋېرستېتى	Universiteit van Amsterdam
ماتېرىيال	Materiale
دۇڭزۇ مىللىتى	Dong (folk)
تارىم ئويمانلىقى	Tarimbekkenet
بۈيۈك ئويۇن	Det store spillet
لازۇرىت	Lasurstein
قاراماي يۇقىر سۇرئەتلىك يولى	Karakoramveien
داغۇر مىللىتى	Daur
ﺭﺍﺩﯨﺸﺸﯧﯟ	Aleksandr Radisjtsjev
ئوۋتېز	Joyce Carol Oates
مۇدەنجياڭ شەھىرى	Mudanjiang (Heilongjiang)
ناشى مىللىتى	Nakhi
ۋاشىنگتون ئۇنىۋېرستېتى	University of Washington
زونگۇلداق ۋىلايىتى	Zonguldak (provins)
شىزاڭ ياۋا ئېشىكى	Tibetansk villesel
بىرمىنگام ئۇنىۋېرستېتى	University of Birmingham
ماتېرىيال ئىلمى	Materialvitenskap
ھەنبەلىي مەزھىبى	Hanafi
سەي لۇن	Cai Lun
قوڭۇر بۇغا	Sambarhjort
مىچىگان ئۇنىۋېرستېتى	University of Michigan
ﺋﺎﻗﺴﺎﻱ ﭼﯩﻦ	Aksai Chin
مانچېستېر ئۇنىۋېرستېتى	University of Manchester
تارپان	Tarpan
تارىم دەرياسى	Tarim (elv)
مىننېسوتا ئۇنىۋېرستېتى	University of Minnesota
فۇكاڭ شەھىرى	Fukang
ئورخان پامۇك	Orhan Pamuk
ئەرتۇغرۇل غازى	Ertuğrul
نەجمەتتىن ئەرباقان	Necmettin Erbakan
Teyjong shehiri	Taichung
ﭼﯘﯞﺍﺵ ﻣﯩﻠﻠﯩﺘﻰ	Tsjuvasjer
ئىسپارتا ۋىلايىتى	Isparta (provins)
قوڭۇر يىلپىز	Treleoparder
چىقچىق	Sumprikse
چانقىرى ۋىلايىتى	Çankırı (provins)
چورۇم ۋىلايىتى	Çorum (provins)
بەيزۇ مىللىتى	Bai (folk)
ئوسمانىيە ۋىلايىتى	Osmaniye (provins)
Putbol	Football
رابىيە قادىر	Rebiya Kadeer
ۋەن مارۋىجىك	Bert van Marwijk
داچىڭ شەھىر	Daqing
لىزۇ مىللىتى	Li (folk)
سۇلتان مەلىك شاھ	Malik Shah I
مەھمەت ئەلىي تالات	Mehmet Ali Talat
ئابدۇراخمان جامى	Abd al-Rahman Jami
مېلبۇرن ئۇنىۋېرستېتى	University of Melbourne
Dünxuang Shehiri	Dunhuang
لوپنۇر	Lop Nor
Senya shehiri	Sanya
Dostum	Abdul Rashid Dostum
ئۈرۈمچى ناھىيىسى	Ürümqi (Ürümqi)
بادام؛بادام؛بادام	Amygdala
ئىزمىر ۋىلايىتى	İzmir (provins)
بۇغدىيەك	Adamseple
بېڭبۇ شەھەرى	Bengbu
خۇەينەن شەھىرى	Huainan
مائەنشەن شەھىرى	Ma'anshan
ئەنچىڭ شەھىرى	Anqing
ياۋزۇ مىللىتى	Yao (folk)
ئەرزۇرۇم ۋىلايىتى	Erzurum (provins)
يېڭى تاڭنامە	Xin Tangshu
شانلى ئۇرفا ۋىلايىتى	Şanlıurfa (provins)
ترابزون ۋىلايىتى	Trabzon (provins)
برىتانى كولۇمبىيە ئۇنىۋېرستېتى	University of British Columbia
Metta bayan qilghan xush xewer	Evangeliet etter Matteus
Tekshi choqqiliq tagh shehiri	Pingdingshan
شىنشياڭ شەھىرى	Xinxiang
Nenyang shehiri	Nanyang (Henan)
Shinyang shehiri	Xinyang
ئەفەسلىكلەرگە يېزىلغان خەت	Paulus' brev til efeserne
ﺋﯩﻜﻜﯩﻨﭽﻰ ﻗﯩﺘﯩﻤﻠﯩﻖ ﯬﭘﻴﯘﻥ ﯰﺭﯗﺷﻰ	Andre opiumkrig
ئاقچى ناھىيىسى	Akqi
ئاقسۇ ۋىلايىتى	Aksu (Xinjiang)
ئاقسۇ شەھىرى	Aksu (Aksu)
ئاقسۇ دەرياسى	Aksu (elv i Xinjiang)
ئاقتو ناھىيىسى	Akto
ميەنياڭ شەھىرى	Mianyang
ھلا رەڭ	Rosa
نەۋشەھەر ۋىلايىتى	Nevşehir (provins)
نازارې	Nasaret
دۈزجە ۋىلايىتى	Düzce (provins)
ئالتاي شەھىرى	Altay (Altay)
يىزۇ مىللىتى	Yi (folk)
روزا ھېيت	Id al-fitr
شېڭ شىسەي	Sheng Shicai
نوتتىڭخام ئۇنىۋېرستېتى	University of Nottingham
تۈركىيە جۇمھۇريىتى باش مىنىستىرى	Liste over Tyrkias statsministre
ھانى مىللىتى	Hani
گىرەسۇن ۋىلايىتى	Giresun (provins)
گۈمۈشخانە ۋىلايىتى	Gümüşhane (provins)
سىئىرت ۋىلايىتى	Siirt (provins)
قاھرامان ماراش ۋىلايىتى	Kahramanmaraş (provins)
ئومۇرتقا	Ryggsøyle
قارامان ۋىلايىتى	Karaman (provins)
سامسۇن ۋىلايىتى	Samsun (provins)
ئۆزبېك مىللىتى	Usbekere
ئەسكىشەھەر ۋىلايىتى	Eskişehir (provins)
بايبۇرت ۋىلايىتى	Bayburt (provins)
ئۇشاق ۋىلايىتى	Uşak (provins)
يالوۋا ۋىلايىتى	Yalova (provins)
ئەلازىغ ۋىلايىتى	Elazığ (provins)
سىۋاس ۋىلايىتى	Sivas (provins)
غازى ئانتەپ ۋىلايىتى	Gaziantep (provins)
قارابۈك ۋىلايىتى	Karabük (provins)
ئەرزىنجان ۋىلايىتى	Erzincan (provins)
ئوردۇ ۋىلايىتى	Ordu (provins)
كاستامونۇ ۋىلايىتى	Kastamonu (provins)
توقات ۋىلايىتى	Tokat (provins)
نورۇز بايرىمى	Nouruz
كايسەرى ۋىلايىتى	Kayseri (provins)
رىزە ۋىلايىتى	Rize (provins)
تاجىك مىللىتى	Tadsjiker
مۇھەممەد ئىقبال	Muhammad Iqbal
پارسلار	Persere
قاراقالپاقىستان	Karakalpakstan
قىرىققالە ۋىلايىتى	Kırıkkale (provins)
شاڭخەي ھەمكارلىق تەشكىلاتى	Shanghaigruppen
تۈركىيە دەرىجىدىن تاشقىرى ئايلانمىسى	Süper Lig
فەرغانە ئويمانلىقى	Ferganadalen
فەرغانە	Fergana
Kanzas Shehiri, Kanzas	Kansas City (Kansas)
چاغاتاي خان	Chagatai Khan
سىدنېي ئۇنىۋېرستېتى	University of Sydney
ئوغۇزلار	Oghuz-tyrkere
كۆمۈرچەك	Brusk
ئەلشىر ناۋائى	Ali-Shir Nava'i
جەنۋە ئۇنىۋېرستېتى	Universitetet i Genève
قۇربان ھېيت	Id al-adha
تىمساھ	Alligatorer
ئىستانبۇل ۋىلايىتى	İstanbul (provins)
Kökxot shehiri	Hohhot
ياقۇب بەگ	Yaqub Beg
يەكەن دەرياسى	Yarkand (elv)
باۋتۇ شەھىر	Baotou
كۈنەس ناھىيىسى	Xinyuan
رومبىسىمان كرىستال كاتەكچىسى	Trigonal
تۇجيا مىللىتى	Tujia
توقسۇن ناھىيىسى	Toksun
تېھران ۋىلايىتى	Teheran (provins)
تۆش	Thorax
موناش ئۇنىۋېرستېتى	Monash University
كىچىك مونتياك	Svartmuntjak
بوکان	Bukan
رېگان ئىقتىسادشۇناسلىقى	Reaganomics
ئۆركەش دۆلەت	Wuerkaixi
ئۇلۇغچات ناھىيىسى	Ulugqat
دۇلۇڭ مىللىتى	Derung
تۇنجەلى ۋىلايىتى	Tunceli (provins)
ئارال شەھرى	Aral (Xinjiang)
خوتەن دەرياسى	Khotan (elv)
مۇز تاغ ئاتا	Muztagata
قابا ناھىيىسى	Kaba (Altay)
ئالبېرتا ئۇنىۋېرستېتى	University of Alberta
قوي گۆشى	Lammedeig
چەرچەن ناھىيىسى	Qiemo
تارباغاتاي ۋىلايىتى	Tacheng
قوڭۇر تاغ	Kongur Tagh
شىرناق ۋىلايىتى	Şırnak (provins)
چۆچەك شەھىرى	Tacheng (Tacheng)
قۇمۇل شەھىرى	Kumul (Kumul)
قاراماي شەھىرى	Karamay
ئاتۇش شەھىرى	Artux
ئارىشاڭ ناھىيىسى	Wenquan
بۇيى مىللىت	Bouyei
سۈلەيسۈن	Ekte gauper
نان	Nanbrød
بۆرەك ئۈستى بېزى	Binyre
لىمفا ئىشلەپچىقىرىدىغان	Lymfesystem
يانپاش	Bekken
جاڭ چۈنشيەن	Zhang Chunxian
ۋاڭ لېچۈەن	Wang Lequan
يۇڭ تاجلىق بۇغا	Topphjort
شېزۇ مىللىتى	She (folk)
قەشقەر ۋىلايىتى	Kashgar (Xinjiang)
تىن تىننىڭ سەرگۈزەشتىلىرى	Tintin
يوپۇرغا ناھىيىسى	Yopurga
دۇڭشياڭ مىللىتى	Dongxiang (folk)
لاخۇ مىللىتى	Lahu
مەكىت ناھىيىسى	Makit
ئۈرۈمچى دىۋوپۇ خەلقئارا ئايروپورتى	Ürümqi Diwopu internasjonale lufthavn
ئالتاي ۋىلايىتى	Altay (Xinjiang)
ۋۇجياچۈ شەھىرى	Wujiaqu
ئاۋات ناھىيىسى	Awat
ئايدىڭكۆل	Aydingkol
بابۇر	Babur
جەرەنبۇلاق رايونى	Baijiantan
باي ناھىيىس	Baicheng (Aksu)
بايىنغولىن موڭغۇل ئاپتونوم ئوبلاستى	Bayingolin
بونان مىللىتى	Bonan
قارا تەنلىكلەر	Svart (hudfarge)
ئورخۇن ئۇيغۇر خانلىقى	Uighur-imperiet
كورلا شەھىرى	Korla
دەيزۇ مىللىتى	Dai (folk)
مېنبا مىللىتى	Monba
چياڭزۇ مىللىتى	Qiang
ۋازۇ مىللىتى	Wa (folk)
تاجىسىمان يۇرەك قان تومۇر كېسىلى	Koronar hjertesykdom
شىمالىي ئامېرىكىلىق	Amerikaner (USA)
ئىلى قازاق ئاپتونوم ۋىلايىتى	Ili
شىخەنزە شەھىرى	Shihezi
دوكتور ئاسپرانتى	Doktorgrad
ئاچاڭ مىللىتى	Achang
تۇزۇ مىللىتى	Tu (folk)
لوبا مىللىتى	Lhoba
يەكەن ناھىيىسى	Yarkant
لىسۇ مىللىتى	Lisu
تېڭشۈن شىركىتى	Tencent
قىزىلسۇ قىرغىز ئاپتونوم ئوبلاستى	Kizilsu
كۋېنسلاند ئۇنىۋېرستېتى	University of Queensland
غۇلجا شەھىرى	Yining (by)
مۇلاۋ مىللىتى	Mulam
تۇرپان ۋىلايىتى	Turfan
Néwkastl Undérlim	Newcastle-under-Lyme
بورتالا موڭغۇل ئاپتونوم ئوبلاستى	Bortala (Xinjiang)
قئارئاهوجئا	Gaochang
布朗族	Blang
باغراش ناھىيىسى	Bohu
بورتالا شەھىرى	Bortala (Bortala)
جىمىسار ناھىيىسى	Jimsar
تاشقۇرقان تاجىك ئاپتونوم ناھىيىسى	Taxkorgan
ياردەم:ياردەم	Hjelp:Portal
لوپ ناھىيىسى	Lop
ئورقۇ رايونى	Urho
تۇمشۇق شەھىرى	Tumxuk
بۈيۈك ئارال	Büyükada
خوتەن ۋىلايىتى	Hotan
قۇمۇل ۋىلايىتى	Kumul (Xinjiang)
سانجى خۇيزۇ ئاپتونوم ئوبلاستى	Changji
كۈيتۇن شەھىرى	Kuitun
سانجى شەھىرى	Changji (Changji)
فارس ۋىلايىتى	Fars
بۇرچىن ناھىيىسى	Burqin
بۇرۇلتوقاي ناھىيىسى	Fuhai
يېڭىسار ناھىيىسى	Yengisar
ۋۇسۇ شەھىرى	Wusu
دۆربىلجىن ناھىيىسى	Emin
پوسكام ناھىيىسى	Poskam
گۇچۇڭ ناھىيىسى	Qitai
قورغاس ناھىيىسى	Huocheng
يەنجى خۇيزۇ ئاپتونوم ناھىيىسى	Yanqi Hui
لوپنۇر ناھىيىسى	Yuli
كوكتوقاي ناھىيىسى	Fuyun
قوبۇقسار موڭغۇل ئاپتونوم ناھىيىسى	Hoboksar
قەشقەر كونا شەھەر ناھىيىسى	Shufu
ساۋەن ناھىيىسى	Shawan (Tacheng)
قاغىلىق ناھىيىسى	Kargilik
خېجىڭ ناھىيىسى	Hejing
چاغانتوقاي ناھىيىسى	Yumin
پىچان ناھىيىسى	Piqan
كۇچار ناھىيىسى	Kucha
مايتاغ رايونى	Dushanzi
چاقىلىق ناھىيىسى	Ruoqiang
بۈگۈر ناھىيىسى	Luntai
قەشقەر يېڭىشەھەر ناھىيىسى	Shule
شايار ناھىيىسى	Shayar
مارالبېشى ناھىيىسى	Maralbexi
ماناس ناھىيىسى	Manas
ئونسۇ ناھىيىسى	Onsu
چىڭگىل ناھىيىسى	Qinggil
پەيزاۋات ناھىيىسى	Peyziwat
مورى قازاق ئاپتونوم ناھىيىسى	Mori (Changji)
تولى ناھىيىسى	Toli
خوشۇت ناھىيىسى	Hoxud
يېڭىشەھەر رايونى	Xinshi (Ürümqi)
تەڭرىتاغ رايونى	Tianshan (Ürümqi)
گۇما ناھىيىسى	Pishan
سايباغ رايونى	Saybagh
ئاشقازان	Magesekk
ئېلىك	Eurasiske rådyr
شىبە مىللىتى	Xibe
كىنو مىللىتى	Jino
غەربىي خەن سۇلالىسى	Det vestlige Han-dynasti
پېشاۋار	Peshawar
دۇتار	Dutar
كونا تاڭنامە	Tangshu
سۈينامە	Suishu
ئۇچتۇرپان ناھىيىسى	Uqturpan
چىرا ناھىيىسى	Qira (Hotan)
كەلپىن ناھىيىسى	Kalpin
قاراقاش ناھىيىسى	Karakash (Hotan)
جىڭ ناھىيىسى	Jinghe
نىيە ناھىيىسى	Minfeng
كېرىيە ناھىيىسى	Keriya
تۇخۇم نەيچىسى	Eggleder
شىنجاڭ ئىشلەپچىقىرىش - قۇرۇلۇش بىڭتۇەنى	Produksjons- og konstruksjonskorpset i Xinjiang
كونا بەش دەۋر تارىخى	Jiu Wudaishi
ﻣﯧﯔ ﺟىيەنﺠﯘ	Meng Jianzhu
جېمىنەي ناھىيىسى	Jeminay
توققۇزتارا ناھىيىسى	Gongliu
قاراماي رايونى	Karamay (Karamay)
توقسۇ ناھىيىسى	Xinhe (Aksu)
ئېسفەھان ۋىلايىتى	Isfahan (provins)
تۈر:تۈركىيە	Kategori:Tyrkia
تۈر:ئۆسۈملۈك	Kategori:Planter
تۈر:فىزىكا	Kategori:Fysikk
تۈر:تەبىئىي پەن	Kategori:Naturvitenskap
تۈر:Geografia	Kategori:Geografi
قەشقەر دەرياسى	Kashgar (elv)
خۇيزۇ	Hui
دوگانا	Dogana
ماخۇاتېڭ	Ma Huateng
سالانق تەشمەسى	Salangtunnelen
تۈر:خرىستىئان دىنى	Kategori:Kristendom
ئائىلە جەمئىيەتشۇناسلىقى	Familiesosiologi
ئەنقەرە ۋىلايىتى	Ankara (provins)
تۇنيۇقۇق	Tonjukuk
ئىراق ۋە شام ئىسلام دۆلىتى	Den islamske staten Irak og Levanten
پۇشتۇ مىللىتى	Pashtun
شىخەنزە ئۇنىۋېرسىتېتى	Shiheziuniversitetet
گېئورگى بۇچنېر ئەدەبىيات مۇكاپاتى	Georg Büchners pris
توشقان دەرياسى	Toshkan
نۇر بەكرى	Nur Bekri
ﺩﯨﻠﺒﻪﺭ ﻳﯘﻧﯘﺱ	Dilber
سەيپىدىن ئەزىزى	Saifuddin Azizi
تەمبۈر	Tanbur
Ördek	Ender
قېلىپ:Tl	Mal:Mal
قېلىپ:Userbox	Mal:Userbox
Wikipedia:Administrators	Wikipedia:Administratorer
تۈر:جۇڭخۇا مىللەتلىرى	Kategori:Folkegrupper i Kina
مىسىر	Egypt
قېلىپ:Bot	Mal:Bot
كانادا	Canada
Wikipedia:ھەققىدە	Wikipedia:Om
قېلىپ:Flagicon	Mal:Flagicon
قېلىپ:Documentation	Mal:Dokumentasjon
قېلىپ:Softredirect	Mal:Softredirect
قېلىپ:Delete	Mal:Hurtigsletting
تۈر:تىل	Kategori:Språk
Wikipedia:General disclaimer	Wikipedia:Generelle forbehold
قېلىپ:Navbox	Mal:Navboks
ئورقۇن-يېنسەي يېزىقى	Tyrkiske runer
خالتىلىق چاشقان	Kenguruer
ئىسمايىل تىلىۋالدى	Ismail Tiliwaldi
قېلىپ:!	Mal:!
قېلىپ:Tnavbar	Mal:Tnavbar
قېلىپ:Babel-3	Mal:Babel-3
قېلىپ:Babel	Mal:Babel
قېلىپ:Commons	Mal:Commons
قېلىپ:Reflist	Mal:Referanser
قېلىپ:Stub	Mal:Stubb
قېلىپ:User az	Mal:Bruker az
قېلىپ:User de	Mal:Bruker de
قېلىپ:User de-1	Mal:Bruker de-1
قېلىپ:User es	Mal:Bruker es
قېلىپ:User de-3	Mal:Bruker de-3
قېلىپ:User en-3	Mal:Bruker en-3
قېلىپ:User en-1	Mal:Bruker en-1
قېلىپ:User en-2	Mal:Bruker en-2
قېلىپ:User en-4	Mal:Bruker en-4
قېلىپ:User en	Mal:Bruker en
قېلىپ:User de-2	Mal:Bruker de-2
قېلىپ:User es-1	Mal:Bruker es-1
قېلىپ:User fr-1	Mal:Bruker fr-1
قېلىپ:User ja-4	Mal:Bruker ja-4
قېلىپ:User sk	Mal:Bruker sk
قېلىپ:User tr-2	Mal:Bruker tr-2
قېلىپ:User tr	Mal:Bruker tr
قېلىپ:User ja	Mal:Bruker ja
قېلىپ:User ja-1	Mal:Bruker ja-1
قېلىپ:User fr	Mal:Bruker fr
قېلىپ:Location map/Info	Mal:Kartposisjon/Info
قېلىپ:Mod	Mal:Mod
قېلىپ:Welcome	Mal:Reg-velkommen
تۈر:User fr-1	Kategori:Bruker fr-1
قېلىپ:Country showdata	Mal:Country showdata
قېلىپ:Category handler	Mal:Category handler
قېلىپ:ئافرىقا	Mal:Afrikaland
تۈر:User en-4	Kategori:Bruker en-4
تۈر:User en	Kategori:Bruker en
تۈر:User zh	Kategori:Bruker zh
تۈر:User zh-N	Kategori:Bruker zh-N
تۈر:User en-2	Kategori:Bruker en-2
قېلىپ:Infobox	Mal:Infoboks
قېلىپ:ئىراننىڭ ۋىلايەتلىرى	Mal:Irans provinser
قېلىپ:User zh	Mal:Bruker zh
قېلىپ:Legend	Mal:Legend
قېلىپ:Ombox	Mal:Pmboks
قېلىپ:Pp-template	Mal:Beskyttet side
قېلىپ:Babel-4	Mal:Babel-4
قېلىپ:Babel-5	Mal:Babel-5
قېلىپ:Babel-2	Mal:Babel-2
قېلىپ:Babel-9	Mal:Babel-9
قېلىپ:Babel-6	Mal:Babel-6
قېلىپ:User ru	Mal:Bruker ru
قېلىپ:Babel-8	Mal:Babel-8
قېلىپ:IPA	Mal:IPA
قېلىپ:Babel-1	Mal:Babel-1
قېلىپ:ئوكيانىيە	Mal:Oseania
قېلىپ:Babel-7	Mal:Babel-7
قېلىپ:Unreferenced	Kategori:Artikler som trenger referanser
قېلىپ:جۇڭخۇا خەلق جۇمھۇرىيىتى	Mal:Kinas provinser
قېلىپ:Provinces of Uzbekistan	Mal:Usbekistans provinser
قېلىپ:ياپونىيە	Mal:Japans regioner og prefekturer
تۈر:User ja-N	Kategori:Bruker ja-N
قېلىپ:Tick	Mal:Hake
قېلىپ:رۇسىيە	Mal:Russlands forvaltningsenheter
قېلىپ:Infobox person	Mal:Infoboks biografi
قېلىپ:ياۋروپا	Mal:Europa
تۈر:User az	Kategori:Bruker az
تۈر:User sk	Kategori:Bruker sk
تۈر:User fr	Kategori:Bruker fr
تۈر:User ja	Kategori:Bruker ja
تۈر:User az-3	Kategori:Bruker az-3
تۈر:User fr-3	Kategori:Bruker fr-3
تۈر:User ja-3	Kategori:Bruker ja-3
تۈر:User tr-3	Kategori:Bruker tr-3
تۈر:User tr-1	Kategori:Bruker tr-1
تۈر:User fr-4	Kategori:Bruker fr-4
تۈر:User fr-2	Kategori:Bruker fr-2
تۈر:User ja-2	Kategori:Bruker ja-2
تۈر:User tr-2	Kategori:Bruker tr-2
تۈر:User ko-N	Kategori:Bruker ko-N
تۈر:User fr-N	Kategori:Bruker fr-N
تۈر:User ru-N	Kategori:Bruker ru-N
تۈر:User az-1	Kategori:Bruker az-1
تۈر:User az-N	Kategori:Bruker az-N
تۈر:User sk-N	Kategori:Bruker sk-N
تۈر:User de	Kategori:Bruker de
تۈر:User de-2	Kategori:Bruker de-2
تۈر:User de-3	Kategori:Bruker de-3
تۈر:User de-4	Kategori:Bruker de-4
تۈر:User de-N	Kategori:Bruker de-N
شىراز	Shiraz
تۈر:User en-3	Kategori:Bruker en-3
تۈر:User en-N	Kategori:Bruker en-N
تۈر:User es	Kategori:Bruker es
تۈر:User es-1	Kategori:Bruker es-1
تۈر:User es-N	Kategori:Bruker es-N
تۈر:User ja-1	Kategori:Bruker ja-1
تۈر:User ko	Kategori:Bruker ko
تۈر:User ko-3	Kategori:Bruker ko-3
تۈر:User ru-1	Kategori:Bruker ru-1
قېلىپ:Table Greekletters	Mal:Greske bokstaver
تۈر:ئىقتىساد	Kategori:Økonomi
تۈر:User zh-min-nan	Kategori:Bruker zh-min-nan
قېلىپ:Sockpuppet	Mal:Sokkedukke
قېلىپ:User ru-2	Mal:Bruker ru-2
تۈر:User ru	Kategori:Bruker ru
تۈر:User tr	Kategori:Bruker tr
تۈر:User tr-4	Kategori:Bruker tr-4
تۈر:User tr-N	Kategori:Bruker tr-N
تۈر:User ug	Kategori:Bruker ug
تۈر:User ug-1	Kategori:Bruker ug-1
تۈر:User uz	Kategori:Bruker uz
ۋىكىپېدىيە:ھۆججەت ئىشلىتىش پىرىنسىپى	Wikipedia:Retningslinjer for billedbruk
تۈر:ۋىتامىنلار	Kategori:Vitaminer
قېلىپ:User ru-1	Mal:Bruker ru-1
قېلىپ:User zh-1	Mal:Bruker zh-1
قېلىپ:User zh-2	Mal:Bruker zh-2
تۈر:User zh-1	Kategori:Bruker zh-1
تۈر:User zh-4	Kategori:Bruker zh-4
تۈر:User zh-3	Kategori:Bruker zh-3
تۈر:User zh-2	Kategori:Bruker zh-2
تۈر:خىمىيىۋى ئېلېمېنت	Kategori:Grunnstoffer
تۈر:ئۆزبېكىستان	Kategori:Usbekistan
تۈر:ئاتوم يادرو فىزىكىسى	Kategori:Kjernefysikk
ئەينەك تالا	Glassfiber-armert plast
سەۋزە	Gulrot
تۈر:جۇڭخۇا خەلق جۇمھۇرىيىتى	Kategori:Folkerepublikken Kina
تۈر:ئېتمولوگىيە	Kategori:Etymologi
قېلىپ:UF-hcard-geo	Mal:UF-hcard-geo
تۈر:بىيولوگ	Kategori:Biologer
تراگۇلۇس بۇغىسى	Dvergmoskusdyr
تۈر:User en-1	Kategori:Bruker en-1
تۈر:User de-1	Kategori:Bruker de-1
خوتەن شەھىرى	Hotan (Hotan)
ئالاھىدە:RecentChanges	Spesial:Siste endringer
تۈر:User ja-4	Kategori:Bruker ja-4
