非洲	Afrika
日本	Japan
南美洲	Sør-Amerika
挪威	Norge
英格兰	England
苏格兰	Skottland
匈牙利	Ungarn
西班牙	Spania
美国	USA
比利时	Belgia
卢森堡	Luxembourg
地球	Jorden
人	Menneske
欢喜	Lykke
芬兰	Finland
瑞典	Sverige
波兰	Polen
立陶宛	Litauen
意大利	Italia
瑞士	Sveits
奥地利	Østerrike
希腊	Hellas
土耳其	Tyrkia
啤酒	Øl
葡萄牙	Portugal
欧洲	Europa
亚洲	Asia
维基百科	Wikipedia
尼德兰	Nederland
PHP	PHP
纽约市	New York
旧金山	San Francisco
洛杉矶	Los Angeles
计算机	Datamaskin
办合纳	Bern
极乃伐	Genève
苏黎世	Zürich
巴拉克·奥巴马	Barack Obama
乌拉圭	Uruguay
白才尔	Basel
打印机	Skriver
伦敦	London
开罗	Kairo
苹果	Epleslekten
墨西哥	Mexico
大西洋	Atlanterhavet
太平洋	Stillehavet
加利福尼亚	California
波士顿	Boston
礼拜一	Mandag
火星	Mars (planet)
肯尼亚	Kenya
礼拜两	Tirsdag
礼拜三	Onsdag
礼拜四	Torsdag
礼拜五	Fredag
礼拜六	Lørdag
礼拜天	Søndag
法国	Frankrike
世界语	Esperanto
狗	Tamhund
英国	Storbritannia
貓	Tamkatt
中华人民共和国	Folkerepublikken Kina
法文	Fransk
鱼	Fisk
巴西	Brasil
俄罗斯	Russland
大海	Hav
圓周率	Pi
Π	Pi (bokstav)
聖保羅	São Paulo
该办克	Québec
德国	Tyskland
白俄罗斯	Hviterussland
德语	Tysk
冰岛	Island
愛沙尼亞	Estland
土星	Saturn
巧克力	Sjokolade
飞机	Fly
打仗	Krig
拉脱维亚	Latvia
乌克兰	Ukraina
捷克	Tsjekkia
斯洛伐克	Slovakia
斯洛文尼亚	Slovenia
摩尔多瓦	Moldova
罗马尼亚	Romania
保加利亚	Bulgaria
罗马	Roma
马其顿	Republikken Makedonia
阿爾巴尼亞	Albania
格陵兰	Grønland
克罗地亚	Kroatia
波黑	Bosnia-Hercegovina
阿塞拜疆	Aserbajdsjan
安道尔	Andorra
塞浦路斯	Republikken Kypros
格鲁吉亚	Georgia
哈萨克斯坦	Kasakhstan
马耳他	Malta
摩纳哥	Monaco
黑山共和国	Montenegro
梵蒂冈	Vatikanstaten
圣马力诺	San Marino
古巴	Cuba
大众汽车	Volkswagen
Java	Java (programmeringsspråk)
印度尼西亚	Indonesia
南非	Sør-Afrika
阿尔及利亚	Algerie
乌兹别克斯坦	Usbekistan
欧罗维竞唱歌比赛	Eurovision Song Contest
水	Vann
木	Treverk
电视机	Fjernsyn
冰岛文	Islandsk
智利	Chile
耶稣	Jesus Kristus
語言	Språk
英语维基百科	Wikipedia på engelsk
尼古拉·萨科齐	Nicolas Sarkozy
新加坡	Singapore
科学	Vitenskap
自由軟件	Fri programvare
列支敦士登	Liechtenstein
希特拉	Adolf Hitler
WikiLeaks	WikiLeaks
第二次世界大战	Andre verdenskrig
科隆	Köln
数学	Matematikk
拉丁文	Latin
巴林	Bahrain
亚美尼亚	Armenia
塞尔维亚	Serbia
月球	Månen
澳大利亚	Australia
物理学	Fysikk
阿根廷	Argentina
秘鲁	Peru
朝鲜民主主义人民共和国	Nord-Korea
柬埔寨	Kambodsja
恐龙	Dinosaurer
回教	Islam
里昂	Lyon
欧洲联盟	Den europeiske union
女性	Kvinne
诗	Poesi
米蘭	Milano
屁眼	Anus
古高尔	Googol
珠穆朗玛峰	Mount Everest
城市	By
巴斯德	Louis Pasteur
村	Landsby
大洋洲	Oseania
太阳系	Solsystemet
氢	Hydrogen
维基共享	Wikimedia Commons
揚聲器	Høyttaler
东帝汶	Øst-Timor
维嘞合朋纳	Villeurbanne
学纳河	Rhône
迪拜	Dubai
瀑瑶兰葡萄酒	Beaujolais
哥白尼	Nikolaus Kopernikus
碳	Karbon
音乐	Musikk
圣皮得斯堡	St. Petersburg
北	Nord
新西兰	New Zealand
南	Sør
印度	India
西	Vest
氯气	Klor
铅	Bly
蒙古国	Mongolia
委内瑞拉	Venezuela
国际象棋	Sjakk
缅因	Maine
苏里南	Surinam
巴拉圭	Paraguay
圭亚那	Guyana
艺术	Kunst
厄瓜多尔	Ecuador
哥伦比亚	Colombia
佛教	Buddhisme
玻利维亚	Bolivia
特里尼达搭仔多巴哥	Trinidad og Tobago
新罕布什爾	New Hampshire
马萨诸塞	Massachusetts
康涅狄格	Connecticut
鸡	Tamhøns
澤西島	Jersey
猪猡	Gris
伊朗	Iran
伊拉克	Irak
阿拉斯加	Alaska
以色列	Israel
巴拿马	Panama
也門	Jemen
约旦	Jordan
佛罗里达州	Florida
吉尔吉斯斯坦	Kirgisistan
科威特	Kuwait
老挝	Laos
黎巴嫩	Libanon
俄勒冈	Oregon
马尔代芙	Maldivene
马来西亚	Malaysia
缅甸	Myanmar
尼泊尔	Nepal
阿曼	Oman
巴基斯坦	Pakistan
卡塔尔	Qatar
沙特阿拉伯	Saudi-Arabia
斯里兰卡	Sri Lanka
史太林	Josef Stalin
叙利亚	Syria
塔吉克斯坦	Tadsjikistan
口袋妖怪	Pokémon
中华民国	Republikken Kina
泰国	Thailand
火车	Jernbanetog
土库曼斯坦	Turkmenistan
阿拉伯联合酋长国	De forente arabiske emirater
越南	Vietnam
新西伯利亚	Novosibirsk
大韩民国	Sør-Korea
阿富汗	Afghanistan
金	Gull
喀山	Kazan
孟加拉	Bangladesh
马里	Mali
安哥拉	Angola
不丹	Bhutan
文莱	Brunei
菲律宾	Filippinene
牛顿	Isaac Newton
OpenStreetMap	OpenStreetMap
量子力学	Kvantemekanikk
突尼斯	Tunisia
赞比亚	Zambia
津巴布韦	Zimbabwe
北京	Beijing
贝宁	Benin
博茨瓦纳	Botswana
布隆迪	Burundi
刚果共和国	Republikken Kongo
刚果民主共和国	Den demokratiske republikken Kongo
甘地	Mahatma Gandhi
连环画	Tegneserie
冈比亚	Gambia
科特迪瓦	Elfenbenskysten
喀麦隆	Kamerun
尼日利亚	Nigeria
索马里	Somalia
铌	Niob
凱撒	Julius Cæsar
苏丹	Sudan
汉堡	Hamburg
联合国	De forente nasjoner
唐担	Dante Alighieri
艾哈迈德堡	Ahmedabad
锡	Tinn (grunnstoff)
克林顿总统	Bill Clinton
孟买	Mumbai
波多黎各	Puerto Rico
卡纳塔克邦	Karnataka
列农	John Lennon
爱达荷州	Idaho
华盛顿州	Washington
科索沃	Kosovo
潘基文	Ban Ki-moon
Kofi Annan	Kofi Annan
分类:页面分类	Kategori:Kategorier
多特蒙德	Dortmund
冬天	Vinter
西班牙语	Spansk
匹兹堡	Pittsburgh
费城	Philadelphia
金奈	Chennai
班加罗尔	Bangalore
钞票	Penger
纽约州	New York (delstat)
罗德岛	Rhode Island
昆虫	Insekter
宾夕法尼亚	Pennsylvania
Uetersen	Uetersen
奧古斯都	Augustus
微软视窗	Microsoft Windows
直布罗陀	Gibraltar
布宜诺斯艾利斯	Buenos Aires
东京都	Tokyo
爱荷华州	Iowa
印地语	Hindi
艾迪托·比娅呋	Édith Piaf
因斯孛鲁克	Innsbruck
都柏林	Dublin
法兰克福	Frankfurt am Main
天主教	Katolisisme
圣经	Bibelen
金边	Phnom Penh
胡志明市	Ho Chi Minh-byen
河內市	Hanoi
英语	Engelsk
曼谷	Bangkok
臺北市	Taipei
同海市	Dong Hoi
Końskowola	Końskowola
达累斯萨拉姆	Dar-es-Salaam
Al-Khartoum	Khartoum
疾画合	Givors
1月11号	11. januar
明斯克	Minsk
微软公司	Microsoft
库鲁夫	Kurów
化学	Kjemi
2月19号	19. februar
Visual Basic	Visual Basic
本笃十六世	Benedikt XVI
12月25号	25. desember
8月4号	4. august
8月31号	31. august
迈克尔·杰克逊	Michael Jackson
巴西利亞	Brasília
圣地牙哥	Santiago de Chile
坎培拉	Canberra
悉尼	Sydney
墨尔本	Melbourne
木卫三	Ganymedes (måne)
珀斯	Perth (Australia)
西澳大利亚州	Vest-Australia
北领地 (澳大利亚)	Nordterritoriet
苏门答腊岛	Sumatra
突尼斯市	Tunis
德黑兰	Teheran
亚的斯亚贝巴	Addis Abeba
安卡拉	Ankara
贝尔格莱德	Beograd
分类:维基百科模板	Kategori:Maler
爪哇岛	Java (øy)
法属圭亚娜	Fransk Guyana
安曼	Amman
贝鲁特	Beirut
分类:国家模板	Kategori:Maler etter område
内罗毕	Nairobi
分类:地理模板	Kategori:Geografimaler
学堂	Skole
大学	Universitet
Wikipedia:沙盘	Wikipedia:Sandkasse
屋	Hus
卡尔梅克共和国	Kalmykia
金头公园	Parc de la Tête d'Or
地图	Kart
奥萨斯库	Osasco
同海机场	Dong Hoi lufthavn
世界言话排名	Liste over språk etter utbredelse
分类:日本历史	Kategori:Japans historie
孔子	Konfucius
分类:数学	Kategori:Matematikk
法罗群岛	Færøyene
分类:印度历史	Kategori:Indias historie
分类:泰国历史	Kategori:Thailands historie
巴厘岛	Bali
分类:缅甸历史	Kategori:Myanmars historie
欧元	Euro
美元	Amerikansk dollar
地中海	Middelhavet
威尼斯共和国	Republikken Venezia
杭州市	Hangzhou
基督教	Kristendom
模板:Support	Mal:For
金国	Jin-dynastiet (1115–1234)
洲	Kontinent
阿德来得	Adelaide
首都	Hovedstad
葡萄牙语	Portugisisk
模板:Portal	Mal:Portal
公元1949年	1949
阿嘞玛桑	Almazán
黄现璠	Huang Xian-fan
里昂国际城	Cité internationale
日语	Japansk
荧光屏	Skjerm (monitor)
百科全书	Encyklopedi
封面	Portal:Forside
路由器	Ruter (IT)
棒球	Baseball
奧林匹克运动会	Olympiske leker
长江	Chang Jiang
里海	Det kaspiske hav
拉斐尔	Rafael
电车	Sporvei
加泰罗尼亚	Catalonia
毛泽东	Mao Zedong
西安	Xi'an
拉萨市	Lhasa
性行为	Samleie
加夫列尔·加西亚·马尔克斯	Gabriel García Márquez
分类:快速删除候选	Kategori:Sider som er foreslått raskt slettet
莎里 嘛克嘞朗	Sally Pearson
马可·波罗	Marco Polo
共产主义	Kommunisme
1368年	1368
Joe Biden	Joe Biden
希拉里·克林顿	Hillary Clinton
Yelena Isinbayeva	Jelena Isinbajeva
大英博物馆	British Museum
蒙彼利埃	Montpellier
分类:天文学	Kategori:Astronomi
汉堡包	Hamburger
班合比让	Perpignan
标致汽车	Peugeot
李白	Li Bai
图书馆	Bibliotek
世界银行	Verdensbanken
汉武帝	Keiser Wu av Han
女权主义	Feminisme
元朝	Yuan-dynastiet
库克船长	James Cook
郑和	Zheng He
黃河	Den gule flod
蚂蚁	Maur
宋朝	Song-dynastiet
宋高宗	Keiser Gaozong av Song
落苏	Aubergine
龙	Drage
姆妈	Mor
隆波岛	Lombok
小人	Barn
俄语	Russisk
普京	Vladimir Putin
东南亚国家联盟	Association of Southeast Asian Nations
面包	Brød
国际货币基金组织	Det internasjonale pengefondet
联合国教育科学文化组织	UNESCO
联合国卫生组织	Verdens helseorganisasjon
漢語	Kinesisk
雨	Regn
全球暖化	Global oppvarming
纳尔逊·曼德拉	Nelson Mandela
马丁·路德·金	Martin Luther King jr.
蛋白质	Protein
天灾	Naturkatastrofe
海啸	Tsunami
云	Sky
几何学	Geometri
日圆	Japansk yen
单词	Ord
漢字	Kinesiske tegn
希腊字母	Det greske alfabetet
諺文	Hangul
分类:法国	Kategori:Frankrike
分类:音乐	Kategori:Musikk
红楼梦	Drømmen om det røde kammeret
漫画	Manga
哈利波特	Harry Potter
小提琴	Fiolin
肛交	Analsex
教育	Utdannelse
男性	Mann
婚姻	Ekteskap
法语维基百科	Wikipedia på fransk
咖啡	Kaffe
果汁	Jus (drikk)
山	Fjell
第29届奧林匹克运动会	Sommer-OL 2008
孙中山	Sun Yat-sen
香港	Hongkong
首尔	Seoul
上海	Shanghai
伦敦 海斯楼 飞机场	London Heathrow lufthavn
清朝	Qing-dynastiet
越南战争	Vietnamkrigen
巴斯克语	Baskisk
阿拉贡语	Aragonesisk
瓦伦西亚	Valencia
玛丽咏·高帝娅	Marion Cotillard
麦克斯韦	James Clerk Maxwell
原子	Atom
光	Lys
罗鲍斯	Dayron Robles
韩语	Koreansk
官話	Mandarin (språk)
高棉文	Khmer (språk)
弗洛伊德	Sigmund Freud
泰语	Thai
马来语	Malayisk
蒙古语	Mongolsk
犹太教	Jødedom
万象	Vientiane
莫白桑	Guy de Maupassant
司马迁	Sima Qian
朱熹	Zhu Xi
廷巴克图	Timbuktu
伦理学	Etikk
沙·卢克·康	Shah Rukh Khan
什叶派	Sjiaislam
道教	Taoisme
子宫	Livmor
颈	Hals
富克朗特群岛	Falklandsøyene
马恩岛	Man
戴安娜王妃	Diana, prinsessen av Wales
唐玄宗	Keiser Xuanzong av Tang
Α	Alfa
Ω	Omega
Μ	My
明朝	Ming-dynastiet
朱元璋	Hongwu-keiseren
Φ	Phi
朱由检	Chongzhen-keiseren
Laura Robson	Laura Robson
2008年欧罗维竞唱歌比赛	Eurovision Song Contest 2008
强·马凯恩	John McCain
金正日	Kim Jong-il
元素周期表	Periodesystemet
罗別脫 姆格比	Robert Mugabe
自杀	Selvmord
爬蟲類	Krypdyr
Λ	Lambda
伍老虎	Tiger Woods
洋山芋	Potet
三宝垄	Semarang
报纸	Avis
电话	Telefon
?	Spørsmålstegn
美国空军	United States Air Force
菲德尔·卡斯特罗	Fidel Castro
元素单子	Grunnstoff
广域网	Vidstrakt datanett
围棋	Go
电影	Film
气体	Gass
液体	Væske
固体	Faststoff
脚踏车	Sykkel
农业	Landbruk
温度	Temperatur
面积	Areal
数	Tall
玛丽亚·莎拉波娃	Marija Sjarapova
重慶	Chongqing
天津市	Tianjin
武汉	Wuhan
世界地理索引	Liste over stater
玫瑰人生 (歌)	La vie en rose (sang)
担桑身	Svangerskap
Google地图	Google Maps
癌	Kreft
残疾人	Funksjonshemning
抗生素	Antibiotika
青霉素	Penicillin
肺炎	Lungebetennelse
克来普	Crêpe
麻将	Mahjong
运河	Kanal (farvann)
坝	Demning
牛顿 (单位)	Newton (enhet)
世界报 (法国)	Le Monde
万里长城	Den kinesiske mur
可再生能源	Fornybar energi
电	Elektrisitet
核武器	Kjernefysiske våpen
Joomla!	Joomla!
吉卜赛语	Romanes
壮语	Zhuang (språk)
自由人报 (法国)	Libération
安吉丽娜	Angelina Jolie
阿拉伯语	Arabisk
马多符	Bernard Madoff
扬马延岛	Jan Mayen
弗	Dollar
科西嘉岛	Korsika
奥克语	Oksitansk
克里斯蒂娜 艾伐脱	Chris Evert
李明博	Lee Myung-bak
Β	Beta
Γ	Gamma
Δ	Delta (bokstav)
Ε	Epsilon
Ζ	Zeta
Η	Eta (bokstav)
Θ	Theta
Ι	Iota
Κ	Kappa (bokstav)
Ν	Ny (bokstav)
Ξ	Ksi
Ο	Omikron
Ρ	Rho
Σ	Sigma
Τ	Tau (bokstav)
Υ	Ypsilon
Χ	Khi
Ψ	Psi
复活节岛	Påskeøya
澳门	Macao
联想计算机公司	Lenovo
董建华	Tung Chee-Hwa
胡锦涛	Hu Jintao
习近平	Xi Jinping
深圳市	Shenzhen
廣東省	Guangdong
广西壮族自治区	Guangxi
国际金融中心 (香港)	International Finance Centre
施蒂文 呼克	Steven Hooker
鹿儿岛县	Kagoshima (prefektur)
C语言	C (programmeringsspråk)
手铐	Håndjern
艾米·麦克唐纳 (歌手)	Amy Macdonald
Wikipedia:Featured articles	Wikipedia:Utmerkede artikler
Wikipedia:红茶坊	Wikipedia:Tinget
釜山广域市	Busan
佛蒙特	Vermont
广州	Guangzhou
蔣中正	Chiang Kai-shek
江泽民	Jiang Zemin
温家宝	Wen Jiabao
南京市	Nanjing
刘德华	Andy Lau
张学友	Jacky Cheung
同济大学	Tongjiuniversitetet
首都圈电铁	Seouls undergrunnsbane
北京大学	Pekinguniversitetet
清華大學	Tsinghuauniversitetet
江苏省	Jiangsu
浙江省	Zhejiang
邓小平	Deng Xiaoping
菲律宾比索	Filippinsk peso
西藏	Den autonome region Tibet
圆	Sirkel
同性婚姻	Likekjønnet ekteskap
Francesc Fàbregas	Cesc Fàbregas
手机	Mobiltelefon
太平山 (香港)	Victoria Peak
欧洲杯足球赛	UEFA Champions League
马来亚半岛	Malayahalvøya
平壤市	Pyongyang
奥斯卡奖	Oscar
各经济实体国内生产总值列表	Liste over land etter BNP
司徒华	Szeto Wah
黑龍江省	Heilongjiang
芽庄市	Nha Trang
教皇	Pave
波多黎各独立党	Partido Independentista Puertorriqueño
钱塘江	Qiantang
四川省	Sichuan
蔡元培	Cai Yuanpei
圣诞	Jul
闰年	Skuddår
大田广域市	Daejeon
大邱广域市	Daegu
仁川国际机场	Incheon internasjonale lufthavn
仁川广域市	Incheon
京畿道	Gyeonggi
计算机科学	Informatikk
阿鲁巴	Aruba
国际音标	Det internasjonale fonetiske alfabetet
河北省	Hebei
GNU自由文档许可证	GNU fri dokumentasjonslisens
陈水扁	Chen Shui-bian
台湾	Taiwan
纽约	New York (andre betydninger)
2012年欧洲足球冠军赛	EM i fotball 2012
人口密度	Befolkningstetthet
爱尔兰	Irland (øy)
南京航空航天大学	Nanjings aeronautiske og astronautiske universitet
鲁迅	Lu Xun
湖	Innsjø
黄瓜	Agurk
南奥赛西亚	Sør-Ossetia
阿什哈巴德	Asjkhabad
岛屿	Øy
马赛	Marseille
风牙己榜国家公园	Phong Nha-Ke Bang nasjonalpark
广平省	Quang Binh (provins)
赤道	Ekvator
字典	Ordbok
北塞浦路斯	Nord-Kypros
沪剧	Huju
死海	Dødehavet
英镑	Britisk pund
金兰国际机场	Cam Ranh internasjonale lufthavn
荷属安地列斯	De nederlandske Antiller
根西岛	Guernsey
斯瓦尔巴群岛	Svalbard
Benetice	Benetice (Světlá nad Sázavou)
摄氏温标	Grad Celsius
大叻市	Dalat
岘港市	Da Nang
Washington	Washington (andre betydninger)
甴巴子	Kakerlakker
鱷魚	Krokodiller
朝鮮正祖	Jeongjo av Joseon
人造卫星	Kunstig satellitt
杀人鲸	Spekkhogger
苏岩礁	Socotrarevet
日本海	Japanhavet
东亚	Øst-Asia
北亚	Nord-Asia
南欧	Syd-Europa
东欧	Øst-Europa
北欧	Nord-Europa
西欧	Vest-Europa
中欧	Sentral-Europa
琉球国	Kongedømmet Ryukyu
扶余国	Buyeo
县	Fylke
伊斯兰历	Islamsk kalender
柳京饭店	Ryugyong Hotel
霍顿汽车	Holden (bil)
市长	Ordfører
总统	President
满洲国	Mandsjukuo
安娜·伊凡诺维琪	Ana Ivanović
圣诞岛	Christmasøya
黄宗羲	Huang Zongxi
臺灣省	Taiwan (provins)
拳击	Boksing
大西洋处女	Virgin Atlantic Airways
快达航空	Qantas
国立台湾大学	Taiwans nasjonale universitet
斑马	Sebra
金瓯省	Ca Mau (provins)
客家语	Hakka (språk)
优八克	IUPAC
赣语	Gan (språk)
海地克里奥耳语	Haitisk kreol
大熊猫	Panda
孤立語言	Isolerte språk
卡纳达语	Kannada
杜甫	Du Fu
瓦尔帕莱索	Valparaíso
演员	Skuespiller
分类:程序编制言话	Kategori:Programmeringsspråk
瓦哈卡	Oaxaca
侗台语	Tai-kadai-språk
白脱	Smør
尼亚加拉瀑布	Niagarafallene
吴语	Wu (språk)
塔斯马尼亚	Tasmania
贝拉齐尔‧布托	Benazir Bhutto
费利佩二世 (西班牙)	Filip II av Spania
牛津大学	University of Oxford
基地 (恐怖组织)	Al-Qaida
英吉利海峡	Den engelske kanal
柴尔兹孛格	Salzburg
秦国	Qin (stat)
半岛	Halvøy
新疆維吾爾自治區	Xinjiang
布里司班	Brisbane
东正教	Den ortodokse kirke
各国首都列表	Liste over hovedsteder etter land
平面镜	Speil
孛拉特 皮此	Brad Pitt
欧洲足球联合会	UEFA
美国个州	USAs delstater
议会	Parlament
大阪市	Osaka
剑桥大学	University of Cambridge
牙膏	Tannkrem
通货膨胀	Inflasjon
艾美 羅森	Emmy Rossum
竹	Bambus
刚果	Kongo
马失拉地	Maserati
科科斯群岛	Kokosøyene
昆士兰州	Queensland
明尼阿波利斯	Minneapolis
顺化市	Huế
马拉雅南语	Malayalam
逻辑语	Lojban
耶稣会	Jesuittordenen
承天顺化省	Thua Thien-Hue (provins)
阿伯丁	Aberdeen
上海浦东国际机场	Shanghai Pudong internasjonale lufthavn
政治學	Statsvitenskap
闽东语	Mindong
闽南语	Minnan
Tycho Brahe	Tycho Brahe
薄辽省	Bac Lieu (provins)
约旦河西岸	Vestbredden
维克多利亚州	Victoria (Australia)
上海言话	Shanghainesisk
水晶之夜	Krystallnatten
潮州话	Teochew
台语	Taiwansk
门	Dør
猪流感	Svineinfluensa
平阳省	Binh Duong (provins)
三船敏郎	Toshiro Mifune
AK-47	AK-47
八国集团	G8
孙武	Sunzi
国际商用机器公司	International Business Machines
互聯網電影數據庫	Internet Movie Database
贝克特	Samuel Beckett
达赖喇嘛	Dalai Lama
邮政编码	Postnummer
Nicole Kidman	Nicole Kidman
联合国安理会	FNs sikkerhetsråd
洋火棒儿	Fyrstikk
雹	Hagl
南海	Sørkinahavet
朝鮮世宗	Sejong den store
奥克兰格兰玛学校	Auckland Grammar School
电冰箱	Kjøleskap
黄海	Gulehavet
大仲马	Alexandre Dumas
黄果树瀑布	Huangguoshufossen
孟加拉湾	Bengalbukta
哈马斯	Hamas
阿斯旺水坝	Aswandammen
人民币	Kinesisk renminbi
富士山	Fuji-san
小鼠	Mus (slekt)
索契	Sotsji
迈克尔·菲尔普斯	Michael Phelps
卡地马党	Kadima
加沙地带	Gazastripen
霍巴特	Hobart
金草莓奖	Golden Raspberry Awards
律师	Advokat
相扑	Sumo
希斯·莱杰	Heath Ledger
安徽省	Anhui
内蒙古自治区	Indre Mongolia
金日成	Kim Il-sung
全罗北道	Nord-Jeolla
济州特别自治道	Jeju
郁陵岛	Ulleungdo
湄公河	Mekong
索尼	Sony
巴別塔	Babels tårn
力学	Mekanikk
南半球	Sydlige halvkule
蔚山广域市	Ulsan
光州广域市	Gwangju
温室效应	Drivhuseffekt
Julia Gillard	Julia Gillard
华国锋	Hua Guofeng
福建省	Fujian
克拉耿富合脱	Klagenfurt
小熊猫	Rød panda
大溪地	Tahiti
安东市	Andong (Nord-Gyeongsang)
海南省	Hainan
汉语拼音	Pinyin
远东	Det fjerne østen
西班牙国家足球队	Spanias herrelandslag i fotball
华氏温标	Grad Fahrenheit
海峡群岛	Kanaløyene
甘肃省	Gansu
苏州市	Suzhou
无锡市	Wuxi
湖州市	Huzhou
绍兴市	Shaoxing
汉族	Han-kinesere
昆山	Kunshan
宁波市	Ningbo
ETA (民族组织)	ETA
隆城国际机场	Long Thanh internasjonale lufthavn
迪马 皮郎	Dima Bilan
记者	Reporter
基本粒子	Elementærpartikkel
陆克文	Kevin Rudd
沙菲娅 劳塔露	Sofia Rotaru
些拉·班琳	Sarah Palin
云南省	Yunnan
苏丹 (称谓)	Sultan
德国国家足球队	Tysklands herrelandslag i fotball
山东省	Shandong
福楼拜	Gustave Flaubert
英属印度洋领地	Det britiske territoriet i Indiahavet
地质年代	Geologisk tidsskala
河南省	Henan
乃堂雅虎	Benjamin Netanyahu
护照	Pass
遼寧省	Liaoning
件西卡 阿尔白	Jessica Alba
桑•班	Sean Penn
GNOME	GNOME
色子	Spillterning
吉林省	Jilin (provins)
东海	Østkinahavet
2008年美国总统选举	Presidentvalget i USA 2008
沙吞区	Sathon
阿南德	Viswanathan Anand
湖南省	Hunan
水族馆	Akvarium
青海省	Qinghai
豪納省	Rhône (departement)
陸龜	Landskilpadder
話筒	Mikrofon
山西省	Shanxi
魔方	Rubiks kube
尼德兰国家足球队	Nederlands herrelandslag i fotball
谜子	Gåte
艾西瓦娅·巴克罕	Aishwarya Rai
贵州省	Guizhou
Warren Buffett	Warren Buffett
蹔𧉆	Ekte sirisser
纸币	Pengeseddel
加沙城	Gaza (by)
白斯克	Baskerland
安达曼海	Andamanhavet
胡适	Hu Shi
孛路內 (Blu-Ray)	Blu-ray Disc
法国国家足球队	Frankrikes herrelandslag i fotball
后现代	Postmodernisme
宮城县	Miyagi (prefektur)
帕荔斯 希尔顿	Paris Hilton
陕西省	Shaanxi
模板:Commonscat	Mal:Commonscat
岩手县	Iwate (prefektur)
死人	Lik
莱纳斯·鲍林	Linus Pauling
Patrick Swayze	Patrick Swayze
純合子	Homozygot
水彩画	Akvarell
李舜臣	I Sun-sin
巴黎地铁	Métro de Paris
釜山地铁	Busans undergrunnsbane
清迈	Chiang Mai
珍珠港事件	Angrepet på Pearl Harbor
分类:化学模板	Kategori:Kjemimaler
模板:Taxobox	Mal:Taksoboks
丰田汽车	Toyota
田鸡	Springpadder
艾奇亚	IKEA
火车站	Jernbanestasjon
洛东江	Nakdongelva
模板:中国历史	Mal:Kinas historie
金正恩	Kim Jong-un
豪萨语	Hausa
闽语	Min (språk)
莆仙语	Puxian
徐汇区	Xuhui
江西省	Jiangxi
纳姆耶尔·旺楚克 (不丹国王)	Jigme Khesar Namgyel Wangchuck
阮明哲	Nguyen Minh Triet
宁夏回族自治区	Ningxia
拿督阿都拉萨	Najib Tun Razak
吉格梅·廷礼	Jigme Thinley
约翰·菲利普·凯伊	John Key
宿迁市	Suqian
扬州市	Yangzhou
泰州	Taizhou (Jiangsu)
南通	Nantong
镇江市	Zhenjiang
常州市	Changzhou
嘉兴市	Jiaxing
金华市	Jinhua
衢州	Quzhou (Zhejiang)
台州市	Taizhou (Zhejiang)
舟山市	Zhoushan
迪斯科	Disco
沧浪区	Canglang
阉	Kastrasjon
以色列国防军	Israels forsvar
寿春机场	Sao Vang lufthavn
嘟嘟車	Autorickshaw
海蒂·克鲁姆	Heidi Klum
拉吉倪甘斯	Rajinikanth
阿拉伯文数字	Øst-arabiske tall
空军	Flyvåpen
周庄镇 (昆山)	Zhouzhuang
大名	Daimyō
太仓	Taicang
劳莱士表	Rolex
数码照相机	Digitalkamera
数词	Tallord
哈里发	Kalif
汇率	Valutakurs
青森县	Aomori (prefektur)
福岛县	Fukushima (prefektur)
梁思成	Liang Sicheng
青蛙	Rana (slekt)
海防市	Haiphong
斯堪的纳维亚半岛	Den skandinaviske halvøy
里尔克	Rainer Maria Rilke
排列组合	Kombinatorikk
鲍林标度	Elektronegativitet
街道	Gate
机器翻译	Maskinoversettelse
阿根廷国家足球队	Argentinas herrelandslag i fotball
面向对象程式编制	Objektorientert programmering
千叶县	Chiba (prefektur)
定积分	Integral (matematikk)
故宫	Den forbudte by
泰米尔猛虎解放组织	Tamiltigrene
印度卢比	Indisk rupi
Microsoft Outlook	Microsoft Office Outlook
早饭	Frokost
自动银行出纳机	Minibank
秋田县	Akita (prefektur)
乌克兰元	Ukrainsk hryvnja
Ségolène Royal	Ségolène Royal
通用汽车	General Motors Corporation
差头	Drosje
乌赛	Region
拿塔莎 康埔西	Natascha Kampusch
新浪微博	Sina Weibo
模板:Cite book	Mal:Kilde bok
香农 (计算数学家)	Claude Elwood Shannon
宝莱坞	Bollywood
三角函数	Trigonometriske funksjoner
2009年甲型H1N1流感疫情	Influensa A(H1N1)-pandemien 2009
草	Ugress
文瑾莹	Moon Geun-young
2004年欧洲足球冠军赛	EM i fotball 2004
严重急性呼吸道综合症	SARS
Flickr	Flickr
John C. Mather	John C. Mather
索尔·珀尔马特	Saul Perlmutter
俞正声	Yu Zhengsheng
克里米亚鞑靼人	Krim-tatarer
伊斯兰圣战组织 (巴勒斯坦)	Islamsk jihad
爱媛县	Ehime (prefektur)
圣灰星期三	Askeonsdag
邻舍	Strøk
沙地	Steppe
鸡窠生凤凰 (电影)	Slumdog Millionaire – Han som hadde svar på alt
浦东新区	Pudong
天坛	Himmelens tempel
外滩	The Bund
山形县	Yamagata (prefektur)
基呒湖	Kivusjøen
台湾海峡	Taiwanstredet
神奈川县	Kanagawa (prefektur)
中国地区	Chūgokuregionen
长野县	Nagano (prefektur)
埼玉县	Saitama (prefektur)
英属印度	Britisk India
法国高速铁路	TGV
Ϝ	Digamma
群马县	Gunma (prefektur)
Ϙ	Qoppa
Hugh Jackman	Hugh Jackman
兵库县	Hyōgo (prefektur)
2004年东南亚大地震搭海啸	Jordskjelvet og tsunamien i Indiahavet 2004
安娜·库妮可娃	Anna Kurnikova
天线	Antenne
泰国湾	Siambukten
2000年欧洲足球冠军赛	EM i fotball 2000
Ϛ	Stigma (bokstav)
兵房	Kaserne
石川县	Ishikawa (prefektur)
妓院	Bordell
国际单位制词头	SI-prefiks
静冈县	Shizuoka (prefektur)
对话	Dialog
Ͳ	Sampi
农民	Bonde
葡蛮郎	Bumerang
渧拉米酥	Tiramisù
Ϻ	San (bokstav)
毛巾	Håndkle
春节	Kinesisk nyttår
麻生太郎	Taro Aso
弥撒	Messe (katolsk)
Naomi Watts	Naomi Watts
座头鲸	Knølhval
冈山县	Okayama (prefektur)
赌场	Kasino
撒旦教	Satanisme
农历	Den kinesiske kalender
克罗地亚国家足球队	Kroatias herrelandslag i fotball
巴尔喀什湖	Balkhasjsjøen
丹尼·波尔	Danny Boyle
泰国旗	Thailands flagg
希腊国家足球队	Hellas' herrelandslag i fotball
峨眉山	Emei Shan
Zip	ZIP
冰壶	Curling
台南市	Tainan
太湖	Tai Hu
研究生	Doktorand
针	Synål
加合拉·孛何妮	Carla Bruni
北仑区	Beilun
袁枚	Yuan Mei
魔幻现实主义	Magisk realisme
潘玉良	Pan Yuliang
义和团	Bokseropprøret
李芙妮	Tzipi Livni
列宁搿拉德围城搭仔保卫战	Beleiringen av Leningrad
1988年欧洲足球冠军赛	EM i fotball 1988
皇家夜总会 (电影)	Casino Royale (2006)
薯条	Pommes frites
吉赛尔·邦臣	Gisele Bündchen
塔塔拿挪	Tata Nano
特强气旋风暴纳尔吉斯	Syklonen Nargis
2008年希腊街头骚乱	Opptøyene i Hellas 2008
半岛战争	Den spanske selvstendighetskrigen
丽水县	Le Thuy
英国电视电影艺术学院奖	BAFTA
毛纳洛火山	Mauna Loa
荷兰东印度公司	Det nederlandske Ostindiske kompani
富牌国际机场	Phu Bai internasjonale lufthavn
斷背山	Brokeback Mountain
雀巢公司	Nestlé
环球小姐	Miss Universe
1992年欧洲足球冠军赛	EM i fotball 1992
奥斯区亚国家足球队	Østerrikes herrelandslag i fotball
伦敦德里城	Londonderry
新干线	Shinkansen
达新	Thaksin Shinawatra
Olga Kurylenko	Olga Kurylenko
瑞士国家足球队	Sveits' herrelandslag i fotball
金泳三	Kim Young-sam
星海爭霸	StarCraft
波兰国家足球队	Polens herrelandslag i fotball
祖父母	Besteforeldre
环球影视城	Universal Studios
罗马尼亚国家足球队	Romanias herrelandslag i fotball
唐宁街10号	Downing Street 10
小仲马	Alexandre Dumas den yngre
芹苴机场	Cần Thơ internasjonale lufthavn
罗杰·科恩伯格	Roger D. Kornberg
2008年末─2009年初加沙地带大规模军事行动	Gaza-krigen
利息	Rente
直接民主制	Direkte demokrati
橡胶擦子	Viskelær
幽老猫	Gjemsel
萨丽	Sari (klesplagg)
1960年欧洲足球国家杯	EM i fotball 1960
几何原本	Euklids Elementer
数码信号处理	Digital signalbehandling
木版画	Tresnitt
世界小姐	Miss World
长沙市	Changsha
阿披实	Abhisit Vejjajiva
越南国家航空公司	Vietnam Airlines
伦敦政治经济学院	London School of Economics
油画	Oljemaling
Portal:历史	Portal:Historie
泥石流	Slamstrøm
洲际弹道飞弹	Interkontinentale ballistiske missiler
物流	Logistikk
遗传转录	Transkripsjon (genetikk)
繁体字	Tradisjonell kinesisk
宦官	Evnukk
虱误	Programvarefeil
阿歷克山德拉·柯倫泰	Aleksandra Kollontaj
George F. Smoot	George F. Smoot
Ϸ	Sjo
酋长航空公司	Emirates
1996年欧洲足球冠军赛	EM i fotball 1996
消费者物价指数	Konsumprisindeks
国际足球联合会世界排名表	FIFAs verdensranking
卡本塔里亚湾	Carpentariabukta
超级市场	Supermarked
章子怡	Zhang Ziyi
Heineken	Heineken
威尔士国家足球队	Wales' herrelandslag i fotball
千分比	Promille
高雄市	Kaohsiung
病人	Pasient
1980年欧洲足球冠军赛	EM i fotball 1980
1968年欧洲足球冠军赛	EM i fotball 1968
1964年欧洲足球国家杯	EM i fotball 1964
印第安纳琼斯 —— 水晶骷髅王国	Indiana Jones og krystallhodeskallens rike
1972年欧洲足球冠军赛	EM i fotball 1972
Bayes定理	Bayes' teorem
美人魚	Havfrue
普吉府	Phuket (provins)
1984年欧洲足球冠军赛	EM i fotball 1984
亚历山大	Alexandria (andre betydninger)
昆明	Kunming
老呒所依	No Country for Old Men
东京铁塔	Tokyo Tower
兰州市	Lanzhou
佛來崮	Le Puy-en-Velay
头趟公开募股	Børsnotering
羅迪尼亞	Rodinia
欧里维娅	Olivia Newton-John
Knol	Knol
Ͱ	Heta
法国航空447号班机	Air France Flight 447
共享软件	Shareware
简化字	Forenklet kinesisk
Mike Myers	Mike Myers
薄拉特 (电影)	Borat: Cultural Learnings of America for Make Benefit Glorious Nation of Kazakhstan
張勉	Chang Myon
耳機	Hodetelefoner
利库德党	Likud
洛阳	Luoyang
淞河	Saône
1976年欧洲足球冠军赛	EM i fotball 1976
平昌郡	Pyeongchang
亚洲开发银行	Den asiatiske utviklingsbanken
矮马	Ponni
匈奴编年史	Xiongnu
孟子	Mencius
帝国理工	Imperial College London
曾国藩	Zeng Guofan
卫生	Folkehelse
桂林	Guilin
雪兰莪州	Selangor
海口市	Haikou
挪威广播公司	NRK
第一趟鸦片战争	Første opiumkrig
声调	Tonespråk
基督山伯爵	Greven av Monte Cristo
玛丽女王2号	RMS «Queen Mary 2»
尹潽善	Yun Bo-seon
伊顿公学	Eton College
越盾	Vietnamesisk dong
解剖学治疗学及化学分类系统	Anatomisk terapeutisk kjemisk klassifikasjon
尹致昊	Yun Chi-ho
终结者3	Terminator 3: Rise of the Machines
北卡罗莱纳大学教堂山分校	University of North Carolina at Chapel Hill
我有一只梦	I Have a Dream
上海世博会	Expo 2010
梦工厂	DreamWorks
谢列梅捷沃国际机场	Sjeremetjevo internasjonale lufthavn
麵	Nudler
瑞联银行	UBS
观世音	Avalokitesvara
新曼谷国际机场	Suvarnabhumi lufthavn
闸北区	Zhabei
张爱玲	Zhang Ailing
章太炎	Zhang Binglin
张道陵	Zhang Daoling
张居正	Zhang Juzheng
张家港	Zhangjiagang
浙江大学	Zhejianguniversitetet
郑洁	Zheng Jie
正阳门	Qianmen
镇海区	Zhenhai
月饼	Månekake
周迅	Zhou Xun
诸暨	Zhuji
株洲市	Zhuzhou
壯學	Zhuangologi
中国人民解放军	Folkets Frigjøringshær
辛格·旺楚克 (不丹国王)	Jigme Singye Wangchuck av Bhutan
利尿药	Diuretikum
毕升	Bi Sheng
华南虎	Sørkinatiger
巴黎大区高速铁路C线	RER C
精神疾病诊断搭仔统计手冊	Diagnostic and Statistical Manual of Mental Disorders
米尔克 (电影)	Milk
高棉帝国	Khmerriket
狙击手	Skarpskytter
鼻衄	Neseblod
开脱•文斯莱脱	Kate Winslet
平均	Gjennomsnitt
富国机场	Phu Quoc lufthavn
李商隐	Li Shangyin
曹操	Cao Cao
火山湖	Kratersjø
水粉画	Gouache
拨人忽视个真相	En ubehagelig sannhet
Isaac Hayes	Isaac Hayes
春武里府	Chonburi (provins)
武夷山	Wuyishan
塔麻可吉电子小鸡	Tamagotchi
泰王国国歌	Phleng Chat
二氧化氮	Nitrogendioksid
冬至	Vintersolverv
风月俏佳人	Pretty Woman
新台币	Taiwansk dollar
混成词	Teleskopord
法国省份一览表	Frankrikes provinser
袁世凯	Yuan Shikai
袋鼠岛	Kenguruøya
泰拉 蕾	Tara Reid
氯化氢	Hydrogenklorid
刘翔	Liu Xiang (hekkeløper)
蒙古人民共和国	Folkerepublikken Mongolia
DTD	Document Type Definition
开脱•末斯	Kate Moss
娜塔莎·李察遜	Natasha Richardson
三聚氰胺	Melamin
高隆皮亚国家足球队	Colombias herrelandslag i fotball
莫尼卡-莱温斯基	Monica Lewinsky
雷曼兄弟公司	Lehman Brothers
大使馆	Utenriksstasjon
金奎植	Kim Kyu-sik
IPod Shuffle	IPod shuffle
泼水节	Songkran
7-Zip	7-Zip
洋油盏	Parafinlampe
南沙群岛	Spratlyøyene
湘潭市	Xiangtan
费加罗报 (法国)	Le Figaro
垃圾桶	Søppelspann
泻药	Avføringsmiddel
海龜	Havskilpadder
老鼠会	Ponzi-svindel
赌城风云 (电影)	Casino (film)
化学品登记、评估、准许搭限制法规	Kjemikalieregelverket REACH
ISO/IEC 8859	ISO 8859
关公	Guan Yu
龟	Skilpadder
东方明珠	Fjernsynstårnet Østens Perle
国际足联世界冠军俱乐部杯赛	VM i fotball for klubblag
卢旺达旅馆	Hotel Rwanda
重见日头 (1996年电影)	Dagslys (film)
Isla Fisher	Isla Fisher
石泰凡妮 莱斯	Stephanie Rice
印度空间研究组织	Indian Space Research Organisation
酱油	Soyasaus
新山	Johor Bahru
MT	MT
国富论	Nasjonenes velstand
清迈府	Chiang Mai (provins)
蔡英文	Tsai Ing-wen
宋卡府	Songkhla (provins)
平年	Normalår
玫瑰人生 (2007年电影)	La Vie en Rose
沙吞府	Satun (provins)
泰文字母表	Thai-skrift
清莱府	Chiang Rai (provins)
拉廊府	Ranong (provins)
披集府	Phichit (provins)
We Are the Champions	We Are the Champions
九龙	Kowloon
末尔悬岩	Cliffs of Moher
北榄坡府	Nakhon Sawan (provins)
碧差汶府	Phetchabun (provins)
普吉国际机场	Phuket internasjonale lufthavn
陈艳青	Chen Yanqing
2008年欧洲足球冠军赛	EM i fotball 2008
五代十国	De fem dynastiers og ti kongedømmers tid
索马里内战	Den somaliske borgerkrig
金砖国家	BRICS
安纳乍能府	Amnat Charoen (provins)
董里府	Trang (provins)
博他仑府	Phattalung (provins)
纳戈尔诺-卡拉巴赫	Republikken Nagorno-Karabakh
血色将至	There Will Be Blood
乌泰他尼府	Uthai Thani (provins)
臺中市	Taichung
他拉嘞共 (维克多利亚)	Traralgon (Victoria)
堂前	Citang
和谐社会	Det sosialistiske harmoniske samfunn
新竹市	Hsinchu
鹅	Tamgås
年号	Kinesiske æranavn
高丽航空	Air Koryo
环球银行金融电信协会	Society for Worldwide Interbank Financial Telecommunication
Motorola	Motorola
欧洲足球冠军赛	Europamesterskapet i fotball
汽水	Kullsyreholdig vann
天狼星号油轮	MT «Sirius Star»
三沙市	Sansha
保合多伽勒国家足球队	Portugals herrelandslag i fotball
苏梅岛	Ko Samui
爱尔兰镑	Irsk pund
陈冯富珍	Margaret Chan
Lauren Jackson	Lauren Jackson
安娜 米亚里斯	Anna Meares
Prapawadee Jaroenrattanatarakoon	Prapawadee Jaroenrattanatarakoon
邓亚萍	Deng Yaping
里斯班斯 齐凯脱	Lisbeth Trickett
西跋榭滴	Shilpa Shetty
石泰凡妮 孛朗	Stephanie Brown Trafton
Melissa Etheridge	Melissa Etheridge
陈冲	Joan Chen
林心如	Ruby Lin
陈若琳 (运动员)	Chen Ruolin
Pamela Jelimo	Pamela Jelimo
挪威公主阿斯特丽德	Astrid, fru Ferner
莱索尔 强斯	Leisel Jones
汤唯	Tang Wei
郭晶晶	Guo Jingjing
陈燮霞	Chen Xiexia
沙没巴干府	Samut Prakan (provins)
呵叻府	Nakhon Ratchasima (provins)
生个利亚酒	Sangria
浮罗交怡	Langkawi
攀牙府	Phang Nga (provins)
馅饼统计图	Sektordiagram
早稻田大学	Wasedauniversitetet
吴 (三国)	Østre Wu
氯霉素	Kloramfenikol
猜也贲府	Chaiyaphum (provins)
马肖·米切姆	Matthew Mitcham
耶莲娜	Jelena Dokić
海宁市	Haining
硫酸镁	Magnesiumsulfat
澳大利亚搭新西兰军团纪念日	ANZAC-dagen
ANZ大球场	ANZ Stadium
杨玉环	Yang Guifei
奥特莱•导都	Audrey Tautou
周星驰	Stephen Chow
多尼尔228	Fairchild Dornier 228
孙权	Sun Quan
蒋经国	Chiang Ching-kuo
墨尔本胜利	Melbourne Victory FC
神舟七号飞船	Shenzhou 7
鬼勒耳朵边头讲	Ghost Whisperer
Grant George Hackett	Grant Hackett
韩愈	Han Yu
梁朝伟	Tony Leung Chiu Wai
丁俊晖	Ding Junhui
王安石	Wang Anshi
投资银行	Investeringsbank
阿宾拿夫 宾德拉	Abhinav Bindra
巴真府	Prachinburi (provins)
精工表	Seiko
杭州灣大橋	Hangzhoubuktbroen
武里喃府	Buriram (provins)
坤敬府	Khon Kaen (provins)
德国无线通信	T-Mobile
廊开府	Nong Khai (provins)
日本中央银行	Japans bank
李自成	Li Zicheng
哈桑式火箭弹	Qassam-rakett
林语堂	Lin Yutang
朴憲永	Park Hon-young
金枓捧	Kim Du-bong
龙仔厝府	Samut Sakhon (provins)
信武里府	Sing Buri (provins)
包拯	Bao Zheng
武昌起义	Wuchangopprøret
镐立 (泰国)	Khao Lak
阿德来德联队	Adelaide United FC
芜湖市	Wuhu
安庆市	Anqing
亳州市	Bozhou
上饶	Shangrao
冯玉祥	Feng Yuxiang
2007年加沙地带争夺战	Slaget på Gazastripen i 2007
拗廊 (泰国)	Ao Nang
新兴工业国家	Nylig industrialiserte land
李鸿章	Li Hongzhang
中秋节	Månefesten
元均	Won Gyun
邓散木	Deng Sanmu
以蒙 苏里房	Eamon Sullivan
雷锋	Lei Feng
梁启超	Liang Qichao
多尔衮	Dorgon
素可泰府	Sukhothai (provins)
彭德怀	Peng Dehuai
依善	Isan
紫峰大厦	Greenland Square Zifeng Tower
姚文元	Yao Wenyuan
宁国	Ningguo
Khao Yai National Park	Khao Yai nasjonalpark
斯瓦特县	Swat (Pakistan)
悉尼晨锋报	The Sydney Morning Herald
静安寺	Jing'antempelet
金牌	Gullmedalje
亚洲航空	AirAsia
徐光启	Xu Guangqi
喹诺酮	Quinoloner
靖江	Jingjiang
通州	Tongzhou
Моа	Moafugler
1976年河北唐山大地震	Jordskjelvet i Tangshan 1976
上海地铁	Shanghai Metro
以色列空军	Israels luftforsvar
玩转身前事	Nå eller aldri (film)
秋瑾	Qiu Jin
崇礼门	Namdaemun
伍丽群	Melissa Wu
阿嘞伽莎拉	Ruqaya Al Ghasara
嫦娥	Chang'e
Liudmila Blonska	Ljudmila Blonska
吴三桂	Wu Sangui
孙休	Sun Xiu
許政	Heo Jeong
孙皓	Sun Hao
孙亮	Sun Liang
宋吉 (拳手)	Somjit Jongjohor
韩寒	Han Han
滑水	Vannski
亚罗士打	Alor Setar
棕榈山 (泰国)	Khao Kho
國際馬術聯合會	Fédération équestre internationale
新山一国际机场	Tan Son Nhat internasjonale lufthavn
宏碁电脑	Acer
运动场	Stadion
朝鲜半岛	Koreahalvøya
圣保罗地铁	São Paulos undergrunnsbane
亚运会	Asialekene
捷克国家足球队	Tsjekkias herrelandslag i fotball
朝鲜族	Koreanere
吕克·贝松	Luc Besson
萨尔浒之战	Slaget ved Sarhu
傲游浏览器	Maxthon
金庾信	Kim Yu-sin
武烈王	Muyeol av Silla
文武王	Munmu av Silla
复旦大学	Fudanuniversitetet
仁川地铁	Incheons undergrunnsbane
六方会谈	Sekspartsforhandlingene
金润玉	Kim Yoon-ok
班地戈 (维克多利亚)	Bendigo
朝鲜核问题	Nord-Koreas atom- og rakettprogram
韩国放送公社	Korean Broadcasting System
莎阿南	Shah Alam
玉山	Yushan (fjell)
雜合子	Heterozygot
西湖	Xihu
大屿山	Lantau
60秒惊天动地	Gone in 60 seconds
伊斯兰祈愿团	Jemaah Islamiyah
Andry Laffita	Andry Laffita
中庸	Zhong yong
温岭	Wenling
上海交通大學	Jiaotonguniversitetet i Shanghai
卡卡	Kaká
南印度	Sør-India
柏林宣言	Berlin-erklæringen
安吉	Anji
视力	Visus (synsskarphet)
徐志摩	Xu Zhimo
趙元任	Yuen Ren Chao
蒙古简介	Det mongolske platå
沈约	Shen Yue
巴彦淖尔	Bayan Nur
抗糖尿病药	Antidiabetika
岳庙	Yue Fei-tempelet
南京路	Nanjing Lu
意大利杂菜汤	Minestronesuppe
咳嗽药	Hostemedisin
萧山	Xiaoshan
醴陵市	Liling
奠边府战役	Slaget ved Dien Bien Phu
如东	Rudong
法拉备拉矮马	Falabella
甲米机场	Krabi lufthavn
西非国家中央银行	Sentralbanken for de vestafrikanske statene
依夫城堡	Château d'If
皮蛋	Tusenårsegg
庐山	Lushan (fjell)
必和必拓矿业公司	BHP Billiton
零假设	Nullhypotese
世纪报	The Age
饺子	Jiaozi (matrett)
乃米湖	Lago di Nemi
黄浦区	Huangpu (Shanghai)
长宁区	Changning (Shanghai)
广州地铁	Guangzhou Metro
静安区	Jing'an (Shanghai)
普陀区 (上海)	Putuo (Shanghai)
虹口区	Hongkou
杨浦区	Yangpu
闵行区	Minhang
宝山区 (上海)	Baoshan (Shanghai)
嘉定区	Jiading
金山区 (上海市)	Jinshan
松江区	Songjiang (Shanghai)
青浦区	Qingpu (Shanghai)
奉贤区	Fengxian
性旅游者	Sexturisme
卡里平	Karibia
教堂山 (北卡罗来纳州)	Chapel Hill (Nord-Carolina)
启德机场	Kai Tak lufthavn
昆剧	Kunqu
意大利国家足球队	Italias herrelandslag i fotball
国际先驱论坛报	International Herald Tribune
流亡政府	Eksilregjering
海门市	Haimen
南京大學	Nanjinguniversitetet
輔仁大學	Fu Jen katolske universitet
鹰式教练机	BAE Hawk
搿连搭罗格 (爱尔兰)	Glendalough
快门	Lukker
白朗	Blaupunkt
Shooting Dogs	Shooting Dogs
谥号	Posthumt navn
吴佩孚	Wu Peifu
吴敬梓	Wu Jingzi
四庫全書	Siku Quanshu
杭州湾	Hangzhoubukten
魏忠贤	Wei Zhongxian
市区	Tettsted
小笼馒头	Xiaolongbao
张士诚	Zhang Shicheng
段祺瑞	Duan Qirui
中法战争	Den fransk-kinesiske krig
庙号	Tempelnavn
潘迪华	Rebecca Pan
汤恩伯	Tang Enbo
清云科技大学	Ching Yun-universitetet
陈仪	Chen Yi (Kuomintang)
启东	Qidong (Nantong)
奉化市	Fenghua
西德	Vest-Tyskland
陈良宇	Chen Liangyu
春卷	Vårrull
袁崇焕	Yuan Chonghuan
张献忠	Zhang Xianzhong
李金华	Li Jinhua
攀牙湾	Phang Nga-bukten
中华大学	Chung Hua-universitetet
鲸体爆炸事件	Eksploderende hval
金坛	Jintan
上海申花足球俱乐部	Shanghai Greenland FC
俄罗斯国家足球队	Russlands herrelandslag i fotball
蓝天处女	Virgin Australia
現代標準漢語	Standard kinesisk
薛福成	Xue Fucheng
圆仁	Ennin
中国国家图书馆	Det kinesiske nasjonalbibliotek
大漠孤雄 (电影)	Mongol – Den unge Djengis Khan
墨尔本机场。	Melbourne lufthavn, Tullamarine
TCL集团	TCL Corporation
西昌卫星发射中心	Xichang satellittutskytningssenter
2008年欧洲足球冠军赛资格赛C组	Kvalifisering til EM i fotball 2008, gruppe C
鲁国	Lu (stat)
巴黎大区高速铁路A线	RER A
泰国人妖	Kathoey
凯山丰威汉市	Savannakhet
克里米亚共和国	Den autonome republikken Krim
暖武里市	Nonthaburi
亭曼岛	Tioman
岘港国际机场	Da Nang internasjonale lufthavn
共同語	Koinéspråk
崇明县	Chongming
宋卡市	Songkhla
挽甲必区	Bang Kapi
马来西亚国家银行	Malaysias sentralbank
赞比亚国家银行	Zambias bank
北塘区	Beitang
黑人	Svart (hudfarge)
五公祠	De fem embedsmenns tempel
码头	Kai (sjøfart)
富通银行	Fortis (finans)
秦淮河	Qinhuai He
远古侵略	Primeval
韶山市	Shaoshan
傣族	Dai (folk)
普吉市	Phuket (by)
F-15雷暴式战斗机	Boeing F-15 Strike Eagle
國際語音學學會	International Phonetic Association
越捷航空	VietJet Air
巴乃到乃	Panettone
拉玛九世	Bhumibol Adulyadej
外国口音综合症	Utenlandsk aksent-syndrom
科索沃宣布独立事件（2008年）	Kosovos andre uavhengighetserklæring
公主	Prinsesse
滨湖区	Binhu
南翔镇	Nanxiang
阴蒂	Klitoris
胡志明纪念堂	Ho Chi Minh-mausoleet
天主教上海教区	Shanghai bispedømme
坤敬市	Khon Kaen
粥	Congee
巴亭郡	Ba Dinh
2006年印度孟买火车大爆炸	Terrorangrepet i Mumbai juli 2006
金瓯机场	Ca Mau lufthavn
叶麂	Løvhjort
2009年以色列国会大选	Valget i Israel 2009
吴国	Wu (stat)
帮助:目录	Hjelp:Portal
Wikipedia:Tutorial	Wikipedia:Veiledning
澳洲电信大球场	Docklands Stadium
澎湖列岛	Pescadores
申報	Shen Bao
龙游县	Longyou
支气管扩张剂	Bronkodilatator
Cha Am	Cha-am
京津城际铁路	Beijing–Tianjin Intercitybane
琼语	Hainanesisk
弗林德斯岛 (塔斯曼尼亚)	Flinders Island
伐拉古嘞 (维克多利亚)	Warragul (Victoria)
吴中区	Wuzhong (Suzhou)
印度储备银行	Indias sentralbank
河姆渡文化	Hemudukulturen
皇家铸币局	Royal Mint
阿根廷，勿要为奴哭泣	Don't Cry for Me Argentina
福布斯	Forbes
翁同龢	Weng Tonghe
上海道	Shanghai daotai
相城区	Xiangcheng (Suzhou)
猜也奔	Chaiyaphum
草原	Gresslette
金球奖	Golden Globe
比拉伊	Piraí
宜兴市	Yixing
维克多港	Victor Harbor
常熟	Changshu
江阴	Jiangyin
卢湾区	Luwan
乍都节区	Chatuchak
常州言话	Changzhouhua
琼山	Qiongshan
天长	Tianchang
如皋市	Rugao
江山市	Jiangshan
浏阳市	Liuyang
海曙区	Haishu
同里镇	Tongli
新昌	Xinchang (Shaoxing)
吴兴区	Wuxing
新都区	Xindu
龙虾	Hummere
龚自珍	Gong Zizhen
常山县	Changshan
南京中国近代史遗址博物馆	Presidentpalasset i Nanjing
宋国	Song (stat)
泰鸟航空公司	Nok Air
后羿	Houyi
2008年欧洲足球冠军赛资格赛A组	Kvalifisering til EM i fotball 2008, gruppe A
2008年欧洲足球冠军赛资格赛E组	Kvalifisering til EM i fotball 2008, gruppe E
龙井茶	Longjing-te
越南南方共和国	Republikken Sør-Vietnam
西汉	Det vestlige Han-dynasti
中国国家博物馆	Det kinesiske nasjonalmuseum
百万富豪	Millionær
崇安区	Chong'an
崇川区	Chongchuan
2008年欧洲足球冠军赛资格赛B组	Kvalifisering til EM i fotball 2008, gruppe B
手写体	Håndskrift
武汉大学	Wuhanuniversitetet
库克船长个小房子	Cooks' Cottage
迪拜大商场	Dubai Mall
婚礼歌手	Bryllupssangeren
异食癖	Picasyndromet
本田爵士 (汽车)	Honda Jazz
盛宣怀	Sheng Xuanhuai
越国	Yue (stat)
1887年个黄河大水灾	Oversvømmelsen av Guleelven i 1887
科廷科技大学	Curtin University
天台山 (浙江)	Tiantaifjellet
子思	Zisi
2008年欧洲足球冠军赛资格赛G组	Kvalifisering til EM i fotball 2008, gruppe G
2008年欧洲足球冠军赛资格赛F组	Kvalifisering til EM i fotball 2008, gruppe F
2008年欧洲足球冠军赛资格赛D组	Kvalifisering til EM i fotball 2008, gruppe D
孛相	Lek
1931年个江淮大水	Oversvømmelsene i Kina 1931
泾县	Jing (Xuancheng)
惠山区	Huishan
西施	Xi Shi
岱山县	Daishan
当涂县	Dangtu
梅林	Merlin (TV-serie)
粤文维基百科	Wikipedia på kantonesisk
长江三角洲	Yangtzeflodens delta
杭州萧山国际机场	Hangzhou Xiaoshan internasjonale lufthavn
繁昌县	Fanchang
全椒县	Quanjiao
郎溪	Langxi
广德	Guangde
无为县	Wuwei (Wuhu)
良渚文化	Liangzhukulturen
湘乡市	Xiangxiang
定海区	Dinghai
廊曼区	Don Mueang
机场	Flyplass
世界大桥长度排名	Liste over broer i verden etter lengde
南汇区	Nanhui
夫差	Fu Chai
阖闾	Helü av Wu
土星运载火箭	Saturn-rakett
乔石	Qiao Shi
井冈山	Jinggangshan
汉服	Hanfu
南潯區	Nanxun
南湖区	Nanhu
嵊泗縣	Shengsi
衢江区	Qujiang (Quzhou)
衡山县	Hengshan (Hengyang)
Nowra (新南威尔士)	Nowra (New South Wales)
平江区	Pingjiang (Suzhou)
金阊区	Jinchang (Suzhou)
上海大学	Shanghaiuniversitetet
通州市	Tongzhou (Nantong)
港闸区	Gangzha
巴黎大区高速铁路B线	RER B
富劳里友半岛	Fleurieu-halvøya
江南	Jiangnan
开县	Kai (Chongqing)
扬中市	Yangzhong
锡山区	Xishan (Wuxi)
开化县	Kaihua
吴江区	Wujiang (Suzhou)
海安县	Hai'an (Nantong)
玉环县	Yuhuan
柯城区	Kecheng
路桥	Luqiao
南长区	Nanchang (Wuxi)
宁乡县	Ningxiang
湘潭县	Xiangtan (Xiangtan)
荣毅仁	Rong Yiren
法朗 (泰语)	Farang
Simon Crean	Simon Crean
空堤区 (曼谷)	Khlong Toei
分类:德国	Kategori:Tyskland
分类:意大利	Kategori:Italia
分类:美国	Kategori:USA
分类:俄罗斯	Kategori:Russland
分类:英国	Kategori:Storbritannia
分类:西班牙	Kategori:Spania
分类:中国	Kategori:Kina
分类:日本	Kategori:Japan
分类:澳大利亚	Kategori:Australia
分类:墨西哥	Kategori:Mexico
分类:印度	Kategori:India
分类:阿根廷	Kategori:Argentina
门牌号码	Husnummer
富国国际机场	Phu Quoc internasjonale lufthavn
巴黎大区高速铁路D线	RER D
分类:印度尼西亚	Kategori:Indonesia
分类:乃特朗特	Kategori:Nederland
分类:新加坡	Kategori:Singapore
分类:韩国	Kategori:Sør-Korea
分类:泰国	Kategori:Thailand
分类:越南	Kategori:Vietnam
分类:哺乳动物	Kategori:Pattedyr
分类:植物	Kategori:Planter
分类:物理	Kategori:Fysikk
分类:生物学	Kategori:Biologi
分类:化学	Kategori:Kjemi
分类:历史	Kategori:Historie
分类:地理	Kategori:Geografi
分类:社会	Kategori:Samfunn
分类:宗教	Kategori:Religion
分类:体育运动	Kategori:Sport
分类:科学	Kategori:Vitenskap
分类:电影	Kategori:Film
分类:建筑物	Kategori:Byggverk
拉脱卜大学	La Trobe University
韓國 (戰國)	Han (stat)
IPCC第4趟评价报告书	IPCCs fjerde hovedrapport
苏州中学	Suzhou Zhongxue
苏州大学	Suzhouuniversitetet (Suzhou)
幸福航空	Joy Air
宋卡湖	Songkhlasjøen
舟山岛	Zhoushanøya
英国火车事故列表	Liste over togulykker i Storbritannia
樟宜	Changi
巴士底獄	Bastillen
泰国足球联赛	Thailands toppserie i fotball
七宝镇	Qibao
赵古泥	Zhao Guni
民武里区	Min Buri
分类:消歧义	Kategori:Pekere
分类:佛教	Kategori:Buddhisme
分类:基督教	Kategori:Kristendom
分类:伊斯兰教	Kategori:Islam
华东师范大学	East China Normal University
岳麓书院	Yueluakademiet
运动员	Atlet
表字	Stilnavn
Poise	Poise
外白渡桥	Waibaidubroen
罗津	Rajin
江淮官话	Jianghuaimandarin
吴	Wu
女阴	Vulva
妙蛙花	Venusaur
吞武里区	Thonburi
无锡言话	Wuxihua
新挪威语维基百科	Wikipedia på nynorsk
Bochotnica	Bochotnica
2008年丹麦驻巴基斯坦大使馆爆炸	Terrorangrepet i Islamabad 2. juni 2008
紫砂壶	Yixing-leire
隆宾尼拳场	Lumpini stadion
2005年安曼炸弹爆炸	Terrorangrepet i Amman i 2005
正一派	Zhengyi
淀山湖	Dianshansjøen
分类:未完个文章	Kategori:Stubber
分类:文化	Kategori:Kultur
分类:大洲	Kategori:Kontinenter
分类:地质学	Kategori:Geologi
Wikipedia:Selected anniversaries	Wikipedia:Hendelser
Wikipedia:命名常规	Wikipedia:Navnekonvensjoner
卡拉姆山谷	Kalamdalen
Behrain	Bahrein
淮海路	Huaihai Lu
Portal:地理	Portal:Geografi
胡温	Hu–Wen-administrasjonen
粵汉铁路	Yuehanjernbanen
春运	Chunyun
可口可乐公司	The Coca-Cola Company
吴越地区	Wu (region)
2008年印度艾哈迈德堡炸弹爆炸	Terrorangrepene i Ahmedabad 26. juli 2008
2008年夏天中国地区性发大水	Flommen i Kina 2008
Wikipedia:Transclusion	Wikipedia:Transklusjon
Wikipedia:HotCat	Wikipedia:HotCat
穹窿山	Qionglong Shan
菲兹洛伊花园	Fitzroy Gardens
Malcolm Page	Malcolm Page
2008年印度朋伽劳尔炸弹爆炸	Terrorangrepene i Bangalore 25. juli 2008
Elise Rechichi	Elise Rechichi
分类:维基百科机器人	Kategori:Boter
Portal:艺术	Portal:Kunst
分类:美国人	Kategori:Personer fra USA
分类:演员	Kategori:Skuespillere
分类:英国人	Kategori:Briter
分类:法国人	Kategori:Franskmenn
模板:Tl	Mal:Mal
模板:Userbox	Mal:Userbox
模板:Itn	Mal:Aktuelt
分类:自由软件	Kategori:Fri programvare
分类:国家	Kategori:Land
Wikipedia:Changing username	Wikipedia:Endring av brukernavn
Wikipedia:管理员	Wikipedia:Administratorer
分类:人物	Kategori:Personer
分类:职业	Kategori:Beskjeftigelser
分类:各行各业个人	Kategori:Personer etter beskjeftigelse
Wikipedia:机器人	Wikipedia:Roboter
分类:货币	Kategori:Penger
分类:工程學	Kategori:Ingeniørvitenskap
分类:医学	Kategori:Medisin
分类:政治	Kategori:Politikk
分类:教育	Kategori:Utdanning
分类:光学	Kategori:Optikk
分类:艺术	Kategori:Kunst
埃及	Egypt
Wikipedia:手傀儡	Wikipedia:Sokkedukker
Wikipedia:Categorization	Wikipedia:Kategorier
模板:Bot	Mal:Bot
加拿大	Canada
分类:倍尔奇姆	Kategori:Belgia
分类:捷克	Kategori:Tsjekkia
Wikipedia:版权	Wikipedia:Opphavsrett
Wikipedia:关于	Wikipedia:Om
分类:电子游戏	Kategori:Videospill
分类:游戏	Kategori:Spill
工业工程	Industriell økonomi
帮助:編輯摘要	Hjelp:Redigeringsforklaring
Portal:科学	Portal:Vitenskap
模板:Flagicon	Mal:Flagicon
分类:欧洲国家	Kategori:Land i Europa
分类:欧洲	Kategori:Europa
模板:Documentation	Mal:Dokumentasjon
Wikipedia:User access levels	Wikipedia:Brukertyper
分类:已保护页面	Kategori:Wikipedia beskyttede sider
Wikipedia:聊天频道	Wikipedia:Chat
分类:维基人	Kategori:Wikipedia-brukere
Wikipedia:社区门堂	Wikipedia:Portal
分类:User by languages	Kategori:Wikipedia-brukere etter språk
帮助:用词指南	Wikipedia:Unngå unnvikende uttrykk
模板:Soft redirect	Mal:Softredirect
模板:Delete	Mal:Hurtigsletting
分类:技术	Kategori:Teknologi
卫星天线	Parabolantenne
分类:言话	Kategori:Språk
分类:历法	Kategori:Kalendere
分类:维基百科	Kategori:Wikipedia
分类:各样言话个维基百科	Kategori:Språk på Wikipedia
分类:有无用文件链接个页	Kategori:Sider med brutte fillenker
分类:現在正發生個事體	Kategori:Pågående hendelser
分类:欧洲城市	Kategori:Byer i Europa
模板:-	Mal:-
模板:Navbox	Mal:Navboks
模板:Fact	Mal:Trenger referanse
分类:重定向	Kategori:Omdirigeringer
分类:維基百科維護	Kategori:Wikipedia-vedlikehold
分类:泰国网球运动员	Kategori:Thailandske tennisspillere
模板:Error	Mal:Feil
模板:!	Mal:!
模板:((	Mal:((
模板:))	Mal:))
模板:!!	Mal:!!
模板:=	Mal:=
模板:Tnavbar	Mal:Tnavbar
模板:Code	Mal:Kode
模板:0	Mal:0
模板:Unicode	Mal:Unicode
模板:Small	Mal:Small
模板:Clear	Mal:Clear
模板:Col-break	Mal:Col-break
模板:Col-begin	Mal:Col-begin
模板:Col-end	Mal:Col-end
模板:Nowrap	Mal:Nowrap
模板:Bots	Mal:Bots
Wikipedia:必有个页面	Wikipedia:Liste over artikler vi bør ha
分类:非洲	Kategori:Afrika
分类:數字	Kategori:Tall
分类:电子学	Kategori:Elektronikk
分类:书	Kategori:Bøker
模板:Wikisource	Mal:Wikisource
模板:Babel	Mal:Babel
模板:Commons	Mal:Commons
模板:Reflist	Mal:Referanser
Wikipedia:列明來源	Wikipedia:Bruk av kilder
模板:Stub	Mal:Stubb
模板:See also	Mal:Se også
模板:User de	Mal:Bruker de
模板:User de-1	Mal:Bruker de-1
模板:User es	Mal:Bruker es
模板:User de-3	Mal:Bruker de-3
模板:User en-3	Mal:Bruker en-3
模板:User en-1	Mal:Bruker en-1
模板:User en-2	Mal:Bruker en-2
模板:User en-4	Mal:Bruker en-4
模板:User en	Mal:Bruker en
模板:User de-2	Mal:Bruker de-2
模板:User es-1	Mal:Bruker es-1
模板:User fa	Mal:Bruker fa
模板:User fr-1	Mal:Bruker fr-1
分类:各国个文化	Kategori:Kultur etter område
模板:User ja-4	Mal:Bruker ja-4
模板:User sk	Mal:Bruker sk
模板:User fr-2	Mal:Bruker fr-2
模板:User ja	Mal:Bruker ja
模板:User ja-1	Mal:Bruker ja-1
模板:User it-1	Mal:Bruker it-1
模板:User fr	Mal:Bruker fr
模板:Unsigned	Mal:Usignert
分类:亚洲	Kategori:Asia
分类:智利	Kategori:Chile
分类:21世紀	Kategori:2000-tallet
分类:User uk	Kategori:Bruker uk
分类:南美洲	Kategori:Sør-Amerika
分类:User uk-N	Kategori:Bruker uk-N
模板:Intricate template	Mal:Komplisert mal
分类:马来西亚	Kategori:Malaysia
分类:食物	Kategori:Mat
分类:足球	Kategori:Fotball
模板:Mod	Mal:Mod
模板:User uk	Mal:Bruker uk
模板:User es-2	Mal:Bruker es-2
模板:WikipediaSister	Mal:Søsterprosjekt
分类:组织	Kategori:Organisasjoner
分类:语言学	Kategori:Lingvistikk
分类:鏈接模板	Kategori:Lenkemaler
分类:User fr-1	Kategori:Bruker fr-1
模板:Wikiquote	Mal:Wikiquote
模板:Image label	Mal:Image label
模板:Category handler	Mal:Category handler
模板:Translated page	Mal:Oversatt
模板:Ja icon	Mal:Ja icon
模板:Es icon	Mal:Es icon
模板:Ambox	Mal:Amboks
模板:Update	Mal:Trenger oppdatering
模板:Infobox School	Mal:Infoboks skole
模板:Nobel Prize in Physics	Mal:Nobelprisvinnere i fysikk
模板:Infobox Country	Mal:Infoboks land2
模板:Airline infobox	Mal:Infoboks flyselskap
模板:Wide image	Mal:Panoramabilde
模板:Px	Mal:Px
模板:Audio	Mal:Audio
模板:Flatlist	Mal:Flatlist
模板:Expand section	Mal:Seksjonstubb
模板:Tmbox	Mal:Tmbox
模板:清理	Mal:Opprydning
模板:Infobox university	Mal:Infoboks universitet
模板:Wikibooks	Mal:Wikibøker
模板:Hatnote	Mal:Dablink
模板:Redirect3	Mal:Omdirigering3
分类:巴黎	Kategori:Paris
分类:User en-4	Kategori:Bruker en-4
分类:User en	Kategori:Bruker en
分类:User zh	Kategori:Bruker zh
分类:User zh-N	Kategori:Bruker zh-N
分类:User en-2	Kategori:Bruker en-2
模板:Infobox	Mal:Infoboks
模板:Right TOC	Mal:TOC right
模板:Main other	Mal:Main other
模板:User zh	Mal:Bruker zh
模板:Legend	Mal:Legend
模板:Cite web	Mal:Kilde www
模板:Youtube	Mal:YouTube
模板:Current	Mal:Pågående
分类:軍事裝備	Kategori:Militært materiell
模板:Infobox WS	Mal:Infoboks skriftsystem
模板:Ombox	Mal:Pmboks
模板:IMDb title	Mal:Imdb tittel
模板:国际足球	Mal:Internasjonal fotball
模板:User ru-4	Mal:Bruker ru-4
分类:饮食	Kategori:Mat og drikke
模板:Coor URL	Mal:Koor URL
模板:Wiktionary	Mal:Wiktionary
模板:Mbox templates	Mal:Mboks-maler
薄拉特	Borat Sagdijev
模板:Multi-listen start	Mal:Multi-listen start
模板:Languageicon	Mal:Språkikon
分类:英国个博物馆	Kategori:Museer i Storbritannia
模板:大韩民国行政区划	Mal:Sør-Koreas regioner
Wikipedia:Selected anniversaries/October 3	Mal:Oktober 3
分类:总统	Kategori:Presidenter
模板:User ru	Mal:Bruker ru
分类:20世紀	Kategori:1900-tallet
模板:IPA	Mal:IPA
分类:美洲	Kategori:Amerika
模板:Otheruses	Mal:Andrebetydninger
分类:各国个人	Kategori:Personer etter nasjonalitet
模板:MONTHNAME	Mal:MONTHNAME
Wikipedia:GNU自由文档许可证文本	Wikipedia:GNU FDL
模板:Death date and age	Mal:Dødsdato og alder
模板:Infobox Model	Mal:Infoboks modell
模板:(	Mal:(
分类:人物小作品	Kategori:Biografistubber
模板:Top icon	Mal:Toppikon
模板:Namespace detect	Mal:Namespace detect
模板:)	Mal:)
模板:Fmbox	Mal:Fmbox
分类:作家	Kategori:Forfattere
分类:軍事	Kategori:Militærvesen
分类:大学	Kategori:Universiteter
模板:Talkback	Mal:Svar
模板:Infobox Website	Mal:Infoboks nettsted
模板:Documentation subpage	Mal:Dokumentasjonsunderside
模板:Uncategorized	Mal:Ukategorisert
模板:Tlx	Mal:Malp
模板:Purge	Mal:Oppdater
模板:Empty category	Mal:Tom kategori
模板:Infobox Cyrillic	Mal:Kyrillisk alfabet
模板:Dead link	Mal:Død lenke
分类:跨性别	Kategori:Transkjønnethet
模板:Provinces of China	Mal:Kinas provinser
模板:Userpage	Mal:Brukerside
模板:CIS	Mal:Samveldet av uavhengige stater
模板:User	Mal:Bruker
模板:Lorem ipsum	Mal:Lorem ipsum
模板:User language-4	Mal:Babel4
分类:中学	Kategori:Videregående skoler
分类:越南机场	Kategori:Flyplasser i Vietnam
分类:公司	Kategori:Selskaper
模板:Renameuser	Mal:Forandre brukernavn
模板:CIA World Factbook link	Mal:World Factbook
模板:Image label small	Mal:Image label small
模板:Iaaf name	Mal:IAAF navn
模板:Japanese	Mal:Nihongo
模板:User fr-3	Mal:Bruker fr-3
模板:UEFA	Mal:EM i fotball
模板:Infobox Military Unit	Mal:Infoboks militær enhet
模板:IMDb name	Mal:Imdb navn
模板:Ar icon	Mal:Ar icon
分类:突尼斯	Kategori:Tunisia
分类:泰国个寺庙	Kategori:Buddhistiske templer i Thailand
分类:韩国电视	Kategori:TV i Sør-Korea
模板:Japan	Mal:Japans regioner og prefekturer
模板:Cmbox	Mal:Kmboks
模板:Infobox Spacecraft	Mal:Infoboks romsonde
模板:User nds-1	Mal:Bruker nds-1
模板:S-before	Mal:S-bef
模板:Mbox	Mal:Mbox
模板:Oppose	Mal:Imot
模板:Pagetype	Mal:Pagetype
模板:User ar-2	Mal:Bruker ar-2
模板:User fr-0	Mal:Bruker fr-0
分类:User ja-N	Kategori:Bruker ja-N
分类:用戶名字空間模板	Kategori:Maler for brukersider
分类:社会阶层	Kategori:Samfunnsklasser
分类:印度电影	Kategori:Indisk film
模板:URL	Mal:URL
模板:Disambiguation	Mal:Peker
分类:公共交通	Kategori:Kollektivtrafikk
分类:中东	Kategori:Midtøsten
模板:Select skin	Mal:Select skin
分类:报纸	Kategori:Aviser
模板:Para	Mal:Para
模板:Fb	Mal:Fotballflagg
分类:維基百科元模板	Kategori:Metamaler
模板:Infobox Film	Mal:Infoboks film
模板:英文名	Mal:Lang-en
分类:甜品	Kategori:Desserter
模板:Expand language	Mal:Utvid språk
模板:辅音	Mal:Konsonanter
分类:广州	Kategori:Guangzhou
分类:各类电影	Kategori:Filmer etter sjanger
模板:!(	Mal:!(
分类:中国外交官	Kategori:Kinesiske diplomater
模板:NATO	Mal:NATO
分类:生物	Kategori:Organismer
模板:Infobox Biography	Mal:Infoboks biografi
分类:蒙古	Kategori:Mongolia
模板:InterWiki	Mal:InterWiki
分类:泰国个大学	Kategori:Universiteter i Thailand
分类:澳大利亚个报纸	Kategori:Australske aviser
分类:历年个电影	Kategori:Filmer etter årstall
分类:爱尔兰城市	Kategori:Byer i Republikken Irland
分类:美国黑人	Kategori:Afroamerikanere
模板:Thailand-stub	Mal:Thailandstubb
分类:1992年个歌曲	Kategori:Sanger fra 1992
分类:姊妹计划链接模板	Kategori:Interwikimaler
模板:User la-1	Mal:Bruker la-1
模板:歐洲行政區劃	Mal:Europa
分类:模板說明文檔	Kategori:Maldokumentasjonssider
分类:泰语	Kategori:Thai
分类:User zh-yue	Kategori:Bruker yue
分类:User wuu	Kategori:Bruker wuu
分类:User sk	Kategori:Bruker sk
分类:User fr	Kategori:Bruker fr
分类:User ja	Kategori:Bruker ja
分类:User la	Kategori:Bruker la
分类:User fr-3	Kategori:Bruker fr-3
分类:User fr-2	Kategori:Bruker fr-2
分类:User ja-2	Kategori:Bruker ja-2
分类:User la-2	Kategori:Bruker la-2
分类:User wuu-N	Kategori:Bruker wuu-N
分类:User ko-N	Kategori:Bruker ko-N
分类:User fr-N	Kategori:Bruker fr-N
分类:User nl-N	Kategori:Bruker nl-N
分类:User ru-N	Kategori:Bruker ru-N
分类:泰国拳击运动员	Kategori:Thailandske boksere
分类:政治经济学	Kategori:Politisk økonomi
分类:曼谷	Kategori:Bangkoks distrikter
分类:文字	Kategori:Skriftsystem
分类:维基百科清理	Kategori:Opprydning
分类:岛	Kategori:Øyer
分类:广平省	Kategori:Quang Binh
分类:User sk-N	Kategori:Bruker sk-N
分类:User de	Kategori:Bruker de
分类:User de-2	Kategori:Bruker de-2
分类:User de-3	Kategori:Bruker de-3
分类:User de-4	Kategori:Bruker de-4
分类:User de-N	Kategori:Bruker de-N
分类:User en-3	Kategori:Bruker en-3
分类:User en-N	Kategori:Bruker en-N
分类:User es	Kategori:Bruker es
分类:User es-1	Kategori:Bruker es-1
分类:User es-2	Kategori:Bruker es-2
分类:User es-N	Kategori:Bruker es-N
分类:首尔	Kategori:Seoul
分类:日本模板	Kategori:Japanske maler
模板:User la-3	Mal:Bruker la-3
分类:各国个政治	Kategori:Politikk etter område
模板:Multiple image	Mal:Flere bilder
分类:User it	Kategori:Bruker it
分类:User it-1	Kategori:Bruker it-1
分类:User ja-1	Kategori:Bruker ja-1
分类:User ko	Kategori:Bruker ko
分类:美国州	Kategori:USAs delstater
分类:User ksh	Kategori:Bruker ksh
分类:User ksh-N	Kategori:Bruker ksh-N
分类:User la-1	Kategori:Bruker la-1
分类:User la-3	Kategori:Bruker la-3
分类:澳大利亚地理	Kategori:Australias geografi
分类:火山	Kategori:Vulkaner
分类:天气	Kategori:Vær
分类:日本个县	Kategori:Japans prefekturer
分类:法国城市	Kategori:Byer i Frankrike
分类:User ru-1	Kategori:Bruker ru-1
Wikipedia:巴别	Wikipedia:Babel
模板:High-use	Mal:Mye brukt mal
模板:Humor	Mal:Humor
分类:残疾人	Kategori:Personer etter handikap
分类:北京人	Kategori:Personer fra Beijing
分类:化学小作品	Kategori:Kjemistubber
分类:各国个军事	Kategori:Militærvesen etter område
分类:日本地方	Kategori:Regioner i Japan
分类:海	Kategori:Hav
分类:李氏朝鲜君主	Kategori:Konger av Joseon
分类:泰国模板	Kategori:Thailandske maler
分类:计算机科学	Kategori:Informatikk
分类:User nds	Kategori:Bruker nds
分类:User nds-1	Kategori:Bruker nds-1
模板:Red	Mal:Rød
分类:神奈川县	Kategori:Kanagawa prefektur
分类:福岛县	Kategori:Fukushima prefektur
分类:广东省	Kategori:Guangdong
分类:安徽	Kategori:Anhui
分类:江西省	Kategori:Jiangxi
分类:江苏省	Kategori:Jiangsu
分类:经济	Kategori:Økonomi
分类:饮料	Kategori:Drikke
分类:社会科学	Kategori:Samfunnsvitenskap
分类:办拉路斯	Kategori:Hviterussland
分类:苏州人	Kategori:Personer fra Suzhou
分类:中国电影	Kategori:Kinesisk film
分类:非洲国家	Kategori:Land i Afrika
分类:各国教育	Kategori:Utdanning etter område
模板:(((	Mal:(((
模板:)!	Mal:)!
模板:)))	Mal:)))
模板:User ru-2	Mal:Bruker ru-2
分类:科幻片	Kategori:Science fiction-filmer
分类:User ru	Kategori:Bruker ru
分类:User ru-2	Kategori:Bruker ru-2
分类:User ru-4	Kategori:Bruker ru-4
分类:User zh-yue-1	Kategori:Bruker yue-1
分类:User zh-yue-N	Kategori:Bruker yue-N
分类:浙江省	Kategori:Zhejiang
模板:!((	Mal:Open wikilink
模板:))!	Mal:Close wikilink
模板:Lang	Mal:Språk
分类:泰国电影	Kategori:Thailandske filmer
分类:社会学	Kategori:Sosiologi
分类:1981年出生	Kategori:Fødsler i 1981
分类:1986年出生	Kategori:Fødsler i 1986
刘清 (田径运动员)	Liu Qing
分类:美国慈善家	Kategori:Filantroper fra USA
分类:各国个电影	Kategori:Film etter nasjonalitet
分类:人类	Kategori:Mennesker
分类:分類名字空間模板	Kategori:Kategorimaler
模板:Car-stub	Mal:Bilstubb
模板:Auxiliary template common notice	Mal:Auxiliary template common notice
分类:泰国交通	Kategori:Transport i Thailand
模板:Fr	Mal:Fr icon
分类:法国铁路	Kategori:Jernbane i Frankrike
分类:1951年个电影	Kategori:Filmer fra 1951
分类:佛罗里达州	Kategori:Florida
分类:上海个区	Kategori:Distrikter i Shanghai
Wikipedia:Lua	Wikipedia:Lua
分类:大規模殺傷性武器	Kategori:Masseødeleggelsesvåpen
分类:2005年个歌曲	Kategori:Sanger fra 2005
分类:动作片	Kategori:Actionfilmer
分类:英语电影	Kategori:Engelskspråklige filmer
模板:Round8	Mal:Fotballkvartfinaler
模板:Side box	Mal:Sideboks
模板:Citation/core	Mal:Citation/core
分类:法国交通	Kategori:Transport i Frankrike
分类:澳大利亚个湖	Kategori:Innsjøer i Australia
分类:各国经济	Kategori:Økonomi etter område
分类:各国个报纸	Kategori:Aviser etter land
分类:各国个地震	Kategori:Jordskjelv etter land
分类:韩国政治	Kategori:Sørkoreansk politikk
分类:澳大利亚个政治	Kategori:Australsk politikk
分类:柬埔寨经济	Kategori:Kambodsjas økonomi
分类:朝鲜民主主义人民共和国政治	Kategori:Nordkoreansk politikk
分类:泰国经济	Kategori:Thailands økonomi
分类:澳大利亚体育运动	Kategori:Sport i Australia
分类:泰国体育	Kategori:Sport i Thailand
分类:澳大利亚足球	Kategori:Fotball i Australia
分类:河	Kategori:Elver
模板:User ko	Mal:Bruker ko
模板:User la-2	Mal:Bruker la-2
模板:User ru-1	Mal:Bruker ru-1
模板:User zh-1	Mal:Bruker zh-1
模板:User zh-2	Mal:Bruker zh-2
分类:韩国交通	Kategori:Transport i Sør-Korea
分类:中国交通	Kategori:Transport i Kina
分类:世界各国个博物馆	Kategori:Museer etter område
分类:马来西亚经济	Kategori:Malaysias økonomi
分类:泰国军事	Kategori:Thailands forsvar
分类:菲律宾模板	Kategori:Filippinske maler
模板:Multi-listen end	Mal:Multi-listen end
分类:澳大利亚个交通	Kategori:Transport i Australia
分类:蘇聯政治家	Kategori:Sovjetiske politikere
分类:韩国人	Kategori:Sørkoreanere
分类:台湾人	Kategori:Taiwanere
分类:菲律宾	Kategori:Filippinene
分类:各行业澳大利亚人	Kategori:Australiere etter beskjeftigelse
分类:User nl	Kategori:Bruker nl
分类:User zh-1	Kategori:Bruker zh-1
分类:User zh-4	Kategori:Bruker zh-4
分类:User zh-3	Kategori:Bruker zh-3
分类:User zh-2	Kategori:Bruker zh-2
分类:泰国国王	Kategori:Thailandske konger
分类:力学	Kategori:Mekanikk
分类:不丹	Kategori:Bhutan
分类:澳大利亚跳水运动员	Kategori:Australske stupere
分类:印度科学技术	Kategori:Vitenskap og teknologi i India
分类:中国演员	Kategori:Kinesiske skuespillere
分类:澳大利亚游泳运动员	Kategori:Australske svømmere
分类:电视	Kategori:TV
分类:中国诗人	Kategori:Kinesiske diktere
分类:世紀	Kategori:Århundrer
分类:蘇聯外敎官	Kategori:Sovjetiske diplomater
分类:印度演员	Kategori:Indiske skuespillere
分类:中国田径运动员	Kategori:Kinesiske friidrettsutøvere
分类:澳大利亚脚踏车运动员	Kategori:Australske syklister
分类:泰国运动员	Kategori:Thailandske sportsutøvere
分类:中国运动员	Kategori:Kinesiske sportsutøvere
分类:泰国府	Kategori:Thailands provinser
分类:海滩	Kategori:Strender
分类:柬埔寨人	Kategori:Kambodsjanere
分类:泰国政治人物	Kategori:Thailandske politikere
分类:香港人	Kategori:Hongkongkinesere
分类:泰国人	Kategori:Thailendere
粤语	Kantonesisk
分类:意大利个湖	Kategori:Innsjøer i Italia
分类:光学仪器	Kategori:Optiske instrumenter
分类:机场	Kategori:Flyplasser
分类:泰国机场	Kategori:Flyplasser i Thailand
分类:日本个机场	Kategori:Flyplasser i Japan
分类:化学元素	Kategori:Grunnstoffer
分类:澳大利亚运动员	Kategori:Australske sportsutøvere
分类:环球小姐	Kategori:Miss Universe
分类:澳大利亚总理	Kategori:Australske premierministre
分类:地理小作品	Kategori:Geografistubber
分类:朝鲜	Kategori:Nord-Korea
分类:柬埔寨	Kategori:Kambodsja
分类:澳大利亚人	Kategori:Australiere
分类:中国人	Kategori:Kinesere
分类:韩国演员	Kategori:Sørkoreanske skuespillere
分类:中国历史	Kategori:Kinas historie
分类:老挝	Kategori:Laos
分类:缅甸	Kategori:Myanmar
分类:台湾	Kategori:Taiwan
分类:法国演员	Kategori:Franske skuespillere
分类:電影模板	Kategori:Filmmaler
分类:爱尔兰模板	Kategori:Irske maler
分类:伊朗模板	Kategori:Iranske maler
分类:英国模板	Kategori:Britiske maler
分类:美国模板	Kategori:USA-maler
分类:中国古代朝代	Kategori:Kinesiske dynastier
分类:法国模板	Kategori:Franske maler
分类:越南模板	Kategori:Vietnamesiske maler
分类:加拿大模板	Kategori:Canadiske maler
分类:马来西亚模板	Kategori:Malaysiske maler
分类:精密模板	Kategori:Kompliserte maler
分类:維基百科工具模板	Kategori:Hjelpemaler
分类:泰国个公司	Kategori:Thailandske selskaper
分类:马来西亚公司	Kategori:Malaysiske selskaper
分类:常州人	Kategori:Personer fra Changzhou
分类:陕西人	Kategori:Personer fra Shaanxi
分类:安徽人	Kategori:Personer fra Anhui
分类:云南人	Kategori:Personer fra Yunnan
分类:江苏人	Kategori:Personer fra Jiangsu
分类:浙江人	Kategori:Personer fra Zhejiang
分类:上海人	Kategori:Personer fra Shanghai
分类:出生	Kategori:Fødsler etter årstall
分类:法国总统	Kategori:Franske presidenter
分类:亚洲历史	Kategori:Asias historie
分类:约旦	Kategori:Jordan
分类:大洋洲国家	Kategori:Land i Oseania
分类:鱼类	Kategori:Fisk
分类:北京	Kategori:Beijing
分类:国家足球队	Kategori:Landslag i fotball
分类:日本关东地方	Kategori:Kantōregionen
分类:剧情片	Kategori:Dramafilmer
分类:1971年个电影	Kategori:Filmer fra 1971
分类:2003年个电影	Kategori:Filmer fra 2003
分类:1994年个电影	Kategori:Filmer fra 1994
分类:2004年个电影	Kategori:Filmer fra 2004
分类:2005年个电影	Kategori:Filmer fra 2005
分类:2007年个电影	Kategori:Filmer fra 2007
分类:2008年个电影	Kategori:Filmer fra 2008
分类:香港电影	Kategori:Film i Hongkong
分类:法国电影	Kategori:Fransk film
分类:公用领域媒体	Kategori:PD-bilder
分类:阿拉伯语	Kategori:Arabisk
分类:印度言话	Kategori:Språk i India
分类:人类学	Kategori:Antropologi
分类:世界小姐	Kategori:Miss World
分类:抗生素	Kategori:Antibiotika
分类:操作系统	Kategori:Operativsystemer
分类:昆士兰州	Kategori:Queensland
分类:维克多利亚州	Kategori:Victoria (Australia)
分类:电影奖	Kategori:Filmpriser
分类:奥斯卡金像奖	Kategori:Oscar
分类:金球奖	Kategori:Golden Globe
分类:里昂	Kategori:Lyon
分类:中国文化	Kategori:Kinesisk kultur
分类:法国文化	Kategori:Fransk kultur
分类:越南文化	Kategori:Vietnamesisk kultur
分类:韩国文化	Kategori:Sørkoreansk kultur
分类:维基百科指南	Kategori:Wikipedia how-to
分类:网络语言	Kategori:Internett-slang
分类:动物	Kategori:Dyr
分类:泰国航空公司	Kategori:Thailandske flyselskaper
分类:国际象棋	Kategori:Sjakk
分类:武器	Kategori:Våpen
分类:核武器	Kategori:Kjernefysiske våpen
分类:物理量	Kategori:Fysiske størrelser
分类:小吃	Kategori:Snacks
分类:热力学	Kategori:Termodynamikk
分类:气象学	Kategori:Meteorologi
分类:航空事故	Kategori:Flyulykker
分类:香港	Kategori:Hongkong
分类:菲律宾群岛	Kategori:Øyer på Filippinene
分类:上海	Kategori:Shanghai
分类:节日	Kategori:Festivaler
分类:印度城市	Kategori:Byer i India
分类:俄罗斯城市	Kategori:Byer i Russland
分类:Web 2.0	Kategori:Web 2.0
分类:事体	Kategori:Historiske hendelser
分类:電信	Kategori:Telekommunikasjon
分类:交通	Kategori:Transport
分类:选美	Kategori:Skjønnhetskonkurranser
分类:电视剧	Kategori:TV-serier
分类:北美洲	Kategori:Nord-Amerika
分类:歌手	Kategori:Sangere
分类:亚洲个湖泊	Kategori:Innsjøer i Asia
分类:欧洲个湖泊	Kategori:Innsjøer i Europa
分类:湖泊	Kategori:Innsjøer
分类:大韩民国机场	Kategori:Flyplasser i Sør-Korea
模板:Infobox Language	Mal:Infoboks språk
分类:大洋洲	Kategori:Oseania
分类:中国城市	Kategori:Byer i Kina
分类:瀑布	Kategori:Fosser
分类:自然灾害	Kategori:Naturkatastrofer
分类:日本九州	Kategori:Kyūshūregionen
分类:1998年个电影	Kategori:Filmer fra 1998
分类:2006年个电影	Kategori:Filmer fra 2006
分类:恐怖片	Kategori:Skrekkfilmer
分类:美国电影	Kategori:Film i USA
分类:汉语	Kategori:Kinesisk
分类:泰国言话	Kategori:Språk i Thailand
分类:新南威尔士州	Kategori:New South Wales
分类:澳大利亚文化	Kategori:Australsk kultur
分类:泰国文化	Kategori:Thailandsk kultur
分类:越南城市	Kategori:Byer i Vietnam
分类:澳大利亚城市	Kategori:Byer i Australia
分类:泰国城市	Kategori:Byer i Thailand
分类:泰国个岛	Kategori:Øyer i Thailand
分类:印度文化	Kategori:Indisk kultur
分类:印度尼西亚个岛	Kategori:Øyer i Indonesia
分类:中国个公园	Kategori:Parker i Kina
分类:银行	Kategori:Banker
Wikipedia:模板文檔	Wikipedia:Maldokumentasjon
分类:中华人民共和国	Kategori:Folkerepublikken Kina
分类:維基百科名字空間模板	Kategori:Maler etter navnerom
分类:澳大利亚运动场	Kategori:Idrettsanlegg i Australia
模板:FULLROOTPAGENAME	Mal:FULLROOTPAGENAME
分类:学堂	Kategori:Skoler
分类:澳大利亚风光	Kategori:Severdigheter i Australia
分类:越南航空	Kategori:Vietnamesiske flyselskaper
分类:中国地铁	Kategori:Undergrunnsbane i Folkerepublikken Kina
模板:Geo stub	Mal:Geografistubb
分类:User wuu-3	Kategori:Bruker wuu-3
分类:朝鲜国家元首	Kategori:Nordkoreanske presidenter
分类:亚洲国家	Kategori:Land i Asia
模板:Japan stub	Mal:Japanstubb
模板:Mexico-stub	Mal:Mexicostubb
分类:南美洲国家模板	Kategori:Søramerikanske maler
模板:Sister project	Mal:Søster
分类:User wuu-2	Kategori:Bruker wuu-2
分类:User wuu-1	Kategori:Bruker wuu-1
分类:澳大利亚模板	Kategori:Australske maler
分类:大桥	Kategori:Broer
分类:布里司班	Kategori:Brisbane
分类:粤语	Kategori:Kantonesisk
分类:中美洲国家	Kategori:Land i Sentral-Amerika
分类:戏曲	Kategori:Kinesisk opera
分类:地震	Kategori:Jordskjelv
分类:中国地震	Kategori:Jordskjelv i Kina
分类:环境	Kategori:Miljø
分类:维基媒体基金会版权	Kategori:Copyright Wikimedia
模板:IAST	Mal:IAST
模块:Sidebar	Modul:Sidebar
分类:杭州	Kategori:Hangzhou
分类:印度小作品	Kategori:Indiastubber
分类:爱尔兰	Kategori:Irland
模板:India-stub	Mal:Indiastubb
分类:苏州	Kategori:Suzhou
分类:中华民国	Kategori:Republikken Kina
模板:Listen	Mal:Lytte
分类:无锡人	Kategori:Personer fra Wuxi
分类:澳大利亚足球场	Kategori:Fotballstadioner i Australia
分类:相态	Kategori:Aggregattilstander
分类:南澳大利亚州	Kategori:Sør-Australia
分类:广东人	Kategori:Personer fra Guangdong
分类:墨尔本	Kategori:Melbourne
分类:電話	Kategori:Telefoni
分类:温度	Kategori:Temperatur
分类:海啸	Kategori:Tsunamier
分类:悉尼	Kategori:Sydney
分类:热带气旋	Kategori:Tropiske sykloner
分类:应用科学	Kategori:Anvendt vitenskap
分类:法国个报纸	Kategori:Franske aviser
模板:Image label begin	Mal:Image label begin
分类:澳大利亚大学	Kategori:Universiteter i Australia
分类:中国个报纸	Kategori:Kinesiske aviser
分类:日本大学	Kategori:Universiteter i Japan
分类:宁波	Kategori:Ningbo
分类:天津	Kategori:Tianjin
分类:非洲国家模板	Kategori:Afrikanske maler
分类:生活	Kategori:Dagligliv
分类:柬埔寨文化	Kategori:Kambodsjansk kultur
分类:User en-1	Kategori:Bruker en-1
分类:User de-1	Kategori:Bruker de-1
分类:亚洲个台风	Kategori:Tropiske sykloner i Asia
分类:美国演员	Kategori:Skuespillere fra USA
分类:瑞典贵族	Kategori:Svensk adel
分类:电影人	Kategori:Filmfolk
分类:古巴拳击运动员	Kategori:Cubanske boksere
模板:Lua	Mal:Lua
Wikipedia:Media help	Hjelp:Multimedia
模块:Error	Modul:Error
模板:Italy-stub	Mal:Italiastubb
模板:OIC	Mal:OIC
模板:Testcases notice	Mal:Template test cases notice
模板:Start date	Mal:Startdato
琉球群岛	Ryukyuøyene
模板:Bio-stub	Mal:Biografistubb
模板:User wuu	Mal:Bruker wuu
模板:Indonesia stub	Mal:Indonesiastubb
模板:Wayback	Mal:Wayback
模板:Ireland stub	Mal:Irlandstubb
模板:Larger	Mal:Larger
Wikipedia:VisualEditor	Wikipedia:VisualEditor
模板:Contains special characters	Mal:Spesialtegn
Wikipedia:Spoken articles	Wikipedia:Underprosjekter/Lydartikler
模板:Multi-listen item	Mal:Multi-listen item
模板:Markup	Mal:Markup
模板:Vietnam stub	Mal:Vietnamstubb
模板:Tld	Mal:Tld
模板:User wuu-1	Mal:Bruker wuu-1
模板:HKG stub	Mal:Hongkongstubb
模板:TemplateDataHeader	Mal:TemplateDataHeader
模板:Reply to	Mal:Svar til
模块:Yesno	Modul:Yesno
模块:Message box	Modul:Message box
模块:Category handler	Modul:Category handler
模块:Message box/configuration	Modul:Message box/configuration
模块:Arguments	Modul:Arguments
特殊:最近更改	Spesial:Siste endringer
模块:TableTools	Modul:TableTools
模块:List	Modul:List
模块:Namespace detect	Modul:Namespace detect
模块:HtmlBuilder	Modul:HtmlBuilder
模块:String	Modul:String
模块:InfoboxImage	Modul:InfoboxImage
模块:Navbar	Modul:Navbar
模块:Navbox	Modul:Navbox
模块:Infobox	Modul:Infoboks
Wikipedia:VisualEditor/TemplateData	Wikipedia:VisualEditor/TemplateData
模块:Namespace detect/data	Modul:Namespace detect/data
模块:Namespace detect/config	Modul:Namespace detect/config
模块:No globals	Modul:No globals
模块:Lua banner	Modul:Lua banner
馬來西亞航空17號班機空难	Malaysia Airlines Flight 17
