אפריקע	Afrika
יאפאן	Japan
דרום אמעריקע	Sør-Amerika
נארוועגיע	Norge
ענגלאנד	England
סקאטלאנד	Skottland
וויילס	Wales
צפון אירלאנד	Nord-Irland
אירלאנד	Irland
אונגארן	Ungarn
שפאניע	Spania
פאראייניקטע שטאטן פון אמעריקע	USA
בעלגיע	Belgia
לוקסעמבורג	Luxembourg
אוניווערס	Universet
ערד-פלאנעט	Jorden
לעבן	Liv
טויט	Død
מענטש	Menneske
פרייד	Lykke
דזשארזש וואשינגטאן	George Washington
טים בערנערס-לי	Tim Berners-Lee
סטענלי קובריק	Stanley Kubrick
פינלאנד	Finland
שוועדן	Sverige
דענמארק	Danmark
פוילן	Polen
ליטע	Litauen
איטאליע	Italia
שווייץ	Sveits
עסטרייך	Østerrike
גריכנלאנד	Hellas
טערקיי	Tyrkia
ביר	Øl
פארטוגאל	Portugal
אייראפע	Europa
אזיע	Asia
צפון אמעריקע	Nord-Amerika
אנטארקטיקע	Antarktika
וויקיפעדיע	Wikipedia
האלאנד	Nederland
פעניס	Penis
PHP	PHP
ניו יארק (שטאט)	New York
וואשינגטאן די סי	Washington, D.C.
סאן פראנציסקא	San Francisco
בערלין	Berlin
לאס אנדזשעלעס	Los Angeles
באואינג	Boeing
ערבוס	Airbus
קאמפיוטער	Datamaskin
בערן	Bern
גענף	Genève
ציריך	Zürich
אינטערנעץ	Internett
באראק אבאמא	Barack Obama
אורוגוויי	Uruguay
באזעל	Basel
דרוקער	Skriver
מעדיעוויקי	MediaWiki
לאנדאן	London
קיירא	Kairo
קאפוויי	Hodepine
אלעקסאנדריע	Alexandria
עפל	Epleslekten
פאריז	Paris
אברהם לינקאלן	Abraham Lincoln
גוגל	Google
מעקסיקא	Mexico
אטלאנטישער אקעאן	Atlanterhavet
פאציפישער אקעאן	Stillehavet
קאליפארניע	California
באסטאן	Boston
מאנטיק	Mandag
געשפרייט	Rom (fysikk)
יאנואר	Januar
פעברואר	Februar
מערץ	Mars (måned)
מאדים	Mars (planet)
קעניע	Kenya
עטיאפיע	Etiopia
מאנארך	Monark
גהאנע	Ghana
אפריל	April
מיי	Mai
יוני	Juni
יולי	Juli
אויגוסט	August
סעפטעמבער	September
אקטאבער	Oktober
נאוועמבער	November
דעצעמבער	Desember
דינסטיק	Tirsdag
מיטוואך	Onsdag
דאנערשטיק	Torsdag
פרייטיק	Fredag
זונטיק	Søndag
לייב	Løve
פראנקרייך	Frankrike
עספעראנטא	Esperanto
הונט	Tamhund
פאראייניגטע קעניגרייך	Storbritannia
קאץ	Tamkatt
כינע	Folkerepublikken Kina
פראנצויזיש	Fransk
וויקיווערטערבוך	Wiktionary
פיש	Fisk
עטאנאל	Etanol
אלקאהאליש געטראנק	Alkoholholdig drikke
בראזיל	Brasil
אלקאהאל	Alkoholer
פראנצווא האלאנד	François Hollande
רוסלאנד	Russland
וואלפיש	Hvaler
אפטישע פיברע	Fiberoptikk
קוואדראט	Kvadrat
ים	Hav
שווארצער ים	Svartehavet
פי	Pi
פי (אות)	Pi (bokstav)
וויקי	Wiki
טאראנטא	Toronto
אלאבאמא	Alabama
סאו פאולא	São Paulo
קוויבעק	Québec
פיצא	Pizza
וויקימעדיע פונדאציע	Wikimedia Foundation
זשימי וויילס	Jimmy Wales
דייטשלאנד	Tyskland
בעלארוס	Hviterussland
דייטשיש	Tysk
איסלאנד	Island
גאט	Gud
עסטלאנד	Estland
דייוויד קאמעראן	David Cameron
סאטורן	Saturn
שאקאלאד	Sjokolade
עראפלאן	Fly
מלחמה	Krig
1 (נומער)	1 (tall)
2 (נומער)	2 (tall)
3 (נומער)	3 (tall)
4 (נומער)	4 (tall)
5 (נומער)	5 (tall)
0 (נומער)	Null
אומענדלעכקייט	Uendelig
סטיוון הארפער	Stephen Harper
דזשארדזש וו. בוש	George W. Bush
גראדעק	Rektangel
לעטלאנד	Latvia
אוקראינע	Ukraina
טשעכיי	Tsjekkia
סלאוואקיי	Slovakia
סלאוועניע	Slovenia
ווילנע	Vilnius
מאלדאווע	Moldova
רומעניע	Romania
בולגאריע	Bulgaria
רוים	Roma
מאקעדאניע	Republikken Makedonia
אלבאניע	Albania
גרינלאנד	Grønland
קראאטיע	Kroatia
באסניע און הערצעגאווינע	Bosnia-Hercegovina
אזערביידזשאן	Aserbajdsjan
אנדארע	Andorra
ציפערן	Republikken Kypros
גרוזיע	Georgia
וואלאניע	Vallonia
קאזאכסטאן	Kasakhstan
מאלטא	Malta
פלאנדערן	Flandern
מאנאקא	Monaco
מאנטענעגרא	Montenegro
וואטיקאן	Vatikanstaten
סאן מארינא	San Marino
בריסל ראיאן	Brussel
קובא	Cuba
בעליז	Belize
אייפל טורעם	Eiffeltårnet
קלאוויאטור	Tastatur
אינדאנעזיע	Indonesia
וואלפגאנג אמאדעוס מאצארט	Wolfgang Amadeus Mozart
לודוויג וואן בעטהאוון	Ludwig van Beethoven
טערקיש	Tyrkisk
דרום אפריקע	Sør-Afrika
אלזשיר	Algerie
וויקיביבליאטעק	Wikikilden
הוראגאן סענדי	Orkanen Sandy
אוזבעקיסטאן	Usbekistan
פויזן	Poznań
טאשקענט	Tasjkent
ווארשע	Warszawa
וויסקי	Whisky
וויין	Vin
וואסער	Vann
קאניאק	Cognac (Charente)
האלץ	Treverk
טעלעוויזיע	Fjernsyn
געשלעכט	Kjønn
פארנאגראפיע	Pornografi
קלאד מאנע	Claude Monet
דיעגא וועלאזקעז	Diego Velázquez
טשילע	Chile
יעזוס	Jesus Kristus
עלוויס פרעסלי	Elvis Presley
סעוואסטיאן פיניערא	Sebastián Piñera
גאלילעא גאלילעי	Galileo Galilei
מערקור	Merkur
היסטאריע	Historie
עפל (פירמע)	Apple
ווענוס	Venus
שפראך	Språk
ליבע	Kjærlighet
דיקטאטור	Diktatur
גאלאקסיע	Galakse
יופיטער	Jupiter
מיטשעל באטשעלעט	Michelle Bachelet
מילכיגער וועג	Melkeveien
ביג בענג	Big Bang
אוראנוס	Uranus
ענגלישע וויקיפעדיע	Wikipedia på engelsk
ניקאלא סארקאזי	Nicolas Sarkozy
נעפטון	Neptun (planet)
אסטראנאמיע	Astronomi
סינגאפור	Singapore
וויסנשאפט	Vitenskap
קאסמאלאגיע	Kosmologi
פלוטאן	Pluto
מאנטרעאל	Montréal
ליכטנשטיין	Liechtenstein
ספארט	Sport
אדאלף היטלער	Adolf Hitler
פייסבוק	Facebook
ערשטע וועלט מלחמה	Første verdenskrig
צווייטע וועלט-מלחמה	Andre verdenskrig
קעלן	Köln
וויקיביכער	Wikibøker
וואדקע	Vodka
זייגער	Klokke (ur)
אובונטו	Ubuntu (operativsystem)
סקאפיע	Skopje
שטעטין	Szczecin
מאטעמאטיק	Matematikk
לאטיין	Latin
באכריין	Bahrain
ארמעניע	Armenia
סערביע	Serbia
לבנה	Månen
סטאמבול	Istanbul
אויסטראליע	Australia
פיזיק	Fysikk
ארגענטינע	Argentina
טעלעקאמוניקאציע	Telekommunikasjon
פערו	Peru
ביאלאגיע	Biologi
אומאידענטיפיצירטער פליענדער אביעקט	Uidentifisert flygende objekt
צפון קארעע	Nord-Korea
קאמבאדיע	Kambodsja
קאראן	Koranen
דינאזאווער	Dinosaurer
זאאלאגיע	Zoologi
איסלאם	Islam
באטאניק	Botanikk
לעך וואלענסא	Lech Wałęsa
ראד	Hjul
שכל	Sinn
פרידן	Fred
ליאן	Lyon
אייראפעישער פארבאנד	Den europeiske union
פלאוודיוו	Plovdiv
World Wide Web	World Wide Web
פרוי	Kvinne
סאפיע	Sofia
דאן קיכאטע	Don Quijote
דיכטונג	Poesi
קאמפיוטער ווירוס	Datavirus
שמייכל	Smil
ביל מאהער	Bill Maher
מילאן	Milano
פריינטשאפט	Vennskap
זכרון	Hukommelse
טורין	Torino
צואה	Avføring
לימענע	Sitron
באנאן	Bananer
בלום	Blomst
גוגאל	Googol
וולאדימיר וויסאצקי	Vladimir Vysotskij
עווערעסט	Mount Everest
אנאטאמיע	Anatomi
שטאט	By
נאפאלעאן באנאפארטע	Napoléon Bonaparte
פיזיאלאגיע	Fysiologi
שטערן	Stjerne
זון	Solen
לואי פאסטער	Louis Pasteur
ליכט יאר	Lysår
דארף	Landsby
וויקטאר הוגא	Victor Hugo
אקעאניע	Oseania
אטלעטיק	Friidrett
צענזור	Sensur (informasjon)
זון סיסטעם	Solsystemet
באלטישער ים	Østersjøen
ווייסל	Wisła
שאמס עליזע	Avenue des Champs-Élysées
הידראגען	Hydrogen
העליום	Helium
וויקיקאמאנס	Wikimedia Commons
אנגעלא מערקל	Angela Merkel
ליטיום	Litium
בעריליום	Beryllium
בוך	Bok
טאג	Dag
מזרח טימאר	Øst-Timor
נאכט	Natt
יאר	År
יארהונדערט	Århundre
לאדזש	Łódź
מאן בלאנק	Mont Blanc
ריין (טייך)	Rhinen
אסלא	Oslo
באן, דייטשלאנד	Bonn
קאטאוויץ	Katowice
שווארצע לאך	Sort hull
צערעס	Ceres (dvergplanet)
ליסבאן	Lisboa
ריישע	Rzeszów
איטשירא סוזוקי	Ichiro Suzuki
מייקל בלומבערג	Michael Bloomberg
דוביי	Dubai
ליאנעל מעסי	Lionel Messi
באר (עלעמענט)	Bor (grunnstoff)
ניקאליי קאפערניק	Nikolaus Kopernikus
ווערסיי	Versailles
קוילנשטאף	Karbon
וואלגא	Volga
אזאט	Nitrogen
זויערשטאף	Oksygen
פלאנעט	Planet
מוזיק	Musikk
ווענעציע	Venezia
שארם אל שייך	Sharm el-Sheikh
נעווא טייך	Neva
ליל	Lille
מאסקווע	Moskva
פלואר	Fluor
איטאליעניש	Italiensk
נעאן	Neon
פעטערבורג	St. Petersburg
טשאד (לאנד)	Tsjad
נאטריום	Natrium
צפון	Nord
מאגנעזיום	Magnesium
אלומיניום	Aluminium
ניו זילאנד	New Zealand
דרום	Sør
אינדיע	India
סיליציום	Silisium
פאספאר	Fosfor
פראזע (ליטעראטור)	Prosa
אייזן	Jern
מערב	Vest
שוועבל	Svovel
מיזרח	Øst
סאלאמאן אינזלען	Salomonøyene
מאליער	Molière
כלאר	Klor
דעלפט	Delft
וויליאם שייקספיר	William Shakespeare
משל	Fabel
ארגאן (עלעמענט)	Argon
Mozilla Firefox	Mozilla Firefox
קאליום	Kalium
קאלציום	Kalsium
בליי	Bly
מאנגאליי	Mongolia
פידזשי	Fiji
סקאנדיום	Scandium
טיטאניום	Titan (grunnstoff)
ווענעזועלע	Venezuela
שאך (שפיל)	Sjakk
דזשינגיס כאן	Djengis Khan
וואנאדיום	Vanadium
מעין	Maine
כראם	Krom
פערד	Hest
אמסטערדאם	Amsterdam
געווער	Våpen
בעלי חיים	Dyr
סורינאם	Surinam
מאנגאן	Mangan
פאראגוויי	Paraguay
גויאנע	Guyana
קונסט	Kunst
עקוואדאר	Ecuador
רעניום	Rhenium
קאלאמביע	Colombia
קאבאלט	Kobolt
וואלפראם	Wolfram
ניקל	Nikkel
טרוסקאווקע	Jordbærslekta
בודהיזם	Buddhisme
באליוויע	Bolivia
אסמיום	Osmium
קופער	Kobber
פלאנץ	Planter
צינק	Sink
ניו העמפשער	New Hampshire
ביאליסטאק	Białystok
לעאנארדא דא ווינטשי	Leonardo da Vinci
שוואם	Sopper
דזשאמייקע	Jamaica
מאסאטשוסעטס	Massachusetts
גוואטעמאלע	Guatemala
גוגל כראם	Google Chrome
באהאמאס	Bahamas
קאנעטיקעט	Connecticut
האן	Tamhøns
האוואי	Hawaii
האנדוראס	Honduras
דאמיניקאנישע רעפובליק	Den dominikanske republikk
חזיר	Gris
ארקטישער אקעאן	Nordishavet
האיטי	Haiti
על סאלוואדאר	El Salvador
איראן	Iran
שטות	Dumhet
איראק	Irak
אלאסקע	Alaska
קלוגשאפט	Visdom
קאסטא ריקא	Costa Rica
ישראל	Israel
צאנז	Nowy Sącz
פאנאמא	Panama
תימן	Jemen
ווירוס	Virus
פויליש	Polsk
יארדאניע	Jordan
ניקאראגוא	Nicaragua
פלארידע	Florida
קירגיזסטאן	Kirgisistan
אריזאנע	Arizona
קואווייט	Kuwait
לאאס	Laos
לבנון	Libanon
ארעגאן	Oregon
מאלדיוון	Maldivene
אמעריקע	Amerika
יוטא	Utah
אקס	Storfe
מאלייזיע	Malaysia
מיאנמאר	Myanmar
נעפאל	Nepal
אמאן	Oman
פאקיסטאן	Pakistan
דזשעימס באנד	James Bond
קאטאר	Qatar
טעניס	Tennis
סאודי אראביע	Saudi-Arabia
סרי לאנקא	Sri Lanka
יאזעף סטאלין	Josef Stalin
סיריע	Syria
פלאטאן	Platon
גאליום	Gallium
טאדזשיקיסטאן	Tadsjikistan
רעפובליק פון כינע	Republikken Kina
יוטוב	YouTube
גערמאניום	Germanium
אריסטו	Aristoteles
טיילאנד	Thailand
באן	Jernbanetog
ארסעניק	Arsen
ראדיא	Radio
טורקמעניסטאן	Turkmenistan
סעלעניום	Selen
אירידיום	Iridium
פאראייניגטע אראבישע עמיראטן	De forente arabiske emirater
בראם	Brom
פלאטין	Platina
וויעטנאם	Vietnam
טשארלי טשאפלין	Charlie Chaplin
דרום קארעע	Sør-Korea
די סימפסאנס	Simpsons
קריפטאן	Krypton
אפגאניסטאן	Afghanistan
רובידיום	Rubidium
גאלד	Gull
סועץ קאנאל	Suezkanalen
באנגלאדעש	Bangladesh
פראנץ קאפקא	Franz Kafka
טשעליאבינסק	Tsjeljabinsk
כארכע לויס בארכעס	Jorge Luis Borges
מאלי	Mali
סאקראטעס	Sokrates
אנגאלא	Angola
בהוטאן	Bhutan
טוויטער	Twitter
ברוניי	Brunei
טאנזאניע	Tanzania
קוועקזילבער	Kvikksølv
ראאלד אמונדסען	Roald Amundsen
הארי מוליש	Harry Mulisch
פיליפינען	Filippinene
צענטראל-אפריקאנישע רעפובליק	Den sentralafrikanske republikk
טאליום	Thallium
דרום פאלוס	Sydpolen
צפון פאלוס	Nordpolen
אייזיק ניוטאן	Isaac Newton
אלבערט איינשטיין	Albert Einstein
סטראנטיום	Strontium
איטריום	Yttrium
ביסמוט	Vismut
געל	Gul
קוואנטן-מעכאניק	Kvantemekanikk
טאגא	Togo
טוניסיע	Tunisia
זאמביע	Zambia
זימבאבווע	Zimbabwe
בייזשינג	Beijing
דרום סודאן	Sør-Sudan
וולאדיוואסטאק	Vladivostok
בענין	Benin
באצוואנע	Botswana
וויקינייעס	Wikinytt
בורקינע פאסא	Burkina Faso
בורונדי	Burundi
קאמאראס	Komorene
רעפובליק פון קאנגא	Republikken Kongo
דעמאקראטישע רעפובליק פון קאנגא	Den demokratiske republikken Kongo
סאן אנטאניא	San Antonio
דזשיבוטי	Djibouti
פאלאניום	Polonium
בייערן	Bayern
עקוואטארישע גינע	Ekvatorial-Guinea
באדן-ווירטמבורג	Baden-Württemberg
עריטרעא	Eritrea
ניי דעלי	New Delhi
פיאדאר דאסטאיעווסקי	Fjodor Dostojevskij
טביליסי	Tbilisi
אנדריי סאכאראוו	Andrej Sakharov
עופעלע	Spedbarn
גאבאן	Gabon
מאהענדאס קערעמטשענד גאנדי	Mahatma Gandhi
קאמיקס	Tegneserie
די גאמביע	Gambia
גינע	Guinea
גינע-ביסאו	Guinea-Bissau
בארטן פון העלפאנדביין	Elfenbenskysten
קאמערון	Kamerun
קאפווערדישע אינזלען	Kapp Verde
לעסאטא	Lesotho
ליבעריע	Liberia
ליביע	Libya
מאדאגאסקאר	Madagaskar
מאלאווי	Malawi
שטוטגארט	Stuttgart
מאריטאניע	Mauritania
מאריציוס	Mauritius
מאראקא	Marokko
מאזאמביק	Mosambik
נאמיביע	Namibia
ניזשער	Niger
ניגעריע	Nigeria
טשארלס דארווין	Charles Darwin
אוגאנדע	Uganda
רוואנדע	Rwanda
צירקאניום	Zirkonium
סאא טאמע און פרינסיפע	São Tomé og Príncipe
קארלסרוע	Karlsruhe
סענעגאל	Senegal
סיישעל	Seychellene
קארל פאן לינע	Carl von Linné
סיערע לעאנע	Sierra Leone
סאמאליע	Somalia
דזשאווארהארלאל נעהרו	Jawaharlal Nehru
יוליוס קייסער	Julius Cæsar
סודאן	Sudan
סוואזילאנד	Swaziland
רעגנבויגן	Regnbue
האמבורג	Hamburg
מעטאבאליזם	Stoffskifte
נארענדרא מאדי	Narendra Modi
אימון-סיסטעם	Immunforsvar
גודזשאראט	Gujarat
עוואלוציע	Evolusjon
פאראייניגטע פעלקער	De forente nasjoner
דאנטע אליגערי	Dante Alighieri
געאלאגיע	Geologi
געאגראפיע	Geografi
הארץ	Hjerte
מוח	Hjerne
הויט	Hud
קאליר	Farge
סובסטאנטיוו	Substantiv
פראג	Praha
רוטעניום	Ruthenium
רהאדיום	Rhodium
בלוי	Blå
פאלאדיום	Palladium
זילבער	Sølv
קאדמיום	Kadmium
שטערן רייזע	Star Trek
אינדיום	Indium
צין	Tinn (grunnstoff)
אוראניום	Uran
שפיזגלאז	Antimon
טעלור	Tellur
פלוטאניום	Plutonium
יאד	Jod
קסענאן	Xenon
אנימע	Anime
צעז	Cesium
באריום	Barium
טאנטאלום	Tantal
ביל קלינטאן	Bill Clinton
ראדיום	Radium
ראדאן	Radon
לאטארינגיע	Lorraine
עלזאס	Alsace
העקטאר בערליאז	Hector Berlioz
מומביי	Mumbai
אנדרא פראדעש	Andhra Pradesh
ארונאטשאל פראדעש	Arunachal Pradesh
אסאם	Assam
מישיגן	Michigan
טשאטיסגארה	Chhattisgarh
האריאנא	Haryana
אקוויטאניע	Aquitaine
דזשארקהאנד	Jharkhand
קארנאטאקא	Karnataka
קעראלא	Kerala
מאדהיא פראדעש	Madhya Pradesh
מאהאראשטרא	Maharashtra
מעקלענבורג-מערב פאמעראניע	Mecklenburg-Vorpommern
אונטער-זאקסן	Niedersachsen
נארד ריין-וועסטפאליע	Nordrhein-Westfalen
העסע	Hessen
ריינלאנד-פאלץ	Rheinland-Pfalz
זאקסן	Sachsen
אילינוי	Illinois
טורינגיע	Thüringen
זאקסן-אנהאלט	Sachsen-Anhalt
צפון דעקאטע	Nord-Dakota
בראנדנבורג	Brandenburg
דרום דעקאטע	Sør-Dakota
מאנטענע	Montana
וויאמינג	Wyoming
ירושלים	Jerusalem
איידעהא	Idaho
וואשינגטאן	Washington
נעוואדא	Nevada
אינדישער אקעאן	Indiahavet
קאראיבישער ים	Det karibiske hav
קורט וואלדהיים	Kurt Waldheim
קאלאראדא	Colorado
פרעדעריק שאפען	Frédéric Chopin
לענארד כהן	Leonard Cohen
קאַטעגאָריע:אינהאלט	Kategori:Kategorier
אלפן	Alpene
קארפאטן בערג	Karpatene
גרענאבלע	Grenoble
שיקאגא	Chicago
די ביטלס	The Beatles
ווינטער	Vinter
פרילינג	Vår
זומער	Sommer
הארבסט	Høst
סאדאם כוסעין	Saddam Hussein
אסאמא בין לאדען	Osama bin Laden
שפאניש	Spansk
מאנטעווידעא	Montevideo
יאהאן זעבאסטיאן באך	Johann Sebastian Bach
אנטאניא וויוואלדי	Antonio Vivaldi
פיטסבורג	Pittsburgh
אפערע	Opera
פילאדעלפיע	Philadelphia
קאלקאטא	Kolkata
דעלהי	Delhi
דאקא	Dhaka
שפין	Edderkopper
ארטראפאד	Leddyr
איסלאמאבאד	Islamabad
פרוכט	Frukt
מאלפע	Apekatter
געלט	Penger
ווירדזשיניע	Virginia
וועסט ווירדזשיניע	Vest-Virginia
מאטערהארן	Matterhorn
ניו יארק	New York (delstat)
ראוד איילענד	Rhode Island
אינסעקט	Insekter
מארילאנד	Maryland
דעלעווער	Delaware
וולאדימיר לענין	Vladimir Lenin
אהאיא	Ohio
ווערגיל	Vergil
ניקאלא מאקיאוועלי	Niccolò Machiavelli
פענסילוועניע	Pennsylvania
איטערזען	Uetersen
אויגוסטוס	Augustus
Windows	Microsoft Windows
ניו זשערסי	New Jersey
גיבראלטאר	Gibraltar
פיניש	Finsk
אינדיאנע	Indiana
אויטאמאביל	Bil
טריאנוס	Trajan
דזשארדזיע	Georgia (USA)
זאגרעב	Zagreb
ראדזשאסטהאן	Rajasthan
טעקסאס	Texas
טאמיל נאדו	Tamil Nadu
יאנאווע (איטאליע)	Genova
ברונא מארס	Bruno Mars
צפון קאראליינע	Nord-Carolina
דרום קאראליינע	Sør-Carolina
סיציליע	Sicilia
מאנילא	Manila
סארדיניע	Sardinia
סעבו	Cebu City
בארדא	Bordeaux
קארי אקינא	Corazón Aquino
בוענאס איירעס	Buenos Aires
העקער	Datasnok
מעקסיקא שטאט	Mexico by
טאקיא	Tokyo
לא פאז	La Paz
בארצעלאנע	Barcelona
מיסיסיפי	Mississippi
פערדינאנד מאגעלאן	Ferdinand Magellan
מיסיסיפי טייך	Mississippi (elv)
אוטאר פראדעש	Uttar Pradesh
אוטאראקהאנד	Uttarakhand
שווים באסיין	Svømmebasseng
טענעסי	Tennessee
ריכארד וואגנער	Richard Wagner
אבידזשאן	Abidjan
אסטאנא	Astana
ניו מעקסיקא	New Mexico
אטען	Athen
מינעסאטע	Minnesota
באגדאד	Bagdad
קאראקאס	Caracas
וויסקאנסין	Wisconsin
אייאווע	Iowa
נעבראסקא	Nebraska
גוואטעמאלע שטאט	Guatemala by
קענזעס	Kansas
האוואנע	Havanna
טאבאק	Tobakk
אינטערנעט עקספלארער	Internet Explorer
ציגאר	Sigar
פאפיראס	Sigarett
מיזורי	Missouri
לואיזיאנא	Louisiana
קענטאקי	Kentucky
ארקענסא	Arkansas
ניל ארמסטראנג	Neil Armstrong
אורדו	Urdu
עדיט פיאף	Édith Piaf
אקלעהאמע	Oklahoma
דוניי	Donau
צפון ים	Nordsjøen
האנאווער	Hannover
מיינץ	Mainz
וויסבאדן	Wiesbaden
ראגוזא	Dubrovnik
זארבריקן	Saarbrücken
מינכן	München
ערפורט	Erfurt
דרעזדן	Dresden
וויען	Wien
מאדאנא	Madonna (artist)
קאפנהאגן	København
קאלינינגראד אבלאסט	Kaliningrad oblast
שטאקהאלם	Stockholm
העלסינקי	Helsingfors
דובלין	Dublin
רעקיאוויק	Reykjavík
טאלין	Tallinn
ריגע	Riga
לואי ארמסטראנג	Louis Armstrong
בראטיסלאווא	Bratislava
בודאפעשט	Budapest
דאנציג	Gdańsk
פראנקפורט	Frankfurt am Main
ברעסלוי	Wrocław
קאטאליציזם	Katolisisme
ביבל	Bibelen
הא טשי מין שטאט	Ho Chi Minh-byen
האנוי	Hanoi
ענגליש	Engelsk
באנגקאק	Bangkok
אדעס	Odessa
קאנסעפסיאן	Concepción
דיפלאמאטיע	Diplomati
קיעוו	Kiev
אנטעריא	Ontario
אטאווא	Ottawa
דזשובא	Juba
מאניטאבא	Manitoba
אלבערטא	Alberta
נאווע סקאשע	Nova Scotia
יערעוואן	Jerevan
קאנסקאוואלע	Końskowola
דאר עס סאלאאם	Dar-es-Salaam
ניו בראנזוויק	New Brunswick
בריטישע קאלומביע	Britisk Columbia
2000	2000
2003	2003
2002	2002
2001	2001
סאסקאטשעווען	Saskatchewan
2012	2012
2011	2011
2010	2010
2009	2009
קוילן זייערס	Karbondioksid
2013	2013
2014	2014
2015	2015
נייפונדלאנד און לאבראדאר	Newfoundland og Labrador
2008	2008
נארדוועסט טעריטאריעס	Nordvestterritoriene
יוקאן	Yukon
2004	2004
וויקיטרעוול	Wikitravel
2005	2005
2006	2006
2007	2007
1900	1900
1901	1901
שארל דע גאל	Charles de Gaulle
1902	1902
פירענצע	Firenze
1903	1903
1904	1904
1905	1905
1907	1907
1906	1906
1908	1908
1909	1909
1992	1992
1991	1991
1990	1990
1993	1993
1994	1994
1995	1995
1996	1996
1910	1910
1911	1911
1912	1912
1913	1913
1914	1914
1915	1915
1916	1916
1997	1997
1998	1998
נירנבערג	Nürnberg
1999	1999
1917	1917
1918	1918
עסנווארג	Mat
דיסבורג	Duisburg
שלאנג	Slanger
זשאק שיראק	Jacques Chirac
גיך פון ליכט	Lysets hastighet
ארעל סעקס	Oralsex
אשפג	LOL
1טן יאנואר	1. januar
2טן יאנואר	2. januar
1920	1920
3טן יאנואר	3. januar
1919	1919
1921	1921
1922	1922
4טן יאנואר	4. januar
1923	1923
ביאביא ראיאן	Biobío
1924	1924
קארליק פלאנעט	Dvergplanet
5טן יאנואר	5. januar
אריקא	Arica
מאלמע	Malmö
6טן יאנואר	6. januar
עלעקטראן	Elektron
7טן יאנואר	7. januar
8טן יאנואר	8. januar
9טן יאנואר	9. januar
10טן יאנואר	10. januar
11טן יאנואר	11. januar
12טן יאנואר	12. januar
13טן יאנואר	13. januar
בירמינגהאם	Birmingham
14טן יאנואר	14. januar
15טן יאנואר	15. januar
16טן יאנואר	16. januar
17טן יאנואר	17. januar
18טן יאנואר	18. januar
19טן יאנואר	19. januar
20סטן יאנואר	20. januar
אינדוסטריעלע רעוואלוציע	Den industrielle revolusjon
21סטן יאנואר	21. januar
22סטן יאנואר	22. januar
23סטן יאנואר	23. januar
רוימישע אימפעריע	Det romerske keiserriket
24סטן יאנואר	24. januar
25סטן יאנואר	25. januar
מינסק	Minsk
26סטן יאנואר	26. januar
מייקראסאפט	Microsoft
27סטן יאנואר	27. januar
28סטן יאנואר	28. januar
29סטן יאנואר	29. januar
30סטן יאנואר	30. januar
31סטן יאנואר	31. januar
פראטאן	Proton
2טן דעצעמבער	2. desember
1טן דעצעמבער	1. desember
3טן דעצעמבער	3. desember
7טן דעצעמבער	7. desember
5טן דעצעמבער	5. desember
8טן דעצעמבער	8. desember
10טן דעצעמבער	10. desember
6טן דעצעמבער	6. desember
9טן דעצעמבער	9. desember
פינק פלויד	Pink Floyd
4טן דעצעמבער	4. desember
1טן פעברואר	1. februar
2טן פעברואר	2. februar
3טן פעברואר	3. februar
קאריוו	Kurów
4טן פעברואר	4. februar
5טן פעברואר	5. februar
6טן פעברואר	6. februar
7טן פעברואר	7. februar
8טן פעברואר	8. februar
9טן פעברואר	9. februar
10טן פעברואר	10. februar
כעמיע	Kjemi
14טן פעברואר	14. februar
13טן פעברואר	13. februar
15טן פעברואר	15. februar
11טן פעברואר	11. februar
12טן פעברואר	12. februar
סמאלענסק	Smolensk
19טן פעברואר	19. februar
17טן פעברואר	17. februar
16טן פעברואר	16. februar
18טן פעברואר	18. februar
20סטן פעברואר	20. februar
אנאליטישע כעמיע	Analytisk kjemi
נייטראן	Nøytron
21סטן פעברואר	21. februar
22סטן פעברואר	22. februar
23סטן פעברואר	23. februar
24סטן פעברואר	24. februar
25סטן פעברואר	25. februar
26סטן פעברואר	26. februar
27	27
27סטן פעברואר	27. februar
28סטן פעברואר	28. februar
11טן דעצעמבער	11. desember
29סטן פעברואר	29. februar
12טן דעצעמבער	12. desember
וויזועל בייסיק	Visual Basic
13טן דעצעמבער	13. desember
14טן דעצעמבער	14. desember
15טן דעצעמבער	15. desember
2טן מערץ	2. mars
3טן מערץ	3. mars
5טן מערץ	5. mars
1טן מערץ	1. mars
7טן מערץ	7. mars
8טן מערץ	8. mars
4טן מערץ	4. mars
10טן מערץ	10. mars
11טן מערץ	11. mars
6טן מערץ	6. mars
13טן מערץ	13. mars
9טן מערץ	9. mars
12טן מערץ	12. mars
15טן מערץ	15. mars
14טן מערץ	14. mars
++C	C++
16טן דעצעמבער	16. desember
17טן דעצעמבער	17. desember
16טן מערץ	16. mars
17טן מערץ	17. mars
18טן מערץ	18. mars
19טן מערץ	19. mars
1989	1989
1988	1988
20סטן מערץ	20. mars
1987	1987
1986	1986
1985	1985
1984	1984
21סטן מערץ	21. mars
1983	1983
22סטן מערץ	22. mars
1982	1982
1981	1981
18טן דעצעמבער	18. desember
1980	1980
23סטן מערץ	23. mars
מאגאדישו	Mogadishu
19טן דעצעמבער	19. desember
24סטן מערץ	24. mars
25סטן מערץ	25. mars
20סטן דעצעמבער	20. desember
26סטן מערץ	26. mars
27סטן מערץ	27. mars
28סטן מערץ	28. mars
29סטן מערץ	29. mars
30סטן מערץ	30. mars
31סטן מערץ	31. mars
סאנא	Sanaá
1970	1970
1971	1971
1972	1972
1973	1973
1974	1974
1975	1975
1976	1976
1977	1977
1978	1978
1979	1979
1969	1969
דרייסיג יעריגער קריג	Tredveårskrigen
קאנראד אדענאער	Konrad Adenauer
15טן אפריל	15. april
13טן אפריל	13. april
12טן אפריל	12. april
14טן אפריל	14. april
11טן אפריל	11. april
10טן אפריל	10. april
8טן אפריל	8. april
9טן אפריל	9. april
7טן אפריל	7. april
6טן אפריל	6. april
5טן אפריל	5. april
4טן אפריל	4. april
3טן אפריל	3. april
1טן אפריל	1. april
2טן אפריל	2. april
16טן אפריל	16. april
17טן אפריל	17. april
18טן אפריל	18. april
19טן אפריל	19. april
20סטן אפריל	20. april
21סטן אפריל	21. april
22סטן אפריל	22. april
23סטן אפריל	23. april
24סטן אפריל	24. april
25סטן אפריל	25. april
26סטן אפריל	26. april
27סטן אפריל	27. april
28סטן אפריל	28. april
29סטן אפריל	29. april
30סטן אפריל	30. april
1טן מיי	1. mai
2טן מיי	2. mai
3טן מיי	3. mai
4טן מיי	4. mai
5טן מיי	5. mai
6טן מיי	6. mai
7טן מיי	7. mai
8טן מיי	8. mai
9טן מיי	9. mai
10טן מיי	10. mai
11טן מיי	11. mai
12טן מיי	12. mai
13טן מיי	13. mai
14טן מיי	14. mai
15טן מיי	15. mai
16טן מיי	16. mai
17טן מיי	17. mai
18טן מיי	18. mai
19טן מיי	19. mai
20סטן מיי	20. mai
21סטן מיי	21. mai
22סטן מיי	22. mai
23סטן מיי	23. mai
24סטן מיי	24. mai
25סטן מיי	25. mai
26סטן מיי	26. mai
27סטן מיי	27. mai
28סטן מיי	28. mai
29סטן מיי	29. mai
30סטן מיי	30. mai
31סטן מיי	31. mai
21סטן דעצעמבער	21. desember
14טן יוני	14. juni
15טן יוני	15. juni
13טן יוני	13. juni
10טן יוני	10. juni
7טן יוני	7. juni
11טן יוני	11. juni
9טן יוני	9. juni
12טן יוני	12. juni
6טן יוני	6. juni
8טן יוני	8. juni
5טן יוני	5. juni
3טן יוני	3. juni
2טן יוני	2. juni
1טן יוני	1. juni
4טן יוני	4. juni
נאפאלי	Napoli
22סטן דעצעמבער	22. desember
1968	1968
1967	1967
1966	1966
1965	1965
1964	1964
16טן יוני	16. juni
פאלערמא	Palermo
30סטן יוני	30. juni
29סטן יוני	29. juni
28סטן יוני	28. juni
26סטן יוני	26. juni
25סטן יוני	25. juni
22סטן יוני	22. juni
27סטן יוני	27. juni
24סטן יוני	24. juni
20סטן יוני	20. juni
23סטן יוני	23. juni
19טן יוני	19. juni
18טן יוני	18. juni
21סטן יוני	21. juni
17טן יוני	17. juni
23סטן דעצעמבער	23. desember
ברוס וויליס	Bruce Willis
ארנאלד שווארצענעגער	Arnold Schwarzenegger
15טן יולי	15. juli
13טן יולי	13. juli
12טן יולי	12. juli
10טן יולי	10. juli
9טן יולי	9. juli
14טן יולי	14. juli
8טן יולי	8. juli
7טן יולי	7. juli
6טן יולי	6. juli
5טן יולי	5. juli
2טן יולי	2. juli
4טן יולי	4. juli
3טן יולי	3. juli
1טן יולי	1. juli
11טן יולי	11. juli
24סטן דעצעמבער	24. desember
31סטן יולי	31. juli
30סטן יולי	30. juli
29סטן יולי	29. juli
28סטן יולי	28. juli
27סטן יולי	27. juli
25סטן יולי	25. juli
24סטן יולי	24. juli
23סטן יולי	23. juli
26סטן יולי	26. juli
22סטן יולי	22. juli
19טן יולי	19. juli
21סטן יולי	21. juli
20סטן יולי	20. juli
17טן יולי	17. juli
18טן יולי	18. juli
16טן יולי	16. juli
פוטבאל	Fotball
25סטן דעצעמבער	25. desember
1963	1963
26סטן דעצעמבער	26. desember
חורבן אייראפע	Holocaust
1962	1962
IPhone	IPhone
14טן אויגוסט	14. august
15טן אויגוסט	15. august
13טן אויגוסט	13. august
12טן אויגוסט	12. august
11טן אויגוסט	11. august
10טן אויגוסט	10. august
8טן אויגוסט	8. august
7טן אויגוסט	7. august
9טן אויגוסט	9. august
5טן אויגוסט	5. august
4טן אויגוסט	4. august
2טן אויגוסט	2. august
3טן אויגוסט	3. august
6טן אויגוסט	6. august
1טן אויגוסט	1. august
קעמניץ	Chemnitz
27סטן דעצעמבער	27. desember
מאדריד	Madrid
סובמארין	Undervannsbåt
16טן אויגוסט	16. august
קאקא קאלע	Coca-Cola
29סטן אויגוסט	29. august
28סטן אויגוסט	28. august
30סטן אויגוסט	30. august
25סטן אויגוסט	25. august
26סטן אויגוסט	26. august
23סטן אויגוסט	23. august
27סטן אויגוסט	27. august
21סטן אויגוסט	21. august
20סטן אויגוסט	20. august
24סטן אויגוסט	24. august
18טן אויגוסט	18. august
17טן אויגוסט	17. august
22סטן אויגוסט	22. august
19טן אויגוסט	19. august
31סטן אויגוסט	31. august
מייקל זשעקסאן	Michael Jackson
28סטן דעצעמבער	28. desember
גריפע	Influensa
באגאטא	Bogotá
בראזיליא	Brasília
15טן סעפטעמבער	15. september
14טן סעפטעמבער	14. september
13טן סעפטעמבער	13. september
12טן סעפטעמבער	12. september
8טן סעפטעמבער	8. september
11טן סעפטעמבער	11. september
7טן סעפטעמבער	7. september
10טן סעפטעמבער	10. september
5טן סעפטעמבער	5. september
4טן סעפטעמבער	4. september
9טן סעפטעמבער	9. september
2טן סעפטעמבער	2. september
6טן סעפטעמבער	6. september
1טן סעפטעמבער	1. september
3טן סעפטעמבער	3. september
29סטן דעצעמבער	29. desember
לימא	Lima
קאנאדישע פראווינצן	Canadas provinser og territorier
30סטן סעפטעמבער	30. september
29סטן סעפטעמבער	29. september
28סטן סעפטעמבער	28. september
27סטן סעפטעמבער	27. september
26סטן סעפטעמבער	26. september
25סטן סעפטעמבער	25. september
סאנטיאגא	Santiago de Chile
23סטן סעפטעמבער	23. september
22סטן סעפטעמבער	22. september
24סטן סעפטעמבער	24. september
21סטן סעפטעמבער	21. september
20סטן סעפטעמבער	20. september
18טן סעפטעמבער	18. september
17טן סעפטעמבער	17. september
19טן סעפטעמבער	19. september
16טן סעפטעמבער	16. september
קיטא	Quito
30סטן דעצעמבער	30. desember
31סטן דעצעמבער	31. desember
1טן אקטאבער	1. oktober
15טן אקטאבער	15. oktober
12טן אקטאבער	12. oktober
10טן אקטאבער	10. oktober
14טן אקטאבער	14. oktober
9טן אקטאבער	9. oktober
8טן אקטאבער	8. oktober
13טן אקטאבער	13. oktober
7טן אקטאבער	7. oktober
11טן אקטאבער	11. oktober
6טן אקטאבער	6. oktober
4טן אקטאבער	4. oktober
5טן אקטאבער	5. oktober
3טן אקטאבער	3. oktober
2טן אקטאבער	2. oktober
אסונסיאן	Asunción
ציג	Geit
31סטן אקטאבער	31. oktober
30סטן אקטאבער	30. oktober
29סטן אקטאבער	29. oktober
28סטן אקטאבער	28. oktober
26סטן אקטאבער	26. oktober
25סטן אקטאבער	25. oktober
24סטן אקטאבער	24. oktober
27סטן אקטאבער	27. oktober
22סטן אקטאבער	22. oktober
23סטן אקטאבער	23. oktober
20סטן אקטאבער	20. oktober
21סטן אקטאבער	21. oktober
19טן אקטאבער	19. oktober
17טן אקטאבער	17. oktober
16טן אקטאבער	16. oktober
18טן אקטאבער	18. oktober
היידלבערג	Heidelberg
פריי	Frihet
15טן נאוועמבער	15. november
14טן נאוועמבער	14. november
13טן נאוועמבער	13. november
12טן נאוועמבער	12. november
11טן נאוועמבער	11. november
10טן נאוועמבער	10. november
7טן נאוועמבער	7. november
8טן נאוועמבער	8. november
9טן נאוועמבער	9. november
6טן נאוועמבער	6. november
5טן נאוועמבער	5. november
4טן נאוועמבער	4. november
3טן נאוועמבער	3. november
2טן נאוועמבער	2. november
1טן נאוועמבער	1. november
פאראמאריבא	Paramaribo
30סטן נאוועמבער	30. november
29סטן נאוועמבער	29. november
28סטן נאוועמבער	28. november
27סטן נאוועמבער	27. november
26סטן נאוועמבער	26. november
25סטן נאוועמבער	25. november
23סטן נאוועמבער	23. november
24סטן נאוועמבער	24. november
21סטן נאוועמבער	21. november
20סטן נאוועמבער	20. november
22סטן נאוועמבער	22. november
19טן נאוועמבער	19. november
18טן נאוועמבער	18. november
17טן נאוועמבער	17. november
16טן נאוועמבער	16. november
מיידל	Jente
קאטמאנדו	Katmandu
העלגאלאנד	Helgoland
בעלמאפאן	Belmopan
קארל דער גרויסער	Karl den store
פיורדא	Fürth
סאן סאלוואדאר	San Salvador
קאנבערא	Canberra
סידני	Sydney
גרין	Grønn
האדסאן טייך	Hudson (elv)
מעלבארן	Melbourne
רויט	Rød
פייער	Ild
ערד'ס אטמאספער	Jordens atmosfære
טעגוסיגאלפע	Tegucigalpa
מאנאגוע	Managua
פאנאמא-שטאט	Panama by
נילוס	Nilen
הארטפארדשיר	Hertfordshire
אסקאר (פיש)	Oscar (fisk)
קאנגא טייך	Kongo (elv)
בארי	Bari
ניזשער טייך	Niger (elv)
ראבאט, מאראקא	Rabat
קאמעט	Komet
אלזשירס	Alger
טריפאלי	Tripoli
דזשיבוטי (שטאט)	Djibouti (by)
אנטאפאגאסטא	Antofagasta
טעהראן	Teheran
אדיס אבאבא	Addis Abeba
דזשאקארטא	Jakarta
אנקארא	Ankara
נ'דזשאמענא	N'Djamena
ניאמיי	Niamey
נואקשוט	Nouakchott
ריאד	Riyadh
1961	1961
באמאקא	Bamako
בעלגראד	Beograd
דאקאר	Dakar
באנזשול	Banjul
קאנאקרי	Conakry
ביסאו	Bissau
קאַטעגאָריע:וויקיפעדיע מוסטערן	Kategori:Maler
קאסטרא (טשילע)	Castro (Chile)
מאנראוויע	Monrovia
1960	1960
קאַטעגאָריע:מוסטערן קאטעגאריעס	Kategori:Maler etter tema
אקרא	Accra
דמשק	Damaskus
יאמוסאקרא	Yamoussoukro
פראנצויזישע גויאנע	Fransk Guyana
וואגאדוגו	Ouagadougou
פריטאון	Freetown
אמאזאנאס (טייך)	Amazonas
אבודזשא	Abuja
לאמע	Lomé
פארטא-נאווא	Porto-Novo
אמאן (יארדן)	Amman
יאונדע	Yaoundé
ביירוט	Beirut
ליברעוויל	Libreville
קאַטעגאָריע:היסטאריע מוסטערן	Kategori:Historiemaler
קינשאזע	Kinshasa
בראזאוויל	Brazzaville
ווארמז	Worms
בוזשומבורע	Bujumbura
ניקאסיע	Nikosia
קיגאלי	Kigali
דאכא	Doha
אסטערויד	Asteroide
דאדאמא	Dodoma
נייראבי	Nairobi
לילאנגווע	Lilongwe
קאַטעגאָריע:געאגראפישע מוסטערן	Kategori:Geografimaler
לוסאקא	Lusaka
ליקוי חמה	Solformørkelse
מאפוטא	Maputo
קאמפאלא	Kampala
לואנדע	Luanda
מבאבאנע	Mbabane
מאסערו	Maseru
אלבערט דער צווייטער פון בעלגיע	Albert II av Belgia
בינארישע סיסטעם	Binært tallsystem
שולע	Skole
אנטאנאנאריווא	Antananarivo
אוניווערסיטעט	Universitet
גאבאראנע	Gaborone
הארארע	Harare
ווינטהוק	Windhoek
װיקיפּעדיע:זאמדקאסטן	Wikipedia:Sandkasse
װיקיפּעדיע:ברוכים הבאים	Wikipedia:Introduksjon
הויז	Hus
שויס קאמפיוטער	Bærbar datamaskin
הארטווארג	Maskinvare
אלגעברע	Algebra
ליעזש	Liège
מענטשלעכע אנאטאמיע	Menneskets anatomi
מאפע	Kart
טייך	Elv
פראנקפורט אן דער אדער	Frankfurt (Oder)
אזאסקו	Osasco
גלאזגא	Glasgow
באדען-באדען	Baden-Baden
דאנג הוי לופטפעלד	Dong Hoi lufthavn
קאסמאס	Ytre rom
לוצערן	Luzern
טעלעסקאפ	Teleskop
מיילי סיירוס	Miley Cyrus
הויפט טאוול	Hovedkort
קוריטיבא	Curitiba
מערב אפריקע	Vest-Afrika
וואלד	Skog
הארטער דיסק	Platelager
מיט ראמני	Mitt Romney
פלאט	Marine
אנדאליען (טייך)	Andalién
בארשט	Borsjtsj
ספר איוב	Jobs bok
ראנקאגווע	Rancagua
אנע פראנק	Anne Frank
קאנפוציוס	Konfucius
שרה בערנאר	Sarah Bernhardt
מארלין דיטריך	Marlene Dietrich
מארלין מאנרא	Marilyn Monroe
קארבין בלו	Corbin Bleu
קאַטעגאָריע:מאטעמאטיק	Kategori:Matematikk
בארברא סטרייסאנד	Barbra Streisand
פולא	Pula
רענעסאנס	Renessansen
לע קארבוזיע	Le Corbusier
איירא	Euro
אמעריקאנער דאלאר	Amerikansk dollar
מיטלענדישער ים	Middelhavet
זשארזשיע	Georgia (andre betydninger)
סעב-מילער	SABMiller
קריסטנטום	Kristendom
סיאטל	Seattle
בערלינער וואנט	Berlinmuren
גאנגעס	Ganges
רייז	Ris
באלטימאר, מערילענד	Baltimore
קאנטינענט	Kontinent
פויגל	Fugler
הויפטשטאט	Hovedstad
פארטוגעזיש	Portugisisk
מאנאט	Måned
מוסטאפא קעמאל אטאטורק	Mustafa Kemal Atatürk
1948	1948
רונדווערעם	Rundormer
1949	1949
הואנג קסיאנפאן	Huang Xian-fan
1956	1956
1202	1202
1204	1204
1941	1941
1945	1945
1958	1958
1926	1926
1947	1947
1944	1944
1952	1952
בריליאנט	Diamant
ביל גייטס	Bill Gates
יאפאניש	Japansk
עקראן	Skjerm (monitor)
ענציקלאפעדיע	Encyklopedi
דיסקעט	Diskett
RAM זיכרון	RAM
הויפט זייט	Portal:Forside
פראצעסאר	CPU
1959	1959
מוסטער:גוטער ארטיקל	Mal:Anbefalt
1957	1957
רוטירער	Ruter (IT)
רעזיסטאר	Motstand (resistor)
קאנדענסאטאר	Kondensator (elektrisk)
אינדוקטאר	Spole (induktans)
טראנזיסטאר	Transistor
בעיסבאל	Baseball
קוישבאל	Basketball
קריקעט	Cricket
גאלף (שפיל)	Golf
ראגבי פוטבאל	Rugby (sport)
אויטאספארט	Bilsport
אלימפיאדע	Olympiske leker
יאנגצע	Chang Jiang
מיזורי טייך	Missouri (elv)
סיביר	Sibir
פראנסיסקא גאיא	Francisco Goya
הימאלייע	Himalaya
אנדן	Andes
ראקי בערג	Rocky Mountains
קאפשטאט	Cape Town
טראוויזיע	Treviso
קאווקאז בערג	Kaukasus
קאספישער ים	Det kaspiske hav
אונטערגרונט באן	Tunnelbane
וויקטאריע אזערע	Victoriasjøen
טאנגאניקע אזערע	Tanganyikasjøen
בייקאל אזערע	Bajkalsjøen
סאלוואדאר דאלי	Salvador Dalí
אלברעכט דירער	Albrecht Dürer
ווינצענט וואן גאך	Vincent van Gogh
קאצושיקא האקוסיי	Katsushika Hokusai
פרידא קאהלא	Frida Kahlo
אנרי מאטיס	Henri Matisse
מיקעלאנדזשעלא	Michelangelo
פאבלא פיקאסא	Pablo Picasso
ראפאעל	Rafael
רעמבראנדט	Rembrandt
פעטער פאל רובענס	Peter Paul Rubens
סינאן	Mimar Sinan
ענדי ווארהאל	Andy Warhol
פרענק לויד רייט	Frank Lloyd Wright
מאדעם	Modem
עמינעם	Eminem
בוס	Buss
טראמוויי	Sporvei
אבו נואס	Abu Nuwas
האנס קריסטיאן אנדערסען	H.C. Andersen
מאצוא באשא	Matsuo Basho
לארד בייראן	Lord Byron
מיגעל דע סערוואנטעס	Miguel de Cervantes
דזשעפרי טשאסער	Geoffrey Chaucer
בבל	Babylon
אנטאן פאוולאוויטש טשעכאוו	Anton Tsjekhov
טשארלס דיקנס	Charles Dickens
יריחו	Jeriko
סאמארקאנד	Samarkand
באלעארישע אינזלען	Balearene
בית לחם	Betlehem
מעקא	Mekka
טשע געווארא	Che Guevara
קאנארישע אינזלען	Kanariøyene
מאא צעטאנג	Mao Zedong
קארדאבע	Córdoba (Spania)
טאלעדא	Toledo
קאבול	Kabul
בית הכסא פאפיר	Toalettpapir
גבריאל גארסיא מארקעס	Gabriel García Márquez
יאהאן וואלפגאנג פאן געטע	Johann Wolfgang von Goethe
וואגינע	Vagina
טאמיל	Tamilsk
ארגאזם	Orgasme
פילאסאפיע	Filosofi
קאסמאס-פארן	Romfart
משפחה מענטש	Familien Griffin
קאַטעגאָריע:געשטעלטע צו שנעל מעקן	Kategori:Sider som er foreslått raskt slettet
פיאנע	Piano
ראפ מוזיק	Rapping
פופציק צענט	50 Cent
טיי	Te
מארקא פאלא	Marco Polo
קאמוניזם	Kommunisme
אנארכיזם	Anarkisme
קאפיטאליזם	Kapitalisme
ליבעראליזם	Liberalisme
פאשיזם	Fascisme
נאציאנאליזם	Nasjonalisme
כאפעז	Hafez
פאלק (נאציאן)	Nasjon
צווייטע פונישע מלחמה	Andre punerkrig
דזשאו ביידען	Joe Biden
הילערי ראדהעם קלינטאן	Hillary Clinton
אינדיאנאפאליס	Indianapolis
בלעטערער	Nettleser
בריטישער מוזיי	British Museum
שווימען	Svømming
קאַטעגאָריע:אסטראנאמיע	Kategori:Astronomi
דארדאנעלן	Dardanellene
זשאן-זשאק רוסא	Jean-Jacques Rousseau
סטאניסלאוו לעם	Stanisław Lem
פראנצויזישע רעוואלוציע	Den franske revolusjon
1550	1550
1551	1551
קאַטעגאָריע:אסטראנאמען	Kategori:Astronomer
1552	1552
1553	1553
1554	1554
האמסטער	Hamstere
אירקוצק	Irkutsk
סאהארא	Sahara
1556	1556
1557	1557
1558	1558
שטראסבורג	Strasbourg
גיטאר	Gitar
1559	1559
1560	1560
1561	1561
1562	1562
1563	1563
1564	1564
1565	1565
האמאסעקסואלוטעט	Homofili
1566	1566
1567	1567
1568	1568
1569	1569
קראאטיש	Kroatisk
1570	1570
1571	1571
1572	1572
1573	1573
1574	1574
1575	1575
האמעראס	Homer
אלעקסאנדער פאן האמבאלט	Alexander von Humboldt
1576	1576
1577	1577
1578	1578
1579	1579
1580	1580
1581	1581
1582	1582
1600	1600
קארל פרידריך גאוס	Carl Friedrich Gauss
UTC+2	UTC+02.00
1601	1601
1583	1583
1602	1602
1584	1584
פערפיניאן	Perpignan
1603	1603
1585	1585
1604	1604
1586	1586
1605	1605
1587	1587
1606	1606
1607	1607
1588	1588
1608	1608
1589	1589
1609	1609
1590	1590
1610	1610
1591	1591
1611	1611
1592	1592
1612	1612
1593	1593
1613	1613
1594	1594
1614	1614
1595	1595
1615	1615
1596	1596
1616	1616
1597	1597
1617	1617
1598	1598
1618	1618
1599	1599
1619	1619
1620	1620
1621	1621
1700	1700
1701	1701
1622	1622
1623	1623
1702	1702
1624	1624
1703	1703
1704	1704
1625	1625
1705	1705
1626	1626
1627	1627
1706	1706
1628	1628
1707	1707
1708	1708
1629	1629
1630	1630
1709	1709
1631	1631
1710	1710
1632	1632
1711	1711
1633	1633
1712	1712
1634	1634
1713	1713
1800	1800
1801	1801
1714	1714
1635	1635
דזשיימס דזשויס	James Joyce
1802	1802
1715	1715
1636	1636
1803	1803
1637	1637
1716	1716
1638	1638
1804	1804
1717	1717
1639	1639
1805	1805
1718	1718
1640	1640
1719	1719
1806	1806
1641	1641
1720	1720
1807	1807
1642	1642
1721	1721
1808	1808
1643	1643
1722	1722
1809	1809
1644	1644
1723	1723
1810	1810
1645	1645
1724	1724
20סטער י"ה	20. århundre
1811	1811
1646	1646
1725	1725
1812	1812
1647	1647
1726	1726
1813	1813
21סטער י"ה	21. århundre
1648	1648
1727	1727
1814	1814
1649	1649
1728	1728
1815	1815
1650	1650
1729	1729
1816	1816
19טער י"ה	19. århundre
1651	1651
1730	1730
1817	1817
1652	1652
1731	1731
1818	1818
1653	1653
1732	1732
1819	1819
1654	1654
1733	1733
1820	1820
1655	1655
1821	1821
1734	1734
1656	1656
1822	1822
1735	1735
1657	1657
1823	1823
1736	1736
1658	1658
1737	1737
1824	1824
1659	1659
1738	1738
1825	1825
1660	1660
1739	1739
1826	1826
1661	1661
1740	1740
1827	1827
קאלידאסא	Kālidāsa
18טער י"ה	18. århundre
17טער י"ה	17. århundre
16טער י"ה	16. århundre
15טער י"ה	15. århundre
לוגאנא	Lugano
קאטאלאניש	Katalansk
14טער י"ה	14. århundre
זשיראנע	Girona
13טער י"ה	13. århundre
12טער י"ה	12. århundre
11טער י"ה	11. århundre
אטעאיזם	Ateisme
לי באי	Li Bai
ביבליאטעק	Bibliotek
דאכוי	Dachau
מאטעריאליזם	Materialisme
ניעלס באהר	Niels Bohr
באוואוסטזיין	Bevissthet
ביאכעמיע	Biokjemi
ביאטעכנאלאגיע	Bioteknologi
עקאלאגיע	Økologi
אפריקאנער פארבאנד	Den afrikanske union
גענעטיק	Genetikk
פאליטיק	Politikk
וועלט באנק	Verdensbanken
קאלאניאליזם	Kolonialisme
קאנסערוואטיזם	Konservatisme
אראבישע ליגע	Den arabiske liga
דעמאקראטיע	Demokrati
נאגיב מאכפוז	Naguib Mahfouz
רויטער קרייץ	Røde Kors
גלאבאליזאציע	Globalisering
נאט"א	NATO
מארי קירי	Marie Curie
גען	Gen
רעגירונג	Regjering
נאבעל פריז	Nobelprisen
קין שי הואנג	Qin Shi Huangdi
מיקראביאלאגיע	Mikrobiologi
סימאן דע באוואר	Simone de Beauvoir
אווידיוס	Ovid
מארסעל פרוסט	Marcel Proust
אלעקסאנדער פושקין	Aleksandr Pusjkin
מיטל מזרח	Midtøsten
פאלעאנטאלאגיע	Paleontologi
עליזאבעט די ערשטע	Elisabeth I av England
האן דינאסטיע	Han-dynastiet
טאקסאנאמיע	Taksonomi
וויראלאגיע	Virologi
זשאן ד'ארק	Jeanne d’Arc
ראזא לוקסעמבורג	Rosa Luxemburg
סאפאקלעס	Sofokles
ארגאניזם	Organisme
ראבינדראנאט טאגאר	Rabindranath Tagore
שיינקייט	Skjønnhet
לעוו טאלסטוי	Leo Tolstoj
מארק טוויין	Mark Twain
עלן טיורינג	Alan Turing
פעמיניזם	Feminisme
אידעאלאגיע	Ideologi
אימפעריאליזם	Imperialisme
מארקסיזם	Marxisme
קעניגרייך	Monarki
רעפובליק	Republikk
סאציאליזם	Sosialisme
מדינה	Stat
פאליטישע פארטיי	Politisk parti
פראפאגאנדע	Propaganda
טעראריזם	Terrorisme
יאהאנעס בראהמס	Johannes Brahms
קילימאנדזשארא	Kilimanjaro
אנטאנין דווארזשאק	Antonín Dvořák
געארג פרידריך הענדל	Georg Friedrich Händel
גוסטאוו מאהלער	Gustav Mahler
קוש	Kyss
נאציזם	Nasjonalsosialisme
דזיאקאמא פוטשיני	Giacomo Puccini
פראנץ שובערט	Franz Schubert
איגאר סטראווינסקי	Igor Stravinskij
פעטער איליטש טשייקאווסקי	Pjotr Tsjajkovskij
דזשוסעפע ווערדי	Giuseppe Verdi
נאצי דייטשלאנד	Tysklands historie (1933–1945)
זשאק קארטיער	Jacques Cartier
קריסטאפער קאלאמבוס	Christofer Columbus
דזשיימס קוק	James Cook
ייד	Jøder
הערנאן קארטעס	Hernán Cortés
יורי גאגארין	Jurij Gagarin
וואשקו דא גאמא	Vasco da Gama
איבן באטוטא	Ibn Battuta
זשענג הע	Zheng He
אוישוויץ	Auschwitz
אשפעצין	Oświęcim
גרויסער באריער ריף	Great Barrier Reef
גרויסע אזערעס	De store sjøer
אינדוס	Indus
יאזעף היידן	Joseph Haydn
פאנאמא קאנאל	Panamakanalen
דרום אקעאן	Sørishavet
געלער טייך	Den gule flod
אויער	Øre
נאז	Nese
אויג	Øye
מוסקל	Muskel
ליד	Sang
קאמאר	Stikkemygg
שאף	Tamsau
פעדעריקא פעליני	Federico Fellini
הייפיש	Haier
אלפרעד היטשקאק	Alfred Hitchcock
קעמל	Kameler
זויגער	Pattedyr
העלפאנד	Elefanter
פרימאט	Primater
מוראשקע	Maur
שטימע	Stemme
בין	Bier
ווייכווארג	Programvare
האלענדיש	Nederlandsk
מארגארעט טאטשער	Margaret Thatcher
עדה יאנאט	Ada Yonath
DNA	DNA
זגאל	Art
וואהלין	Volhynia
פאטלעזשאן	Aubergine
אינגמאר בערזשמאן	Ingmar Bergman
לוצק	Lutsk
איבערזעצונג	Oversettelse
קאטשקע	Andefamilien
מוטער	Mor
שניי	Snø
טאטע	Far
קינד	Barn
1828	1828
1829	1829
1741	1741
1662	1662
1742	1742
1830	1830
1663	1663
1831	1831
1743	1743
1664	1664
1665	1665
1744	1744
1832	1832
1666	1666
1745	1745
1833	1833
1667	1667
1746	1746
טראנספארט	Transport
1834	1834
1668	1668
1747	1747
1835	1835
1748	1748
1836	1836
1669	1669
לעאנהארד אוילער	Leonhard Euler
1670	1670
1749	1749
1837	1837
1671	1671
1750	1750
1838	1838
1672	1672
1751	1751
1839	1839
1673	1673
1752	1752
1840	1840
1674	1674
1753	1753
1841	1841
1754	1754
1675	1675
1842	1842
1755	1755
1676	1676
1843	1843
1677	1677
1756	1756
1844	1844
1678	1678
1757	1757
1845	1845
1679	1679
1758	1758
1846	1846
1680	1680
1759	1759
1847	1847
1681	1681
1760	1760
1848	1848
1682	1682
1761	1761
1849	1849
1683	1683
1762	1762
1850	1850
1684	1684
1763	1763
1851	1851
1764	1764
1685	1685
1852	1852
1686	1686
1765	1765
1853	1853
1687	1687
1766	1766
1854	1854
1688	1688
1767	1767
1855	1855
1689	1689
1768	1768
1856	1856
1690	1690
1769	1769
1857	1857
1691	1691
1770	1770
1858	1858
1692	1692
1771	1771
1859	1859
1693	1693
1772	1772
1860	1860
1773	1773
1861	1861
1694	1694
1695	1695
1774	1774
1862	1862
1696	1696
1775	1775
1863	1863
1697	1697
1776	1776
1864	1864
1698	1698
1865	1865
1777	1777
1699	1699
1866	1866
1778	1778
1779	1779
1867	1867
1780	1780
1868	1868
1781	1781
1869	1869
אוונט	Kveld
מינוט	Minutt
יידישע אויטאנאמע געגנט	Den jødiske autonome oblast
יהושע בן נון	Josva
רוסיש	Russisk
1782	1782
1870	1870
לואי דער פערצנטער	Ludvig XIV av Frankrike
1783	1783
1871	1871
וולאדימיר פוטין	Vladimir Putin
ראק און ראל	Rock and roll
1784	1784
1872	1872
מאטעמאטישער אנאליז	Matematisk analyse
קאנסטיטוציע	Konstitusjon
1785	1785
1873	1873
1786	1786
1874	1874
1787	1787
1875	1875
1788	1788
1876	1876
פארבאנד פון דרום-מזרח אזיאטישע פעלקער	Association of Southeast Asian Nations
ביראבידזשאן	Birobidzjan
1789	1789
1877	1877
1790	1790
1878	1878
קהל פון זעלבשטענדיקע שטאטן	Samveldet av uavhengige stater
1879	1879
1791	1791
קאמאנוועלט	Samveldet av nasjoner
היסטאריע פון אייראפע	Europas historie
היסטאריע פון גריכנלאנד	Hellas’ historie
אפעק	OPEC
אינטערנאציאנאלע געריכט פון יוסטיץ	Den internasjonale domstolen
ברויט	Brød
אינטערנאציאנאלער געלטפאנד	Det internasjonale pengefondet
1792	1792
1880	1880
1793	1793
1881	1881
אונעסקא	UNESCO
1794	1794
1882	1882
אלוועלטלעכע דעקלאראציע פון מענטשרעכט	Menneskerettighetserklæringen
1795	1795
1883	1883
װעלט געזונט ארגאניזאציע	Verdens helseorganisasjon
1796	1796
1884	1884
1797	1797
1885	1885
1886	1886
1798	1798
וועלט האנדל ארגאניזאציע	Verdens handelsorganisasjon
1887	1887
1799	1799
1888	1888
1889	1889
1890	1890
קרים	Krim
1891	1891
סוואהילי	Swahili
1892	1892
1893	1893
1894	1894
1895	1895
1896	1896
1897	1897
1898	1898
כינעזיש	Kinesisk
1899	1899
בית הכסא	Toalett
נאטור	Natur
טוש	Dusj
פסיכיאטריע	Psykiatri
צעל	Celle
בלוט	Blod
טולוז	Toulouse
סקעלעט	Skjelett
לונג	Lunge
אטעם-סיסטעם	Åndedrettssystemet
פארמערן סיסטעם	Forplantningssystem
רומעניש	Rumensk
בולגאריש	Bulgarsk
רעגן	Regn
לאווינע	Snøskred
קלימאט	Klima
על ניניא	El Niño
גלאבאלע אנווארעמען	Global oppvarming
ערדציטערניש	Jordskjelv
מינעראל	Mineral
אמת	Sannhet
ערד פלאטעס	Platetektonikk
זען בודהיזם	Zen
מויז (קאמפיוטער)	Datamus
נאטור-וויסנשאפטן	Naturvitenskap
סערגיי אייזנשטיין	Sergej Eisenstein
אקירא קוראסאווא	Akira Kurosawa
פרענקלין דעלאנא רוזעוועלט	Franklin D. Roosevelt
ערד וויסנשאפט	Geovitenskap
אוויצענא	Avicenna
דארבי מוזיי און קונסט גאלעריע	Derby Museum and Art Gallery
ווינסטאן טשערטשיל	Winston Churchill
אויגוסטינוס	Augustin av Hippo
נעלסאן מאנדעלע	Nelson Mandela
מארטין לוטער קינג	Martin Luther King jr.
ענזים	Enzym
10טער י"ה	10. århundre
פראטעין	Protein
ציגיינער	Sigøynere
שטיין	Bergart
נאטירלעכע קאטאסטראפע	Naturkatastrofe
פארפלייצונג	Flom
צונאמי	Tsunami
וואולקאן	Vulkan
וואלקן	Sky
לאגיק	Logikk
טארנאדא	Tornado
9טער י"ה	9. århundre
טריגאנאמעטריע	Trigonometri
8טער י"ה	8. århundre
געאמעטריע	Geometri
7טער י"ה	7. århundre
6טער י"ה	6. århundre
גראמאטיק	Grammatikk
שטורעם ווינט	Tropisk syklon
נינטענדא	Nintendo
ווינט	Vind
5טער י"ה	5. århundre
4טער י"ה	4. århundre
3טער י"ה	3. århundre
2טער י"ה	2. århundre
אטמאספער	Atmosfære
1טער י"ה	1. århundre
גרוזיניש	Georgisk
עקאנאמיק	Samfunnsøkonomi
קאפיטאל	Kapital
וואלוטע	Valuta
יאפאנעזער יען	Japansk yen
אינדוסטריע	Industri
שטייער	Skatt
לינגוויסטיק	Lingvistikk
ווארט	Ord
פאנעם	Fonem
טראף	Stavelse
שריפט	Skriftsystem
אראבישער אלפאבעט	Det arabiske alfabetet
כינעזישע שריפט	Kinesiske tegn
קירילישע שריפט	Det kyrilliske alfabetet
גריכישער אלפאבעט	Det greske alfabetet
האנגול	Hangul
לאטיינישער אלפאבעט	Det latinske alfabetet
ליטעראט	Lesekyndighet
קאַטעגאָריע:בולגאריע	Kategori:Bulgaria
ליטעראטור	Litteratur
קאַטעגאָריע:פראנקרייך	Kategori:Frankrike
די קונסט פון מלחמה	Kunsten å krige
בעלעטריסטיק	Fiksjon
קאַטעגאָריע:מוזיק	Kategori:Musikk
טויזנט און איין נעכט	Tusen og én natt
קאַטעגאָריע:ליטעראטור	Kategori:Litteratur
ראמאן	Roman
קאַטעגאָריע:דיכטונג	Kategori:Lyrikk
חלום פונעם רויטן קאמער	Drømmen om det røde kammeret
קאַטעגאָריע:היסטאריע: פראנקרייך	Kategori:Frankrikes historie
אייראזאנע	Eurosonen
די מעשה פון גענזשי	Fortellingen om Genji
גילגאמעש עפאס	Gilgamesj
איליאדע	Iliaden
מאהאבהאראטא	Mahabharata
שאהנאמע	Shahname
FBI	Federal Bureau of Investigation
הארי פאטער	Harry Potter
טרומייט	Trompet
דזשעז	Jazz
פידל	Fiolin
באראק מוזיק	Barokkmusikk
אלגאריטם	Algoritme
טשעלא	Cello
דראג	Rusmiddel
פעדעפיליע	Pedofili
סעקס פאזיציעס	Samleiestillinger
אנאנירן	Onani
אנאל סעקס	Analsex
אלעקסאנדער דער גרויסער	Aleksander den store
קאנסטאנטין דער גרויסער	Konstantin den store
כורש	Kyros den store
געזעלשאפט (סאציאלאגיע)	Samfunn
ציוויליזאציע	Sivilisasjon
חינוך	Utdannelse
פאמיליע	Familie
יוגא טשאוועז	Hugo Chávez
מאנצביל	Mann
אטא פאן ביסמארק	Otto von Bismarck
אישות	Ekteskap
אבארטאציע	Abort
טויטשטראף	Dødsstraff
מענטשן רעכט	Menneskerettigheter
ראסיזם	Rasisme
טימור	Timur Lenk
שקלאפעריי	Slaveri
בירגער קריג	Borgerkrig
אומאר איבן אל-כאטאב	Umar ibn al-Khattab
מיליטער	Militærvesen
סוליימאן דער ערשטער	Suleiman I den store
פיטער דער גרויסער	Peter I av Russland
קאווע	Kaffe
זאפט	Jus (drikk)
מילך	Melk
באַרג	Fjell
מדבר	Ørken
זומער אלימפיאדע 2008	Sommer-OL 2008
סון יאט-סען	Sun Yat-sen
זומער אלימפיאדע 2012	Sommer-OL 2012
סאלאדין	Saladin
אשאקא	Ashoka den store
אקבאר	Akbar den store
סימאן באליוואר	Simón Bolívar
היפנאזיע	Hypnose
ענדרו זשאנסאן	Andrew Johnson
פיער עליאט טרודא	Pierre Trudeau
קוואמע נקרומאה	Kwame Nkrumah
יידיש	Jiddisch
האנג קאנג	Hongkong
מיאמי	Miami
קאראטשי	Karachi
מיטל מזרח קאנפליקט	Midtøsten-konflikten
לאגאס	Lagos
אמעריקאנער בירגערקריג	Den amerikanske borgerkrigen
ריא דע זשאנערא	Rio de Janeiro
בריטישע אימפעריע	Det britiske imperiet
קאלטער קריג	Den kalde krigen
סעאל	Seoul
שאנכיי	Shanghai
קולטורעלע רעוואלוציע	Kulturrevolusjonen
לאנדאן היטרוי ערפארט	London Heathrow lufthavn
וועלט ווירטשאפט קריזיס	Den store depresjonen
וואלט דיזני	Walt Disney
מיידזשי רעסטאראציע	Meijirestaurasjonen
סעווילא	Sevilla
רוסישע רעוואלוציע	Den russiske revolusjon
לאס אנדזשעלעס אינטערנאציאנאלע פליפעלד	Los Angeles internasjonale lufthavn
טשינג דינאסטיע	Qing-dynastiet
ווערסיי אפמאך	Versaillestraktaten
ארכימעד	Arkimedes
וויעטנאם קריג	Vietnamkrigen
טאמעס עדיסאן	Thomas Edison
אוקלידוס	Euklid
מייקל פאראדיי	Michael Faraday
באסקיש	Baskisk
ענריקא פערמי	Enrico Fermi
בריטיש ערוועיס	British Airways
DNS	Domain Name System
הענרי פארד	Henry Ford
גאלען	Galen
קריפטאגראפיע	Kryptografi
אינטערנעט פראטאקאל	Internet Protocol
אוקראיניש	Ukrainsk
ביט	Bit
HTML	HTML
וואלענציע	Valencia
יוניקאד	Unicode
סאטיאדזשיט ריי	Satyajit Ray
סטיווען ספילבערג	Steven Spielberg
אייראפעאישע קאמיסיע	Europakommisjonen
אייראפעישער צענטראלבאנק	Den europeiske sentralbank
אייראפעישע אטאמישע ענערגיע געמיינדע	Det europeiske atomenergifellesskap
יאהאן גוטנבערג	Johann Gutenberg
דזשיימס פרעסקאט דזשול	James Prescott Joule
יאהאנעס קעפלער	Johannes Kepler
מאקס פלאנק	Max Planck
שוועדיש	Svensk
דעניש	Dansk
ניקאלא טעסלא	Nikola Tesla
אל־כוואריזמי	Al-Khwârizmî
זשיימס וואט	James Watt
טשאנאקיע	Chanakya
גאטפריד ווילהעלם לייבניץ	Gottfried Leibniz
נועם כאמסקי	Noam Chomsky
לוקסעמבורגיש	Luxembourgsk
טשעכיש	Tsjekkisk
סלאוואקיש	Slovakisk
קארל מארקס	Karl Marx
סלאוועניש	Slovensk
אונגעריש	Ungarsk
וואלטער	Voltaire
משה רבינו	Moses
לעטיש	Latvisk
וויסן	Kunnskap
ליטוויש	Litauisk
הינדואיזם	Hinduisme
בעלארוסיש	Hviterussisk
דזשיימס קלארק מאקסוועל	James Clerk Maxwell
ברוסט	Bryst
דמיטרי מענדלעעוו	Dmitrij Mendelejev
אטאם	Atom
ערנעסט ראדערפארד	Ernest Rutherford
ליכט	Lys
גריכיש	Gresk
ערווין שרעדינגער	Erwin Schrödinger
מיטאלאגיע	Mytologi
אפערירן סיסטעם	Operativsystem
טאזש מאהאל	Taj Mahal
איריש	Irsk
פראגראמירן שפראך	Programmeringsspråk
פינגווין	Pingviner
פונדאמענטאליזם	Fundamentalisme
בליצפאסט	E-post
מאנאטעיזם	Monoteisme
פאליטעאיזם	Polyteisme
נשמה	Sjel
מאלטעזיש	Maltesisk
פערסיש	Persisk
רעליגיע	Religion
קארעיש	Koreansk
אברהם אבינו	Abraham (bibelsk person)
ספר בראשית	Første Mosebok
עמפייער סטעיט בילדינג	Empire State Building
ספר שמות	Andre Mosebok
רענע דעקארט	René Descartes
וויעטנאמעזיש	Vietnamesisk
שאול התרסי	Apostelen Paulus
סטאטוע פון ליבערטי	Frihetsgudinnen
אמעריקאנער ארמיי	United States Army
זיגמונד פרויד	Sigmund Freud
טיילאנדיש	Thai
דזשייניזם	Jainisme
געארג ווילהעלם פרידריך העגל	Georg Wilhelm Friedrich Hegel
מאנגאליש	Mongolsk
באקו	Baku
וועלט ירושה ארט	Verdensarven
סאלאט	Salat (mat)
יידישקייט	Jødedom
העברעאיש	Hebraisk
איבן כאלדון	Ibn Khaldūn
סערביש	Serbisk
באסניש	Bosnisk
אימאנועל קאנט	Immanuel Kant
סיקהיזם	Sikhisme
דזשאן מיינארד קינס	John Maynard Keynes
אויפפיר	Atferd
לאא צי	Laozi
Gmail	Gmail
גוגל דאקומענטן	Google Docs
יאגא	Yoga
דזשאן לאק	John Locke
פרידריך ניצשע	Friedrich Nietzsche
בישקעק	Bisjkek
זשאן-פאל סארטרע	Jean-Paul Sartre
דושאנבע	Dusjanbe
גוגל (זוכמאשין)	Google Søk
לעבער	Lever
סימא טשיען	Sima Qian
ניר	Nyre
אדם סמיט	Adam Smith
אוריניר פענכער	Urinblære
מאקס וועבער	Max Weber
לודוויג וויטגנשטיין	Ludwig Wittgenstein
זשו טשי	Zhu Xi
נערוון סיסטעם	Nervesystem
געפיל	Følelser
פסיכאלאגיע	Psykologi
טראכטן	Tanke
טימבוקטו	Timbuktu
אקעאן	Verdenshav
טאמאס פון אקווינא	Thomas Aquinas
קעניגין וויקטאריע	Victoria av Storbritannia
גאוטאמא בודהא	Buddha
רעגנוואלד	Regnskog
דיאלעקטיק	Dialektikk
מוכאמאד	Muhammed
מידות	Etikk
עפיסטעמאלאגיע	Erkjennelsesteori
בחירה	Fri vilje
IPod	IPod
משמעותדיקייט	Sannsynlighet
רעאליטעט	Virkelighet
אטעם	Respirasjon
בי בי סי	BBC
טאני בלער	Tony Blair
אל-גאזאלי	Abu Hamid Ghazali
מארטין לוטער	Martin Luther
קאנפוציאניזם	Konfucianisme
דזשעראלד פארד	Gerald Ford
שיא איסלאם	Sjiaislam
ריטשארד ניקסאן	Richard Nixon
ITunes	ITunes
קאטוילישע קירכע	Den katolske kirke
טרימורטי	Trimurti
בויך	Abdomen
טאאיזם	Taoisme
זאראאסטריזם	Zoroastrisme
סופיזם	Sufisme
בענגאליש	Bengali
טראכט	Livmor
צונג	Tunge
פאנקרעאס	Bukspyttkjertel
גענאק	Hals
מויל	Munn
שטימע קעסטל	Strupehode
לינדאן זשאנסאן	Lyndon B. Johnson
געלענק	Ledd
דריז	Kjertel
פאלקלאנד אינזלען	Falklandsøyene
פארדייאונג סיסטעם	Fordøyelsessystem
A	A
מיכאל שומאכער	Michael Schumacher
אינזל פון ווייט	Wight
עליזאבעט די צווייטע	Elisabeth II av Storbritannia
טאנג דינאסטיע	Tang-dynastiet
ניו יארק טיימס	The New York Times
זשאן עף. קענעדי	John F. Kennedy
B	B
זרע	Sperma
דזשיאאקינא ראסיני	Gioacchino Rossini
קלאסישע מוזיק	Klassisk musikk
סימפאניע	Symfoni
G	G
U	U
Z	Z
בלוז	Blues
פלאמענקא	Flamenco
F	F
J	J
עלעקטראנישע מוזיק	Elektronisk musikk
אלפאבעט	Alfabet
אות	Bokstav
רעגיי	Reggae
T	T
C	C
מיטלשול	High school
R	R
D	D
אלפא	Alfa
I	I
מינג דינאסטיע	Ming-dynastiet
E	E
H	H
דווייט דעיוויד אייזנהאוער	Dwight D. Eisenhower
K	K
L	L
M	M (bokstav)
N	N
O	O
Q	Q
S	S
ראנאלד רייגען	Ronald Reagan
V	V
W	W
X	X
Y	Y
ענדי מאריי	Andy Murray
פלאזמע	Plasma
קאנאל טונעל	Kanaltunnelen
פיטאגאראס	Pythagoras
קאלאסעום	Colosseum
פארטענאן	Parthenon
ארימקייט	Fattigdom
סאראגאסא	Zaragoza
דזשאן מעקעין	John McCain
פערנאנדא אלאנסא	Fernando Alonso
דעיוויד בעקהעם	David Beckham
גארדאן בראון	Gordon Brown
נעוויל טשעמבערליין	Neville Chamberlain
קאַטעגאָריע:װענעזועלע	Kategori:Venezuela
בעלפאסט	Belfast
קארדיף	Cardiff
פעריאדישע טאבעלע	Periodesystemet
זעלבסטמארד	Selvmord
נאקעט	Nakenhet
9/11	Terrorangrepet 11. september 2001
רעפטיליע	Krypdyr
סעקס שפילצייג	Sexhjelpemidler
נאגער	Gnagere
טויבן	Duer
שפּאנישע בירגער קריג	Den spanske borgerkrig
ארכעען	Arkebakterier
בלינדקייט	Blindhet
באקטעריע	Bakterier
בוים	Tre
פראטיסטן	Protoktister
אמפיביע	Amfibier
כארדאטן	Ryggstrengdyr
רעוואלוציע	Revolusjon
קעז	Ost
וויינטרויבן	Druer
האניג	Honning
פלייש	Kjøtt
קארטאפל	Potet
צוקער	Sukker
גרינצייג	Grønnsak
סויע	Soyabønne
נוס	Nøtt
ראבאט	Robot
טעכנאלאגיע	Teknologi
מאשין	Maskin
שרויף	Skrue (mekanisme)
אינזשעניריע	Ingeniørvitenskap
קאמוניקאציע	Kommunikasjon
אינפארמאציע	Informasjon
זשורנאליזם	Journalistikk
צייטונג	Avis
מאסן מעדיע	Massemedier
דרוקעריי	Trykking
טעלעפאן	Telefon
קולטור	Kultur
הינדוסטאני	Hindustani
סאנסקריט	Sanskrit
בלוט צירקולאציע	Sirkulasjonssystem
ענדאקרינאלע סיסטעם	Det endokrine system
אלצהיימערס קרענק	Alzheimers sykdom
גראבע קישקע	Tykktarm
פארקינסאן קרענק	Parkinsons sykdom
קליינע קישקע	Tynntarm
חוש-סיסטעם	Sansesystem
שפעק	Bacon
IP אדרעס	IP-adresse
זייערס	Syre
אומארגאנישע כעמיע	Uorganisk kjemi
פראגע צייכן	Spørsmålstegn
כעמישע פארבינדונג	Kjemisk forbindelse
יוליאנישער קאלענדאר	Juliansk kalender
מעדיצין	Medisin
וועלט פאקטבוך	The World Factbook
באזע (כעמיע)	Base
סאראיעווא	Sarajevo
לאגאריטם	Logaritme
העכסטע געריכט פון די פאראייניגטע שטאטן	USAs høyesterett
אריטמעטיק	Aritmetikk
פענטאגאן	The Pentagon
קאארדינאטן סיסטעם	Koordinatsystem
מיליטער פון די פאראייניקטע שטאטן פון אמעריקע	USAs forsvar
דיפערענציאל-גלייכונג	Differensialligning
Windows 7	Windows 7
נומערישער אנאליז	Numerisk analyse
יו.עס. מארין קארפס	United States Marine Corps
אמעריקאנער פלאט	United States Navy
אמעריקאנער לופטפלאט	United States Air Force
אמעריקאנער בארטן פאטראל	United States Coast Guard
פראצענט	Prosent
Windows Vista	Windows Vista
היימלאנד זיכערהייט	Sikkerhetsdepartementet (USA)
Windows Server 2008	Windows Server 2008
World Trade Center	Verdens handelssenter i New York
סמיילי	Smiley
Windows Server 2003	Windows Server 2003
Windows XP	Windows XP
מידטאון מאנהעטן	Midtown (Manhattan)
Microsoft Office	Microsoft Office
פידעל קאסטרא	Fidel Castro
Microsoft Word	Microsoft Office Word
קאנגרעס	Kongressen (USA)
עקסעל	Microsoft Office Excel
קאַטעגאָריע:בראזיל	Kategori:Brasil
טראל (אינטערנעט)	Troll (Internett)
מאנהעטן	Manhattan
וואלקן קראצער	Skyskraper
שאפינג מאלל	Kjøpesenter
קאַטעגאָריע:רומעניע	Kategori:Romania
כעמישער עלעמענט	Grunnstoff
גלייכונג	Ligning (matematikk)
פונקציע	Funksjon (matematikk)
ארגאנישע כעמיע	Organisk kjemi
ווינקל	Vinkel
קארבאהידראט	Karbohydrat
הארמאן	Hormon
ליפיד	Lipid
יוניקס	Unix
מאלעקול	Molekyl
פיזיקאלישע כעמיע	Fysikalsk kjemi
פארגיכערונג	Akselerasjon
ענערגיע	Energi
לאקאל נעצווערק	Lokalnett
קאנסערווירונג פון ענערגיע	Energiprinsippet
עלעקטראמאגנעטישע שטראלונג	Elektromagnetisk stråling
אינפרארויט	Infrarød stråling
אולטראוויאלעט	Ultrafiolett stråling
זגאלן אין סכנה	Trua arter
שטוביקונג	Domestisering
קלאסישע מעכאניק	Klassisk mekanikk
ביאלאגישע קלאסיפיקאציע	Biologisk klassifikasjon
ראק מוזיק	Rock
היפ האפ	Hiphop
קראפט	Kraft
סאמבע	Samba
פויק	Tromme
פלייט	Fløyte
מאגנעטיש פעלד	Magnetfelt
אפארטהייד	Apartheid
שפיל	Spill
טריק-טראק	Backgammon
גראוויטאציע	Tyngdekraft
גא	Go
שטארקע קראפט	Fargekraft
קאמפקונסט	Kampkunst
שוואכע קראפט	Svak kjernekraft
קאראטע	Karate
דזשודא	Judo
מאגנעט	Magnet
שפילכל	Leketøy
מאסע	Masse
פילם	Film
אנימאציע	Animasjon
מעטאל	Metall
שטאל (מעטאל)	Stål
יאדער-שפאלטונג	Kjernefysisk fisjon
צושטאנד פון מאטעריע	Aggregattilstand
גאז	Gass
פליסיקייט	Væske
לופטמאשין	Luftfartøy
סאלידער קערפער	Faststoff
ביציקל	Sykkel
שיף	Skip
ראדיאאקטיוויטעט	Radioaktivitet
לאנדווירטשאפט	Landbruk
אלגעמיינע טעאריע פון רעלאטיוויטעט	Den generelle relativitetsteorien
באוואסערונג	Vanning
ספעציעלע טעאריע פון רעלאטיוויטעט	Den spesielle relativitetsteorien
האלב-דורכפירער	Halvleder
באוול	Bomull
קליידונג	Klær
קלאנג	Lyd
אדאבי	Adobe Systems
אקער	Plog
גיכקייט	Hastighet
טעמפעראטור	Temperatur
מעטאלורגיע	Metallurgi
נאנאטעכנאלאגיע	Nanoteknologi
גלאז	Glass (materiale)
צייט	Tid
פאפיר	Papir
טערמאדינאמיק	Termodynamikk
פלאסטיק	Plast
וואקיום	Vakuum
קינעמאטיק	Kinematikk
שטח	Areal
פיטאגאראס פרינציפ	Pythagoras’ læresetning
מאטעמאטישער דערווייז	Matematisk bevis
צאל	Tall
קאמפלעקסע צאל	Komplekst tall
דארווין, אויסטראליע	Darwin (Australia)
קילאגראם	Kilogram
מעטער	Meter
סעקונדע	Sekund
קוקורוזע	Mais
גערשט	Bygg (korn)
ליטער	Liter
הערי עס טרומאן	Harry S. Truman
מאלעריי	Malerkunst
פאטאגראפיע	Fotografi
סקולפטור	Skulptur
טעאטער	Teater
דזשודי גארלאנד	Judy Garland
טאנץ	Dans
טעפעריי	Pottemaker
עלעקטראניק	Elektronikk
עלעקטרישער שטראם	Elektrisk strøm
פרעקווענץ	Frekvens
דיאדע	Diode
טראנספארמאטאר	Transformator
קינסטלעכע אינטעליגענץ	Kunstig intelligens
אינפארמאציע טעכנאלאגיע	Informasjons- og kommunikasjonsteknologi
וועטער	Vær (meteorologi)
ענדרו קוואמא	Andrew Cuomo
דעיוויד פעטערסאן	David Paterson
עליאט שפיצער	Eliot Spitzer
דזשארזש פאטאקי	George Pataki
אקציע (פינאנץ)	Aksje
פרעזידענט פון די פאראייניגטע שטאטן	USAs president
רעסטאראן	Restaurant
דרום-מזרח אזיע	Sørøst-Asia
רשימה:לענדער פון דער וועלט	Liste over stater
פרעהיסטאריע	Forhistorisk tid
לייזער זאמענהאף	Ludwik Lejzer Zamenhof
שטיין עפאכע	Steinalderen
בראנדז עפאכע	Bronsealderen
אייזן עפאכע	Jernalderen
מעסאפאטאמיע	Mesopotamia
אוראלט עגיפטן	Oldtidens Egypt
אוראלט גריכנלאנד	Antikkens Hellas
גופטא אימפעריע	Guptariket
בער	Bjørnefamilien
זשאן עדעמס	John Adams
טאמעס זשעפערסאן	Thomas Jefferson
זשיימס מעדיסאן	James Madison
זשיימס מאנרא	James Monroe
זשאן קווינסי עדעמס	John Quincy Adams
ענדרו זשעקסאן	Andrew Jackson
מארטין וואן ביורען	Martin Van Buren
וויליאם הענרי העריסאן	William Henry Harrison
זשאן טיילער	John Tyler
וויליאם ראאן האמילטאן	William Rowan Hamilton
זשיימס נאקס פאלק	James Knox Polk
זאקארי טיילאר	Zachary Taylor
בריטני ספירס	Britney Spears
פארדייאונג	Fordøyelse
פאטאסינטעז	Fotosyntese
רעפראדוקציע	Formering
שוואנגערן	Svangerskap
קיילי מינא	Kylie Minogue
דעמב	Eikeslekten
גוגל מאפע	Google Maps
סאסנע	Furuslekten
אדיקציע	Avhengighet
קענסער	Kreft
כאלערע	Kolera
קארן	Dyrket rug
האבער	Havre
ווייץ	Hveteslekten
סארגע	Durra
תבואה	Korn
פארקילונג	Forkjølelse
ציינדאקטעריי	Odontologi
דעפעקטיווקייט	Funksjonshemning
קאלענדאר	Kalender
טויב	Døvhet
מח-קרענק	Psykisk lidelse
קראנקייט	Sykdom
גרעגאריאנישער קאלענדאר	Gregoriansk kalender
מעדיקאמענט	Legemiddel
צייט זאנע	Tidssone
ניקאטין	Nikotin
געזונט	Helse
הארץ אטאקע	Hjerteinfarkt
טוטאַנכאַמון	Tutankhamon
מאלאריע	Malaria
אנטארעס	Antares
נישט-דערנערונג	Feilernæring
מענסטרואציע	Menstruasjon
גראב	Fedme
פאנדעמיע	Pandemi
אנטיביאטיק	Antibiotika
פעניצילין	Penicillin
נאנט	Nantes
לונגען אנטצינדונג	Lungebetennelse
קינדער-פאראליז	Poliomyelitt
געשלעכט-קראנקייט	Seksuelt overførbar infeksjon
עידס	Aids
וואטע שפיץ	Bomullspinne
אנפאל	Hjerneslag
טובערקולאז	Tuberkulose
צוקערקרענק	Diabetes
פאקן	Kopper (sykdom)
קורדן	Kurdere
ארכיטעקטור	Arkitektur
בויגן (ארכיטעקטור)	Bue (arkitektur)
בריק	Bro
קאנאל	Kanal (farvann)
מילארד פילמאר	Millard Fillmore
פרענקלין פירס	Franklin Pierce
דאם	Demning
זשיימס ביוקענען	James Buchanan
זאלץ (כעמיע)	Salt
פירענעען	Pyreneene
שוויץ (קאנטאן)	Schwyz (kanton)
דעטרויט	Detroit
מאס	Måling
אינטערנאציאנאלע סיסטעם פון איינסן	SI-systemet
נומערן טעאריע	Tallteori
סכומען טעאריע	Mengdelære
סטאטיסטיק	Statistikk
סימעטריע	Symmetri
קופאל	Kuppel
בורדזש כאליפא	Burj Khalifa
כינעזער וואנט	Den kinesiske mur
גאנצע צאל	Heltall
האגיא סאפיא	Hagia Sofia
טרעפּ	Trapp
פעטראס באסיליקע	Peterskirken
דריי-שלוכטן-דאמבע	De tre kløfters demning
פיראמיד	Pyramide (byggverk)
טורעם	Tårn
אבאסישער כאליפאט	Abbasidene
אויפקלערונג	Opplysningstiden
אזטעק	Aztekere
ביזאנטישע אימפעריע	Østromerriket
קרייצצוג	Korstog
הייליגע רוימישע אימפעריע	Det tysk-romerske rike
הונדערט-יעריגע מלחמה	Hundreårskrigen
מיטל אלטער	Middelalderen
מאנגאלישע אימפעריע	Mongolriket
אטאמאנישע אימפעריע	Det osmanske rike
פראטעסטאנטישע רעפארמאציע	Reformasjonen
וויקינג	Viking
נבוכדנאצר דער צווייטער	Nebukadnesar II
ברוטא אינלענדישער פראדוקט	Bruttonasjonalprodukt
קאליגראפיע	Kalligrafi
מאדע	Mote
דערנייבארע ענערגיע	Fornybar energi
עלעקטריע	Elektrisitet
קערנדיקע קראפט	Kjernekraft
פאסיל-ברענשטאף	Fossilt brensel
אינטערנל קאמבאסטשען ענזשין	Forbrenningsmotor
דאמפמאטאר	Dampmaskin
שווערד	Sverd
פייער-געווער	Skytevåpen
מאשינביקס	Maskingevær
נוקלעארער וואפן	Kjernefysiske våpen
איבערישער האלבאינזל	Den iberiske halvøy
שיספולווער	Krutt
פליסיגע אויפרייס	Sprengstoff
טאנק	Stridsvogn
אנטווערפן	Antwerpen
דזשארדזש סאראס	George Soros
רעאלע צאל	Reelt tall
לעאפאלד דער צווייטער פון בעלגיע	Leopold II av Belgia
לעאפאלד דער ערשטער פון בעלגיע	Leopold I av Belgia
לעאפאלד דער דריטער פון בעלגיע	Leopold III av Belgia
אלבערט דער ערשטער פון בעלגיע	Albert I av Belgia
באדעוויין פון בעלגיע	Baudouin I av Belgia
מישעל אבאמא	Michelle Obama
ראזשינקע	Rosin
קאקאס	Kokospalme
מילגרוים	Granateple
מאראנץ	Appelsin
רומאנטש	Retoromansk
אייזקרעם	Iskrem
קוכן	Kake
יאגארט	Yoghurt
הארווארד אוניווערסיטעט	Harvard University
על זשאזירא	Al-Jazeera
סעבו (גובערניע)	Cebu
אנזשאלינא זשאולי	Angelina Jolie
אדריאטישער ים	Adriaterhavet
אראביש	Arabisk
דאנק טאג	Thanksgiving
Msnbc	MSNBC
האנשו	Honshu
בערנארד מעדאף	Bernard Madoff
ערווין ראמעל	Erwin Rommel
קאנדאם	Kondom
פאלמע	Palmer
טשימבאראזא	Chimborazo
דאלאר	Dollar
ביקיני	Bikini (klesplagg)
קארסיקע	Korsika
פרעמיער מיניסטער	Premierminister
דזשוסעפע פיאצי	Giuseppe Piazzi
ערשטער ניווא דאמען	Toppnivådomene
סאנטיאגא דע קאמפאסטעלא	Santiago de Compostela
וויטאריע	Vitoria
סאנטא קרוז דע טענעריפע	Santa Cruz de Tenerife
בעטא	Beta
גאמא	Gamma
קאקטוס	Kaktusfamilien
אפטיק	Optikk
הערב	Våpen (heraldikk)
פאן	Flagg
טיש	Bord (møbel)
לענאווא	Lenovo
ברין	Brno
עסקאלאטאר	Rulletrapp
שטול	Stol
אינטערנאציאנאלע ארגאניזאציע פאר סטאנדארטיזאציע	ISO
ד	Dalet
זשיראף	Sjiraff
דרום טיראל	Syd-Tirol
וואנצעס	Bart
סאוועטן פארבאנד	Sovjetunionen
ראן פאול	Ron Paul
מוניציפאליטעט	Kommune
שלעכטס	Ondskap
אלקאהאליזם	Alkoholisme
קאמערע	Kamera
טעלעוויזיע פראגראם	TV-program
פאראנא	Paraná (delstat)
C (פראגראם שפראך)	C (programmeringsspråk)
פוס	Fot (kroppsdel)
האנטקייטן	Håndjern
קווין	Queen
פרעדי מערקורי	Freddie Mercury
ברייען מעי	Brian May
ראדזשער טעילער	Roger Meddows-Taylor
עמי וויינהאוס	Amy Winehouse
מאנטעסקיע	Charles Montesquieu
פערזענלעכער קאמפיוטער	Personlig datamaskin
אקסל	Skulder
האלדז	Strupe
שילדדריז	Skjoldkjertel
פארטאל:רעקאמענדירטע ארטיקלען	Wikipedia:Utmerkede artikler
װיקיפּעדיע:קאווע שטיבל	Wikipedia:Tinget
ריכטער	Dommer
ווערמאנט	Vermont
סאן דיעגא	San Diego
דענווער	Denver
היוסטן	Houston
פיניקס	Phoenix
אסטין	Austin
מעמפיס	Memphis
קאלומבוס, אהייא	Columbus (Ohio)
אמעריקאנישער סאמאא	Amerikansk Samoa
עדגאר אלאן פא	Edgar Allan Poe
שפיטאל	Sykehus
מזרח דייטשלאנד	Den tyske demokratiske republikk
קלויסטער	Kirke
נארד-פא-דע-קאלע	Nord-Pas-de-Calais
אקלאנד, קאליפארניע	Oakland
גאוויאל	Gangesgavial
איי	Egg
אעראפלאנען שיף	Hangarskip
שניי-מאביל	Snøscooter
מאנאפאלי (שפיל)	Monopol (brettspill)
קרייז	Sirkel
פלאך	Plan (matematikk)
זעלביקער-געשלעכט חתונה	Likekjønnet ekteskap
וויקיע	Wikia
קיינציקלאפעדיע	Ikkepedia
פלאמענגא	Clube de Regatas do Flamengo
צעלפאן	Mobiltelefon
שטרויס	Struts
סטיווען האקינג	Stephen Hawking
אקסיאם	Aksiom
טעאריע	Teori
סעקסואלער אריענטאציע	Seksuell orientering
סאקראמענטא	Sacramento
האנאלולו	Honolulu
קארעע	Korea
1925	1925
1927	1927
מאנטשעסטער	Manchester
אספירין	Acetylsalisylsyre
אינסטינקט	Instinkt
פראווידענס	Providence
ניו ענגלאנד	New England
אלי וויזעל	Elie Wiesel
ברוקלין	Brooklyn
קווינס	Queens
בראנקס	The Bronx
סטעטן איילאנד	Staten Island
לאנג איילענד	Long Island
וואלף	Ulv
מעטאפאר	Metafor
אלעגאריע	Allegori
מאפיא	Mafia
1955	1955
1954	1954
1953	1953
1951	1951
1950	1950
1946	1946
1943	1943
1942	1942
1940	1940
1939	1939
1938	1938
1937	1937
1936	1936
1935	1935
1934	1934
1933	1933
1932	1932
1931	1931
1930	1930
1929	1929
פיאנגיאנג	Pyongyang
נייער טעסטאמענט	Det nye testamente
GPS	NAVSTAR Global Positioning System
אסקאר	Oscar
2010ער	2010-årene
אייקאריאט	Eukaryoter
9 (נומער)	9 (tall)
פאדאלסק	Podolsk
זוכמאשין	Søkemotor
פויבסט	Pave
אלקאלי מעטאל	Alkalimetall
ראפאעל קארעא	Rafael Correa
איבערגאנג מעטאל	Innskuddsmetall
האלבמעטאלן	Halvmetall
נישט-מעטאל	Ikke-metall
איידעלער גאז	Edelgass
בוקארעשט	București
על גאר	Al Gore
סעווערן	Severn
פארטא-ריקאנישע אומאפהענגיקייט פארטיי	Partido Independentista Puertorriqueño
טעמז	Themsen
טיראנא	Tirana
1928	1928
מאנגראווע	Mangrove
היטשין	Hitchin
קראצמעך	Jul
דרייעק	Trekant
עיבור יאר	Skuddår
סטיוו זשאבס	Steve Jobs
ליידי גאגא	Lady Gaga
ברייניגערבערג	Breinigerberg
מואמאר קאדאפי	Muammar al-Gaddafi
בעקערלו ליניע	Bakerloo-linjen
טיגער	Tiger
כואן קארלאס דער ערשטער	Juan Carlos I av Spania
פעטוטשיני	Fettuccine
לאנדאנער אונטערגרונט	Londons undergrunnsbane
MAC אדרעס	MAC-adresse
פאדקעסט	Podkasting
קעשענעוו	Chișinău
נאטירלעכע צאל	Naturlig tall
סאציאלאגיע	Sosiologi
שלום (צייטונג)	Şalom
אדישא	Odisha
GNU פרייע דאקומענטאציע ליצענץ	GNU fri dokumentasjonslisens
זשאן קערי	John Kerry
טייוואן אינזל	Taiwan
אנטיסעמיטיזם	Antisemittisme
נאפט	Petroleum
פרידריך שילער	Friedrich Schiller
שיך	Sko
דאנאלד טראמפ	Donald Trump
באנק	Bank
מעץ	Metz
פרייהייט פון ווארט	Ytringsfrihet
טעאריע:סעפטעמבער 11	Konspirasjonsteorier om 11. september
באפעלקערונג ענגקייט	Befolkningstetthet
Russia Today	Russia Today
אירלאנד (אינזל)	Irland (øy)
װיקיפּעדיע:בלעטער צו אויסמעקן	Wikipedia:Sletting
בראדפארד	Bradford
טשעשיר	Cheshire
קאמבריע	Cumbria
לאנקאשיר	Lancashire
נארטהאמבערלאנד	Northumberland
טיין און וויר	Tyne and Wear
קאנטי דארהאם	Durham (grevskap)
מערב יארקשיר	West Yorkshire
צפון יארקשיר	North Yorkshire
מזרח ריידינג פון יארקשיר	East Riding of Yorkshire
לינקאנשיר	Lincolnshire
נאטינגהאמשיר	Nottinghamshire
דרום יארקשיר	South Yorkshire
דארבישיר	Derbyshire
גרויס-מאנטשעסטער	Stor-Manchester
מערזיסייד	Merseyside
שראפשיר	Shropshire
סטאפארדשיר	Staffordshire
לעסטערשיר	Leicestershire
ראטלאנד	Rutland
נארפאלק	Norfolk
סאפאלק	Suffolk
קעמברידזשיר	Cambridgeshire
לו קסון	Lu Xun
נארטהאמפטאנשיר	Northamptonshire
הערעפארדשיר	Herefordshire
וואוסטערשיר	Worcestershire
וואריקשיר	Warwickshire
בעדפארדשיר	Bedfordshire
קארנוואל	Cornwall
בריסטאל	Bristol
דעוון	Devon
דארסעט	Dorset
גלאסטערשיר	Gloucestershire
אקספארדשיר	Oxfordshire
10	10
ווילטשיר	Wiltshire
האמפשיר	Hampshire
בארקשיר	Berkshire
באקינגהאמשיר	Buckinghamshire
20	20
אמטראק	Amtrak
עסעקס	Essex
סארי	Surrey
מערב סאסעקס	West Sussex
מזרח סאסעקס	East Sussex
30	30
קענט	Kent
גרויסלאנדאן	Stor-London
סיטי פון לאנדאן	City of London
9	9
7 (נומער)	7 (tall)
8 (נומער)	8 (tall)
זשאן אגוסט דאמיניק ענגרע	Jean Auguste Dominique Ingres
וואָך	Ukedager
אייז	Is
אזערע	Innsjø
קנאבל	Hvitløk
אנטראפאלאגיע	Antropologi
ים סוף	Rødehavet
אוגערקע	Agurk
אולאן באטאר	Ulan Bator
עדינבורג	Edinburgh
אשגאבאט	Asjkhabad
אקטאוו מירבא	Octave Mirbeau
אינזל	Øy
ווייס	Hvit
שווארץ	Svart
מארסיי	Marseille
ציבל	Vanlig løk
6 (נומער)	6 (tall)
ארכעאלאגיע	Arkeologi
טאמאטע	Tomat
דזשארזש ה. וו. בוש	George H.W. Bush
ריקי דזשארוועיס	Ricky Gervais
באלקאן לענדער	Balkan
סלאווישע שפראכן	Slaviske språk
עקוואטאר	Ekvator
סעלענא	Selena
מערידא, ווענעזועלע	Mérida (Venezuela)
אטלאנטא	Atlanta
בעניטא מוסאליני	Benito Mussolini
לאסט (טעלעוויזיע סעריע)	Lost
17	17
ווערטערבוך	Ordbok
קאפ	Hode
װעלינגטאן	Wellington
גרויסבריטאניע	Storbritannia (øy)
23	23
זשימי קארטער	Jimmy Carter
נאציאנאלער הימען	Nasjonalsang
סיינפעלד (סעריע)	Seinfeld
לאס וועגאס	Las Vegas
26	26
פאלעסטינע	Palestina (område)
10 (נומער)	10 (tall)
אטאם נומער	Atomnummer
אלפרעד נאבעל	Alfred Nobel
24	24
29	29
לילך דאונס	Lila Downs
ים המלח	Dødehavet
25	25
31	31
28	28
ליווערפול	Liverpool
אלבאני	Albany (New York)
אוואטאר (פילם)	Avatar (film)
ווערב	Verb
770	770
וואדי עלען	Woody Allen
טיטאניק	RMS «Titanic»
ראמשטיין	Rammstein
סאווע	Ugler
פונט שטערלינג	Britisk pund
בענעטיץ	Benetice (Světlá nad Sázavou)
ווערטייברעיטס	Virveldyr
מעטעאראלאגיע	Meteorologi
אזארן	Azorene
פעלידאע	Kattefamilien
אינטערנאציאנאלע קאסמאס סטאנציע	Den internasjonale romstasjonen
היספאניאלא	Hispaniola
דא נאנג	Da Nang
פעטרישקע	Persille
אופסאלא	Uppsala
געטעבארג	Göteborg
וואג	Tyngde
קארניש	Kornisk
טייטלבוים	Daddelpalme
האמער	Hammer (redskap)
ראטיבאר	Racibórz
פליג	Tovinger
בליענדיקע פלאנצן	Dekkfrøede planter
ארקטיק	Arktis
מאלוסקן	Bløtdyr
Gaudi Antoni	Antoni Gaudí
מאכט	Effekt
טענענבוים	Edelgranslekten
דראמא	Drama
ליבעלעס	Øyenstikkere
בורשטין	Rav
נוארק	Newark (New Jersey)
וועסטעראס	Västerås
לינשעפינג	Linköping
וואלטאזש	Elektrisk spenning
זאפראן	Safran
סארביש	Sorbisk
מעלנליקע	Mölnlycke
ליכט-ארויסגעבנדיקער דיאד	Lysdiode
נארשעפינג	Norrköping
ערעברו	Örebro
פראטאקאלן פון זקני-ציון	Sions vises protokoller
נאציאנאלע באן	National Rail
אוגרע	Europeisk ål
פאפראד	Poprad
נייטרא	Nitra
צאבעל	Sobel
באאבדע	Baabda
רש"י	Rashi
סאטעליט	Kunstig satellitt
זאכלא	Zahle
אילטיס	Ilder
מארק ענטאני	Marc Anthony
פאלעסטין באפרייונג ארגאניזאציע	Palestinas frigjøringsorganisasjon
נעגעלע	Kryddernellik
אטעלא	Othello
טעילאר סוויפט	Taylor Swift
לאנדאנער בארא פון קרוידן	Croydon
פראפיט	Lønnsomhet
מזרח אזיע	Øst-Asia
צפון אפריקע	Nord-Afrika
צענטראל-אפריקע	Sentral-Afrika
דרום אייראפע	Syd-Europa
מזרח אייראפע	Øst-Europa
מערב אייראפע	Vest-Europa
צענטראל אייראפע	Sentral-Europa
צענטראל-אמעריקע	Mellom-Amerika
האטעל	Hotell
נירנבערג געזעצן	Nürnberglovene
געזאנג	Vokalist
אדאלף אייכמאן	Adolf Eichmann
צימערינג	Kanel
קאנקארד, ניו העמפשער	Concord
סעלערי	Selleri
ליסטע פון שטעט אין ישראל	Liste over israelske byer
אספארגוס	Asparges
גראד	Grad (vinkel)
האר	Hår
עסטרייך אונגארישע אימפעריע	Østerrike-Ungarn
ספרינגפילד, אילינוי	Springfield (Illinois)
דזשיקאוו	Tarnobrzeg
אראמיש	Arameisk
פאך	Profesjon
שניטקע	Sandwich
איסלאמישער קאלענדאר	Islamsk kalender
טענעריפע אוידיטאריע	Auditorio de Tenerife
סאשא בארון כהן	Sacha Baron Cohen
פוס מיליטער	Infanteri
F-35 לייטנינג II	Lockheed Martin F-35 Lightning II
מאנטגאמערי	Montgomery
רעפובליקאנער פארטיי	Det republikanske parti (USA)
באק פולווער	Bakepulver
לאקימיע	Leukemi
אפגאט	Paganisme
דעמאקראטישע פארטיי	Det demokratiske parti
בעאטריקס פון די נידערלאנדן	Beatrix av Nederland
לופטל	Løvetannslekta
בירגערמייסטער	Ordfører
שניי לעמפערט	Snøleopard
שטייגעררעכט	Common law
שלעזיש	Schlesisk
פרעזידענט	President
בלאג	Blogg
אחז	Akas av Juda
דזשיימסטאן, סאנט העלענע	Jamestown (St. Helena)
וואלטער קראנקייט	Walter Cronkite
קאלקולאטאר	Kalkulator
געשוויסטער	Søsken
העלט קעיר	Helsevesen
פאפוגיי	Papegøyefugler
קראקע	Kraków
אנארכיע	Anarki
אראבישער האלבאינדזל	Den arabiske halvøy
צוגאב	Addisjon
לעבנסשטייגער	Livsstil
באקס	Boksing
שאלקע 04	FC Schalke 04
לאנדאנער בארא פון מערטאן	Merton (distrikt)
קעניגלעכע בארא פון קינגסטאן אויפן טעמז	Kingston upon Thames (distrikt)
לאנדאנער בארא פון ריטשמאנד אויפן טעמז	Richmond upon Thames (distrikt)
דזשעניפער עניסטאן	Jennifer Aniston
לוזשיץ	Lausitz
אייקאן	Akon
וואלערי לעאנטיעוו	Valerij Leontjev
ISBN	ISBN
זיבן יעריגער קריג	Syvårskrigen
אויסטרא-אזיאטישע שפראכן	Austroasiatiske språk
טאסמאן ים	Tasmanhavet
שווארצע טומאה	Bila Tserkva
אקצענט	Dialekt
לייב טראצקי	Lev Trotskij
ליטל ראק	Little Rock
פאטענץ	Potens (matematikk)
קארדעמאן	Kardemomme
מוזיי	Museum
אלף בית	Det hebraiske alfabetet
דאווער, דעלאווער	Dover (Delaware)
לודמיר	Volodymyr-Volynskyj
קישא	Kesha
קאנאדא	Kannada
קאשוביש	Kasjubisk
בליץ	Lyn
האנט	Hånd
דו פו	Du Fu
עדמונד הילארי	Edmund Hillary
נעפאליש	Nepali
באפעלקערונג	Befolkning
ארכיפעלאג	Arkipel
טעאדער רוזעוועלט	Theodore Roosevelt
טור דע פראנס	Tour de France
ענטעבע אפעראציע	Operasjon Entebbe
תל אביב-יפו	Tel Aviv
טשעכאסלאוואקיי	Tsjekkoslovakia
ניס	Nice
בלאט	Blad
וואלפאראיסא	Valparaíso
אקטיאר	Skuespiller
האליוואד	Hollywood
מארלאן בראנדא	Marlon Brando
גארטל ליניע (געאגראפיע)	Breddegrad
סעמיטישע שפראכן	Semittiske språk
טאגאלאג	Tagalog
יצחק רבין	Yitzhak Rabin
אשכנזים	Askenasiske jøder
זשאסטין ביבער	Justin Bieber
בראנדז	Bronse
כאסני מובאראק	Hosni Mubarak
פארגא	Fargo (Nord-Dakota)
וואכאקא	Oaxaca
פוטער	Smør
טעאלאגיע	Teologi
זעאוס	Zevs
יאסיר אראפאט	Yasir Arafat
מוסד (אגענטור)	Mossad
אקספארד	Oxford
ניאגארא פאלס	Niagarafallene
שטום לשון	Tegnspråk
לינוס טארוואלדס	Linus Torvalds
לאנגווייליגקייט	Kjedsomhet
BSD	Berkeley Software Distribution
רוסלענדישע אימפעריע	Det russiske keiserdømmet
אלעקסאנדער גרעהעם בעל	Alexander Graham Bell
וואודרא ווילסאן	Woodrow Wilson
דאקטאר הו	Doctor Who
אסטראלאגיע	Astrologi
טאסמאניע	Tasmania
ראטערדאם	Rotterdam
שוואן	Svaner
זייף	Såpe
ניו ארלינס	New Orleans
מאשאווצע	Mošovce
בענאזיר בוטא	Benazir Bhutto
שאקירא	Shakira
אוניווערסיטעט פון אקספארד	University of Oxford
טראקט	Vei
מאכמוד אכמעדיניזשאד	Mahmoud Ahmadinejad
סידי	CD
היראהיטא	Hirohito av Japan
העליקאפטער	Helikopter
אל קיידא	Al-Qaida
ווידעא	Video
אגאישער ים	Egeerhavet
אנאסטאסיע	Anastacia
פרת	Eufrat
זשיימס גארפילד	James Garfield
קיאטא	Kyoto
עשרת הדיברות	De ti bud
שול	Synagoge
ענגלישער קאנאל	Den engelske kanal
1980ער	1980-årene
יאהאנעסבורג	Johannesburg
1990ער	1990-årene
י. ק. ראלינג	J.K. Rowling
פערסישער איינגאס	Persiabukten
רויז	Roseslekta
אדיעקטיוו	Adjektiv
זאלצבורג	Salzburg
גריכישע מיטאלאגיע	Gresk mytologi
קאמפאס	Kompass
מין (ביאלאגיע)	Slekt (biologi)
סאציאל וויסנשאפט	Samfunnsvitenskap
האלבאינזל	Halvøy
רענטגען שטראלן	Røntgenstråling
יוליסעס סימפסאן גרענט	Ulysses S. Grant
עליזעבעט טעילער	Elizabeth Taylor
פראווינץ	Provins
בריזבן	Brisbane
וויטאמין	Vitamin
בענדזשאמין פרענקלין	Benjamin Franklin
אייזיק אזימאוו	Isaac Asimov
תורה	Tora
ים פון אזאוו	Azovhavet
1970ער	1970-årene
2000ער	2000-årene
וויליאם מעקינלי	William McKinley
ליסטע פון פרעזידענטן פון די פאראייניגטע שטאטן	Liste over USAs presidenter
רשימה:הויפטשטעט	Liste over hovedsteder etter land
סלאגאן	Ordspråk
וועבזייטל	Nettsted
אדיסעע	Odysseen
סטיווען גראווער קליוולאנד	Grover Cleveland
שפיגל	Speil
הערבערט קלארק האווער	Herbert Hoover
מעטאפיזיק	Metafysikk
ווארען הארדינג	Warren G. Harding
אראבער	Arabere
ברעד פיט	Brad Pitt
שומער	Sumer
ים פון מארמארא	Marmarahavet
פאנעטיק	Fonetikk
פאמיליע (ביאלאגיע)	Familie (biologi)
זשערוסאלעם פאסט	The Jerusalem Post
פענסטער	Vindu
אלמאטיע	Almaty
טשעסטער עלען ארטור	Chester A. Arthur
הייל	Grotte
לאס	Elg
ווייסע הויז	Det hvite hus
פאליציי	Politi
האקיידא	Hokkaido
חידקל	Tigris
ארטור קאנאן דויל	Arthur Conan Doyle
אינגבער	Ingefær
וויליאם האווארד טעפט	William Howard Taft
שטאטן פון די פאראייניגטע שטאטן	USAs delstater
גלעטשער	Isbre
פיטקארן	Pitcairnøyene
בענזשעמין העריסאן	Benjamin Harrison
ראטערפארד בי הייז	Rutherford B. Hayes
1930ער	1930-årene
1960ער	1960-årene
1920ער	1920-årene
פארלאמענט	Parlament
מאטריאל	Materie
סאפארי	Safari (nettleser)
על בייַדאַ	Al Bayda
ברוך שפינאזא	Baruch de Spinoza
נאס	Nys
שלאף	Søvn
אינפלאציע	Inflasjon
הומאר	Humor
E=mc²	Masseenergiloven
אראל ים	Aralsjøen
קארינטיאנס	Sport Club Corinthians Paulista
עסטעטיק	Estetikk
מייבאק	Maybach
מאזדא	Mazda
איזמיר	Izmir
זשאן קעלווין קולידזש	Calvin Coolidge
לעמבערג	Lviv
ווערבע	Vierslekten
דורכגאס פון גיבראלטאר	Gibraltarstredet
באדן	Jord
סכום (מאטעמאטיק)	Mengde
שרייבער	Skribent
לאדינא	Jødespansk
סענדיי ערדציטערניש	Jordskjelvet ved Tōhoku 2011
פּארטא מאנט	Puerto Montt
פראנאם	Pronomen
וואצלאוו האוועל	Václav Havel
וואקאל	Vokal
לענג	Lengde
בריזשיט בארדא	Brigitte Bardot
ביאגראפיע	Biografi
זיידן גאס	Silkeveien
1950ער	1950-årene
חלום	Drøm
לאזשבאן	Lojban
אבערדין	Aberdeen
מעל	Mel
קאניונקציע	Konjunksjon
אויוון	Ovn
1940ער	1940-årene
1900ער	1900-årene
1910ער	1910-årene
דען האג	Haag
טיכא בראהע	Tycho Brahe
זנות	Prostitusjon
וויזועלע קונסטן	Billedkunst
הענריק איבסן	Henrik Ibsen
זומער זייגער	Sommertid
מערב ברעג	Vestbredden
יוגאסלאוויע	Jugoslavia
קריסטאל נאכט	Krystallnatten
קאמפאזיטאר	Komponist
ריהאנא	Rihanna
חזיר גריפע	Svineinfluensa
נאגל (אנאטאמיע)	Negl
12 (נומער)	12 (tall)
וואלאפוק	Volapük
טאשירא מיפונע	Toshiro Mifune
געזיכט	Ansikt
רעקלאמע	Reklame
טאלאהאסי	Tallahassee
פאפ מוזיק	Popmusikk
נאגל (בויען)	Spiker
טאם קרוז	Tom Cruise
איילבירט	Oliven
שלמה המלך	Salomo
יאהו	Yahoo!
30סטן פעברואר	30. februar
שטריך	Linje
פרעה	Farao
AK-47	AK-47
מאריופאל	Mariupol
11 (נומער)	11 (tall)
13 (נומער)	13 (tall)
גרופע 8	G8
אטאמקערן	Atomkjerne
אוואקאדא	Avokado
איי.בי.עם.	International Business Machines
דייוויד היום	David Hume
כוואליע	Bølge
פיאדאר טיוטשעוו	Fjodor Tjuttsjev
דיאמעטער	Diameter
לערער	Lærer
CIA	Central Intelligence Agency
שרייבן	Skriving
קליוולאנד	Cleveland
לובלין	Lublin
דזשאן מייקל טאלבאט	John Michael Talbot
קלאוס עבנער	Klaus Ebner
סטאשקע	Peanøtt
100 (נומער)	100 (tall)
אפריקאס	Aprikos
זיכערהייטס ראט	FNs sikkerhetsråd
יאנישער ים	Det joniske hav
ברילן	Briller
פילעק	Polygon
וואלענטינע טאג	Valentinsdagen
דוד בן גוריון	David Ben-Gurion
סכעלדע	Schelde
מארק	Marked
דעמאגראפיע	Demografi
יודישע אראביש	Judæo-arabisk
כראמאזאם	Kromosom
געשמעלץ	Legering
בעזאנסאן	Besançon
אהקלענד גראמאטישע שולע	Auckland Grammar School
פרידזשידער	Kjøleskap
מילוואקי	Milwaukee
דורכגאס	Sund
זיסע קארטאפל	Søtpotet
קאנסאנאנט	Konsonant
מאקדאנעלדס	McDonald’s
לואיס קאראל	Lewis Carroll
ליאנארדא דיקאפריא	Leonardo DiCaprio
פעלקער-ליגע	Folkeforbundet
סאמוריי	Samurai
בריטישע אינזלען	De britiske øyer
יאקאהאמע	Yokohama
1840ער	1840-årene
הענרי דער אכטער פון ענגלאנד	Henrik VIII av England
קאלאמביע, דרום קאראליינע	Columbia (Sør-Carolina)
מיליאן	Million
סאו פאולא פוטבאל גרופע	São Paulo Futebol Clube
14 (נומער)	14 (tall)
ארבוז	Vannmelon
1880ער	1880-årene
בוכטע פון בענגאל	Bengalbukta
15 (נומער)	15 (tall)
18 (נומער)	18 (tall)
ריכטער סקאלע	Richters skala
אוניווערסיטעט פון ביא-ביא	Universitetet i Bio-Bio
כאמאס	Hamas
רוחאלא כומעיני	Ruhollah Khomeini
לאזער	Laser
פרייסן	Preussen
קאוונט גארדן אונטערגרונט סטאנציע	Covent Garden undergrunnsstasjon
רוימישע צאל	Romertall
נייעס	Nyhet
בירגערמייסטער פון לאנדאן	Borgermesteren i London
פיבער	Feber
1890ער	1890-årene
מענטשליכע אנטוויקלונג אינדעקס	HDI
לידז	Leeds
אפענער קאד	Åpen kildekode
בעהמען	Böhmen
מויז	Mus (slekt)
אראנזש	Oransje
סאטשי	Sotsji
רונאלדיניו	Ronaldinho
זיבנבערגן	Transilvania
1830ער	1830-årene
סעמי טריילער	Traktor
גאמאל אבדול נאסער	Gamal Abdel Nasser
בלו טוט	Blåtann
ווערקצייג	Verktøy
דרוק	Trykk
בענזין	Bensin
בוכטע	Bukt
צווינטער	Gravlund
דאקטער (מעדיצין)	Lege
עיאפיאטלאיעקול	Eyjafjallajökull
קדימה	Kadima
באלטישע לענדער	Baltikum
עזה פאס	Gazastripen
זשעק ניקאלסאהן	Jack Nicholson
אינסולין	Insulin
מארקעטינג	Markedsføring
טאל	Dal
צענזוס	Folketelling
איבן ראשד	Averroës
Radio Studio 54 Network	Radio Studio 54 Network
1860ער	1860-årene
1870ער	1870-årene
19 (נומער)	19 (tall)
הויזן	Bukse
יארצענדלינג	Tiår
מאנדל	Mandel
פיער-אגוסט רענואר	Pierre-Auguste Renoir
קאנסעפסיאן פראווינץ	Provincia de Concepción
צער בעלי חיים	Dyreplageri
קאמפיוטער פראגראם	Dataprogram
ירדן טייך	Jordan (elv)
פלאזשע	Strand
17 (נומער)	17 (tall)
קאסמאסשיף	Romskip
וואלן	Valg
מאנאוס	Manaus
מאראטאן	Maraton
16 (נומער)	16 (tall)
צעל יאדער	Cellekjerne
טאפלונג	Multiplikasjon
צוואנציק	20 (tall)
אדוואקאט	Advokat
טורמע	Fengsel
געוועב (ביאלאגיע)	Vev (biologi)
באפאלא	Buffalo
AP	Associated Press
לאנדאנער בארא פון האמערסמיט און פולהאם	Hammersmith and Fulham
רבקה	Rebekka (bibelsk person)
לוט	Lot (bibelsk person)
לאנדאנער בארא פון וואלטם פארעסט	Waltham Forest
פאסיל	Fossil
טאקלאבאן	Tacloban
Myspace	Myspace
זשיטאמירער גובערניע	Zjytomyr oblast
זשענאפער לאפעז	Jennifer Lopez
די הונדערט ביכער פונעם יארהונדערט פון לע מאנד	Århundrets 100 bøker ifølge Le Monde
אראפנעם	Subtraksjon
כירורגיע	Kirurgi
קאמעדיע	Komedie
טענעריפע	Tenerife
דניעפער	Dnepr
ווערנער הייזנבערג	Werner Heisenberg
אורין	Urin
1850ער	1850-årene
וואלראס	Hvalross
כעזבאלא	Hizbollah
שטערן (קאפ)	Panne
תהילים	Salmenes bok
אווענידא פאוליסטא	Avenida Paulista
אשור	Assyria
ארבעטסלאזיקײט	Arbeidsledighet
מעכאניק	Mekanikk
באריס פאסטערנאק	Boris Pasternak
בידגאש	Bydgoszcz
קינא	Kino
נאטינגהאם	Nottingham
זשורנאל	Tidsskrift
קוואדראטישע גלייכונג	Andregradsligning
אמעריקאנער פוסבאל	Amerikansk fotball
גרייפפרוכט	Grapefrukt
עסיג	Eddik
דוד המלך	David av Israel
פעלקער מארד	Folkemord
טעלעטאביס	Teletubbiene
זופ	Suppe
איינגאס פון גינע	Guineabukta
אייז האקי	Ishockey
קורדיסטאן	Kurdistan
מערידן	Hemoroide
פאלמעסונג	Obduksjon
געריכט	Domstol
ספר ויקרא	Tredje Mosebok
אוראלטע היסטאריע	Oldtiden
ווארצל	Rot (plantedel)
קראכמל	Stivelse
ארגאניזאציע פאר עקאנאמישע קאאפעראציע און אנטוויקלונג	Organisasjonen for økonomisk samarbeid og utvikling
זשוליא גילארד	Julia Gillard
דייוויד דשזאנסטאן	David Lloyd Johnston
האמלעט	Hamlet
דויד הילבערט	David Hilbert
שירעם	Paraply
חיפה	Haifa
ווארשע פאקט	Warszawapakten
ראמאדאן	Ramadan
דעמיליטאריזירטע זאנע	Demilitarisert sone
עטנישע גרופע	Etnisitet
אירישער ים	Irskesjøen
יאזעף געבעלס	Joseph Goebbels
זאץ	Setning (grammatikk)
גראם (מאס)	Gram
באר שבע	Beersheba
טאלקאוואנא	Talcahuano
אויבערשאפט	Suverenitet
אנוואר סאדאט	Anwar Sadat
בירגערשאפט	Statsborgerskap
תחת	Rumpeball
מעכאנישע ארבעט	Arbeid (fysikk)
פארשונג	Forskning
URL	Uniform Resource Locator
אבזערוואציע פונעם טאל	Mirante do Vale
גוגל ערד	Google Earth
פארענהייט	Grad Fahrenheit
כארקעוו	Kharkiv
סעבאסטיאן פעטל	Sebastian Vettel
40 (נומער)	40 (tall)
וואל	Ull (tekstil)
PDF	Portable Document Format
קאנוס	Kjegle
USB	USB
קאקאא בוים	Kakaotre
ציוניזם	Sionisme
ווייסע בלוט צעל	Hvit blodcelle
טאליבאן	Taliban
שעפילד	Sheffield
יארק	York
קעטי פערי	Katy Perry
עלנבויגן	Albue
MP3	MP3
ספר דברים	Femte Mosebok
בארד	Skjegg
30 (נומער)	30 (tall)
קלינישע דעפרעסיע	Depresjon
נביא	Profet
מוטאציע	Mutasjon
טרויאנישער קריג	Den trojanske krig
בוימל	Olje
ארכיטעקט	Arkitekt
איוואן פאוולאוו	Ivan Pavlov
טאפאלאגיע	Topologi
גאלדע מאיר	Golda Meir
ארקעסטער	Orkester
טאטואירונג	Tatovering
פינאנץ	Finans
1000 (נומער)	1000 (tall)
SMS	Short Message Service
דזשארדזש בוש	George Bush
ניוראן	Nevron
טרוקעניש	Tørke
היינריך הימלער	Heinrich Himmler
שווארצער פעפער	Svart pepper
ספר במדבר	Fjerde Mosebok
רעפערענדום	Folkeavstemning
אייקידא	Aikido
הילף:מערסטע געפרעגטע פראגעס	Wikipedia:OSS
סארא פעלין	Sarah Palin
גאַניידן הייל	Thien Duong
פארזיכערונג	Forsikring
לאסט אויטא	Lastebil
דעלטע	Elvedelta
בייסעקסואלוטעט	Bifili
בורגנלאנד	Burgenland
ארגאניזאציע	Organisasjon
גראז	Grasfamilien
געשטאפא	Gestapo
פאלינאם	Polynom
מעהרן	Mähren
תלמוד	Talmud
סולטאן	Sultan
מיכאיל סאקשווילי	Mikheil Saakasjvili
סי בי עס	CBS
טשאנדיגאר	Chandigarh
פערל	Perle
נקיבה	Hun
פילזען	Plzeň
ארעם	Arm
אנגקאר וואט	Angkor Vat
דארבי	Derby (Derbyshire)
נאטירלעכע סעלעקציע	Naturlig seleksjon
זאא-גארטן	Dyrehage
אקעאנאגראפיע	Oseanografi
קריסטאל	Krystall
מאקאס	Mac OS
ליידן	Leiden
מאנאפאל	Monopol
קיווי	Kivier
אפאלא 11	Apollo 11
שטרימפ	Sokk
בנימין נתניהו	Benjamin Netanyahu
אאזיס	Oase
ברעם	Øyenbryn
פופיק	Navle
פאס	Pass
סוחר	Forretningsfolk
יעקב בן זבדי	Apostelen Jakob
בנימין זאב הערצל	Theodor Herzl
לא פלאטא	La Plata
דן שעכטמאן	Dan Shechtman
פלוים	Plomme
דינער (קאמפיוטער)	Tjener
זכר	Han (kjønn)
מאטאר	Motor
קארדאבע, ארגענטינע	Córdoba (Argentina)
ליקוי לבנה	Måneformørkelse
פארד מאטאר	Ford Motor Company
דזשים מאריסאן	Jim Morrison
סאלמאן ראשדי	Salman Rushdie
באשער על אסאד	Bashar al-Assad
לעגענדע	Legende
דריווש דער ערשטער	Dareios I av Persia
כעמישער בונד	Kjemisk binding
היץ	Varme
קטניות	Erteblomstfamilien
שפיל טעאריע	Spillteori
ריטשארד דאקינס	Richard Dawkins
עפידעמיע	Epidemi
וועקטאר	Vektor (matematikk)
GNU	GNU
טיטאניק (פילם)	Titanic (1997)
קאניבאליזם	Kannibalisme
שרעק	Frykt
אורי געלער	Uri Geller
עס עס	Schutzstaffel
די סטאר ספענגלד בענער	The Star-Spangled Banner
יידישער לוח	Det jødiske året
בערינג ים	Beringhavet
אומזיכערקייט פרינציפ	Heisenbergs uskarphetsrelasjon
פארט	Havn
סודאקו	Sudoku
פונקט (געאמעטריע)	Punkt
אקספארד ענגליש ווערטערבוך	Oxford English Dictionary
מאטראס	Sjømann
עלבע	Elba
מזרח כינע ים	Østkinahavet
The Doors	The Doors
איבערקערעניש	Statskupp
RSS	RSS
האקנקרייץ	Hakekors
אמעריקאנער פרעזידענט וואלן 2008	Presidentvalget i USA 2008
מיסט	Avfall
פעטש	Pécs
אקוואריום	Akvarium
דונקערק	Dunkerque
בארענטס ים	Barentshavet
א ליד פון אייז און פייער	En sang om is og ild
מוכאמאד כוסיין טאנטאווי	Mohamed Hussein Tantawi
פייל	Pil
מיסטיק	Mystikk
פעליקס מענדלסאן	Felix Mendelssohn
קינעטישע ענערגיע	Kinetisk energi
טראפעז	Trapes (geometri)
שרייבמאשין	Skrivemaskin
מיקראפאן	Mikrofon
שאץ	Suceava
פוליצער פרייז	Pulitzerprisen
פידזשי הינדי	Fijiansk hindi
דארפור	Darfur
ראאול קאסטרא	Raúl Castro
ישראל מוזיי	Israel Museum
בארג קייט	Fjellkjede
יאס	Iași
לופטליניע	Flyselskap
באק	Kinn (anatomi)
רוביקס קוב	Rubiks kube
ברוין	Brun
פארגעוואלדיגונג	Voldtekt
ענריקע איגלעסיאס	Enrique Iglesias
קו קלוקס קלען	Ku Klux Klan
שעטלאנד	Shetland
ווארען באפעט	Warren Buffett
קאנדאליזא רייס	Condoleezza Rice
געבורטס טאג	Fødselsdag
ווארעם	Makk
ייחוס	Slektsforskning
מילטאן פרידמאן	Milton Friedman
עזה	Gaza (by)
קאמפיילער	Kompilator
נארוועגישער ים	Norskehavet
אייזבארג	Isfjell
MS-DOS	MS-DOS
אמעריגא וועספוטשי	Amerigo Vespucci
ספר יהושע	Josvas bok
דער גאדפאטער	Gudfaren
מענטא	Mynteslekta
פאריס הילטאן	Paris Hilton
מאריא מאנטי	Mario Monti
הערמאן גערינג	Hermann Göring
לונגען קענסער	Lungekreft
צירקוס	Sirkus
אידענטיטעט קארטע	Legitimasjon
מוסטער:Commonscat	Mal:Commonscat
טוירק	Dreiemoment
סטעם צעל	Stamcelle
אויגן לאד	Øyelokk
23 (נומער)	23 (tall)
מיין קאמף	Mein Kampf
דניפראפעטראווסק	Dnipropetrovsk
דיק טשעיני	Dick Cheney
מין (אידענטיטעט)	Sosialt kjønn
סטודענט	Student
תפילין	Tefillin
פאראבעל	Parabel
שופר	Sjofar
CNN	CNN
אימפעריע	Imperium
מלכות יהודה	Kongedømmet Judea
באבי יאר	Babij Jar
קאסמאס שאטל	Romferge
ליינוס פאלינג	Linus Pauling
פרימצאל	Primtall
ניי מאשין	Symaskin
הערמאן וואק	Herman Wouk
זעקסטאגיקע מלחמה	Seksdagerskrigen
קריסטאפער היטשענס	Christopher Hitchens
קורצע דערציילונג	Novelle
שמעון וויזנטאל	Simon Wiesenthal
קאלומביע אוניווערסיטעט	Columbia University
אומאפהענגיקייט מלחמה	Den arabisk-israelske krig 1948
יום כיפור מלחמה	Jom kippur-krigen
סיני מלחמה	Suezkrisen
ערשטע לבנון מלחמה	Libanon-krigen 1982
צווייטע לבנונישע מלחמה	Libanon-krigen (2006)
על אקצא אינטיפאדע	Andre intifada
מאסאטשוסעטס אינסטיטוט פון טעכנאלאגיע	Massachusetts Institute of Technology
קעמברידזש, מאסאטשוסעטס	Cambridge (Massachusetts)
דען קוועיל	Dan Quayle
רינא	Reno (Nevada)
אנאהיים, קאליפארניע	Anaheim
טוריזם	Turisme
די אינטערנאציאנאלע זינגליד	Internasjonalen
דיכטער	Poet
חתונה	Bryllup
פאסט	Postvesen
וואסאבי	Wasabi (plante)
Visual Basic .NET	Visual Basic .NET
פרעפעקטורן פון יאפאן	Japans prefekturer
קוואדראטצאל	Kvadrattall
צוזאמענגעזעצטע צאל	Sammensatt tall
פראנץ יאזעף	Frans Josef I av Østerrike-Ungarn
ראמאן פאלאנסקי	Roman Polański
פּארטא וואראס	Puerto Varas
פּונטא ארענאס	Punta Arenas
סיבילאנט	Sibilanter
אנאטאליע	Anatolia
שבטי ישראל	Israelitter
שיר השירים	Høysangen
הורדוס	Herodes den store
ספר מלאכי	Malakis bok
אהרן הכהן	Aron
כהן גדול	Ypperstepresten i Israel
גוגל שמועס	Google Talk
קלימאטאלאגיע	Klimatologi
קאליש	Kalisz
אייראפעישע עקאנאמישע געמיינדע	Det europeiske fellesskap
ליסא	Leszno
שמועס	Samtale
רעדן	Tale
פעדעראלע רעזערוו	Federal Reserve
זשאבע	Springpadder
רופערט מורדאק	Rupert Murdoch
בערגל	Ås
וועסטשעסטער קאונטי	Westchester County
קאַטעגאָריע:מאנארכן	Kategori:Monarker
קאַטעגאָריע:רעגירונג מעטאדן	Kategori:Styreformer
קאַטעגאָריע:רעגירונג	Kategori:Myndigheter
קאַטעגאָריע:ליבע	Kategori:Kjærlighet
קאַטעגאָריע:וואיעוואדעשאפטן פון פוילן	Kategori:Polens voivodskap
קליינפוילישע וואיעוואדעשאפט	Lillepolske voivodskap
מאזאוויער וואיעוואדעשאפט	Masoviske voivodskap
אונטערקארפאטישע וואיעוואדעשאפט	Subkarpatiske voivodskap
גרויספוילישע וואיעוואדעשאפט	Storpolske voivodskap
ווארט פראצעסאר	Tekstbehandling
קאַטעגאָריע:פילמען	Kategori:Filmer
וואקזאל	Jernbanestasjon
מוסטער:היסטאריע פון לענדער אין אייראפע	Mal:Europeisk historie
װיקיפּעדיע:וויקיפעדיע אין די מעדיע	Wikipedia:Omtale
Active Directory	Active Directory
בראנפן	Brennevin
טיש קאמפיוטער	Stasjonær PC
זשארזש ביזע	Georges Bizet
בליצקריג	Blitzkrieg
שוויצבאד	Badstue
דניאל פארענהייט	Daniel Gabriel Fahrenheit
אלפרעד יאדל	Alfred Jodl
אבדאללא, קעניג פון סאודי	Abdullah av Saudi-Arabia
דזשאלאל טאלאבאני	Jalal Talabani
אסיף אלי זארדארי	Asif Ali Zardari
נוייען מין טריעט	Nguyen Minh Triet
טרואנג טאן סאנג	Trương Tấn Sang
שמעון פרס	Shimon Peres
וואצלאוו קלאוס	Václav Klaus
אבדאללא דער צווייטער	Abdullah II av Jordan
איסלאם קארימאװ	Islom Karimov
EBay	EBay
אביגדור ליבערמאן	Avigdor Lieberman
טראנס-סיבירישע באן	Den transsibirske jernbanen
צה"ל	Israels forsvar
דענקער	Intellektuell
168 (נומער)	168 (tall)
אסקאר שינדלער	Oskar Schindler
ריינהארד היידריך	Reinhard Heydrich
אריאל שרון	Ariel Sharon
זינד	Synd
קאפעין	Koffein
אשקלון	Ashkelon
וואסילי קאנדינסקי	Vasilij Kandinskij
רייזע	Reise
טורעם פון לאנדאן	Tower of London
אבסערוואטאריע	Observatorium
מערי מעגדעלין	Maria Magdalena
מארקס די ברידער	Brødrene Marx
טעארעם	Teorem
כאליף	Kalif
בראכטייל	Brøk
סענאט	USAs senat
קורס (פינאנץ)	Valutakurs
צענטראלבאנק	Sentralbank
סיטען	Sion (Sveits)
באקסער	Johannesbrødtre
מאנטרע	Montreux
ווישי רעגירונג	Vichy-regimet
סאליוואן קאונטי	Sullivan County (New York)
אוריה החתי	Uria
טעטריס	Tetris
ברעכונג	Lysbrytning
יונתן הוופסי	Jonatan Apphus
מתתיהו הכהן	Mattatias
דעלפי	Delfi
פלאטא	Høydedrag
יצחק באשעוויס זינגער	Isaac Bashevis Singer
פיער דע פערמא	Pierre de Fermat
בר מצווה	Bar mitsva
מעקינטאש	Apple Macintosh
קארטעקס	Hjernebark
רודאלף העס	Rudolf Hess
אויער וואקס	Ørevoks
טעראר אטאקע אין מומביי (2008)	Terrorangrepene i Mumbai 26. november 2008
טרערן	Tårer
מומע	Tante
פעטער	Onkel
העמד	Skjorte
סאפי שאל	Sophie Scholl
רודאלף פראנץ העס	Rudolf Höß
קריסטיאנע פ'	Christiane Vera Felscherinow
יוליוס שטרייכער	Julius Streicher
מאיר אמשיל ראטשילד	Mayer Amschel Rothschild
אנטאן דרעקסלער	Anton Drexler
וולאדימיר קעפן	Wladimir Köppen
יירגן שטרופ	Jürgen Stroop
גליקל	Glückel von Hameln
וואלפגאנג פעטרי	Wolfgang Petry
משה מענדלסאן	Moses Mendelssohn
טאמאס מאסאריק	Tomáš Masaryk
גאס	Gate
פוילבוים	Geitvedslekten
כעמישע סובסטאנץ	Kjemisk substans
גוגל דעסקטאפ	Google Desktop
גוגל כלים פאס	Google Toolbar
טעראבייט	Terabyte
ליכט (לעמפל)	Levende lys
אליגאראכיע	Oligarki
פריינט (סעריע)	Venner for livet
מאזלען	Meslinger
צארן	Sinne
רעגירונגס מאכט אבטייל	Maktfordelingsprinsippet
װיקיפּעדיע:פעסטשטעלן	Wikipedia:Verifiserbarhet
Ethernet	Ethernet
25 (נומער)	25 (tall)
24 (נומער)	24 (tall)
60 (נומער)	60 (tall)
אוראנוס (אפגאט)	Uranos
קאמפיוטער פראגראמירן	Programmering
קאנטראבאס	Kontrabass
דענענבורג	Daugavpils
מגילת רות	Ruts bok
טשעק	Sjekk
פריזן ברייק	Prison Break
טאבריז	Tabriz
גייסט וויסנשאפט	Humaniora
נירנבערג פראצעס	Nürnbergprosessen
פאקער	Poker
קאפעליטש	Hatt
דענדראכראנאלאגיע	Dendrokronologi
פלאש	Flaske
קארן (טרופע)	Korn (band)
ענגלישער בירגערקריג	Den engelske borgerkrigen
עדווארד גריג	Edvard Grieg
קא גע בע	KGB
טראגעדיע	Tragedie
זשאן טראוואלטע	John Travolta
1 אין אפריל	Aprilsnarr
קייט בלאנשט	Cate Blanchett
ארטאדאקסישע יידנטום	Ortodoks jødedom
פרישטיק	Frokost
ווייכווארג אינזשעניריע	Programvareutvikling
ערוואקסענער	Voksen
פייער מויער	Brannmur (datateknikk)
האמעאפאטיע	Homøopati
אינזשעניר	Ingeniør
קארפ	Karpe
אייזערנער קופאל	Iron Dome
געלט אויטאמאט	Minibank
ספר שופטים	Dommernes bok
דעצימאל	Titallsystemet
נאהיט	Kikert
TCP/IP	TCP/IP
נח	Noah
ציטרוס פרוכט	Sitrusfrukt
סעגעד	Szeged
מעלאן	Melon
אילת איינגאס	Akababukten
שלעזיע	Schlesien
גלעזל	Drikkeglass
כישוף	Magi
פאסט פוד	Hurtigmat
ווייטאג	Smerte
באשטעק	Bestikk
GM	General Motors Corporation
צור	Tyr
טעמוקא	Temuco
באדליען ביבליאטעק	Bodleian Library
ליניארע אלגעברע	Lineær algebra
דעזיין	Design
בלוט דרוק	Blodtrykk
איראן-איראק מלחמה	Iran–Irak-krigen
גאמבע	Hake
איניעס	Aineias
קאמפיוטער טעקע	Datafil
קאנדזשי	Kanji
פליניוס דער עלטערער	Plinius den eldre
ראיאן	Region
נאמען	Navn
העקסאדעצימאל סיסטעם	Sekstentallsystemet
היסטאריע פון כינע	Kinas historie
ציפער	Siffer
נעווראלאגיע	Nevrologi
אפעראציע בארבאראסע	Den tyske invasjonen av Sovjetunionen
ספעם	Søppelpost
סאול בעלאו	Saul Bellow
לעסטער	Leicester
שוועמל	Fruktlegeme
טורעם בריק	Tower Bridge
מושקאט נוס	Muskatnøttslekten
ראמעא און יוליא	Romeo og Julie
רמת הגולן	Golanhøyden
טכויר	Stinkdyrfamilien
26 (נומער)	26 (tall)
סעלינע גאמעז	Selena Gomez
יאהאן שטראוס דער זון	Johann Strauss d.y.
מאסול	Mosul
וועגעטאריאניזם	Vegetarianisme
תנ"ך	Tanákh
Windows 95	Windows 95
העראען (טעלעוויזיע סעריע)	Heroes (TV-serie)
איידלשטיין	Edelsten
קאנטערי	Country
גענעראל	General
דזשודאס פריסט	Judas Priest
גרופע (מאטעמאטיק)	Gruppe (matematikk)
סוזאן בויל	Susan Boyle
אינטעליגענץ	Intelligens
סאוואנאה	Savannah (Georgia)
צפון אקטאן אונטערגרונט סטאנציע	North Acton undergrunnsstasjon
אשרה	Asjera
מארטין בובער	Martin Buber
שמן־זית	Olivenolje
אהוד אלמערט	Ehud Olmert
צייכענען	Tegnekunst
גט	Skilsmisse
דאקומענטארער פילם	Dokumentarfilm
איסטמאס	Eid (landform)
מארק שאגאל	Marc Chagall
לאקאמאטיוו	Lokomotiv
קאדעקס כאמוראבי	Hammurabis lover
קשאנאוו	Chrzanów
ווישי	Vichy
ברעג ים	Kyst
גרויסווארדיין	Oradea
ביאביא (טייך)	Biobío (elv)
אינטערסטעיט הייוועי סיסטעם	Interstate Highway
מיליאו וויאדוקט	Millau-broen
F-16 פייטינג פעלקון	Lockheed Martin F-16 Fighting Falcon
קלויזנבורג	Cluj-Napoca
פונט	Pund (masseenhet)
דעפיניציע	Definisjon
יאסוא פוקודא	Yasuo Fukuda
ראשי תיבות	Akronym
פלי מאנשאפט	Kabinpersonale
אומקרויט	Ugress
יאאכים פאן ריבענטראפ	Joachim von Ribbentrop
חזיר ווארצל	Vorte
אנצינדונג	Betennelse
נאוויגאציע	Navigasjon
וויטעבסק	Vitebsk
קעלץ	Kielce
פוסיקאט דאלז	The Pussycat Dolls
שבת	Sabbat (jødisk)
כעמישער סימבאל	Kjemisk symbol
קאמפאניע (מיליטעריש)	Kompani
קלענסטע געמיינזאמע טאפלונג	Minste felles multiplum
קורץ ווארט	Forkortelse
ארץ	Malm
ספרונזשינע	Fjær (teknikk)
האניג בין	Honningbier
דריווש דער דריטער	Dareios III av Persia
ארטיקל (גראמאטיק)	Artikkel (ordklasse)
בהמה	Bufe
ליסטע פון שטעט און שטעטלעך אין פוילן	Liste over byer i Polen
ארץ יהודה	Judea
אמיש	Amish
ליולקע	Tobakkspipe
פלאצק	Płock
ראדעם	Radom (by i Polen)
היפאטענוז	Hypotenus
גלידער איבערפלאנצונג	Transplantasjon
בוקאווינא	Bukovina
נארגילע	Vannpipe
שייטל	Parykk
שאנק	Skap
טארנע	Tarnów
קרוינבלעטל	Kronblad
הלכה	Halakhá
שת	Set (bibelsk person)
פייער לעשער	Brannvesen
איראק מלחמה	Invasjonen av Irak i 2003
מעדיטאציע	Meditasjon
אראנדזש קאונטי, ניו יארק	Orange County (New York)
דימינוטיוו	Diminutiv
בערגאמאט	Bergamott
יותם המלך	Jotam av Juda
אפרים קציר	Efraim Katzir
ראקלענד קאונטי	Rockland County
נבוכדנאצר	Nebukadnesar
ארטיקל	Artikkel
יהודה המכבי	Judas Makkabeus
אינזל לאנד	Øystat
חסידי אומות העולם	Righteous Among the Nations
היסטאריע פונעם פאראייניגטן קעניגרייך	Storbritannias historie
מינאריטעט רעגירונג	Mindretallsregjering
מיקלאש הארטי	Miklós Horthy
איינגאס פון קאדיז	Cadizbukta
כאפעז על אסאד	Hafez al-Assad
אמעדעא מאדיליאני	Amedeo Modigliani
NSA	National Security Agency
סאציאל דעמאקראטיע	Sosialdemokrati
אינפראסטרוקטור	Infrastruktur
פסח	Pesach
פראפעסאר	Professor
קארמען מיראנדא	Carmen Miranda
אמבאסאדאר	Ambassadør
היסטאריע פון דייטשלאנד	Tysklands historie
געבורט קאנטראל	Prevensjon
דניאל בערנולי	Daniel Bernoulli
יאקאב בערנולי	Jakob Bernoulli
אטיקע	Attika
נומערן סיסטעם	Tallsystem
שוועדישע קראנע	Svensk krone
קבלה	Kabbala
גאלדפיש	Gullfisk
שדרות	Sderot
לאנד איינגעשלאסן	Liste over verdens innlandsstater
געגנט	Strøk
ביקס	Gevær
אייזערנעם פארהאנג	Jernteppet
געארגי זשוקאוו	Georgij Zjukov
קוואל וואסער	Kilde (vann)
טעם	Smak
ברוקלין בריק	Brooklyn Bridge
וויליאמסבורג בריק	Williamsburg Bridge
זעג	Sag
שאקאל	Sjakaler
ווארראזאנאו נערויס בריק	Verrazano Narrows Bridge
אהוד ברק	Ehud Barak
טאפען זי בריק	Tappan Zee Bridge
ווייטקייט	Avstand
עכו	Akko
וואלווערהאמפטאן	Wolverhampton
נח'ס תיבה	Noahs ark
יהושפט	Josjafat av Juda
קליינהאנדל	Detaljhandel
קינדערגארטן	Barnehage
ים כנרת	Genesaretsjøen
ענדגילטיקע לייזונג	Den endelige løsning
פערל הארבער	Pearl Harbor
באמבע	Bombe
רמב"ם	Maimonides
טינט	Blekk
פרא באנא	Pro bono publico
גילוי עריות	Incest
קאטאראקט	Katarakt (medisin)
פינפעק	Pentagon
פייער ווארקס	Fyrverkeri
מיקראכוואליע	Mikrobølge
מאכמוד אבאס	Mahmoud Abbas
טאפיר	Tapirer
קאפיטע	Hov (biologi)
דינאמיק	Dynamikk (mekanikk)
עלעקטראנישער בוך	E-bok
יאנקערס, ניו יארק	Yonkers
קינגסטאן אויף האל	Kingston upon Hull
ישראלדיקע פאן	Israels flagg
פאל מארטין	Paul Martin
על דזשאלסאן	Al Jolson
זשאן קרעטיען	Jean Chrétien
קים קעמפבעל	Kim Campbell
ברייען מאלראני	Brian Mulroney
דזשאן טורנער	John Turner
ביאאינפארמאטיק	Bioinformatikk
גלגול	Reinkarnasjon
לעסטער פערסאן	Lester Bowles Pearson
דזשאן דיפענבעיקער	John Diefenbaker
לואיס סעינט לורענט	Louis Saint-Laurent
וויליאם ליאן מעקענזי קינג	William Lyon Mackenzie King
ארטור מעגען	Arthur Meighen
ראבערט בארדן	Robert Borden
ווילפריד לאריער	Wilfrid Laurier
דזשאן אלעקסאנדער מאקדאנאלד	John Macdonald (statsminister)
ריקי מארטין	Ricky Martin
יצחק בן-צבי	Yitzhak Ben-Zvi
עזר ווייצמאן	Ezer Weizman
קלעמענט אטלי	Clement Attlee
טשערנאבל	Tsjernobyl
פולקע	Lår
מאקבעט	Macbeth (skuespill)
קרעאציאניזם	Kreasjonisme
קריג'ס געזעצן	Krigens regler
אלאניס מאריסעט	Alanis Morissette
ריבענטראפ מאלאטאוו אפמאך	Molotov–Ribbentrop-pakten
וויליאם דער פערטער	Vilhelm IV av Storbritannia
דידזשיי	Disc jockey
התקווה	Hatikvah
מנחם בעגין	Menachem Begin
רויטערס	Reuters
חנוכה	Hanukka
עדיפוס	Oidipus
קאלערי	Kalori
הארון אל-ראשיד	Harun al-Rashid
ראש השנה	Rosj hasjaná
מגילת אסתר	Esters bok
קהלת	Forkynneren
ליסטע פון שטעט אין די פאראייניגטע שטאטן לויט באפעלקערונג	Liste over byer i USA med mer enn 100 000 innbyggere
נאמינאטיוו	Nominativ
לופט פארפעסטיקונג	Luftforurensning
בראונאו אם אין	Braunau am Inn
וויץ	Vits
קאבאל	COBOL
וועב 2.0	Web 2.0
שווייסן	Sveising
נעסטער	Dnestr
לינזן	Linse (plante)
מאנטיס	Knelere
װיקיפּעדיע:קוואלן פאר ביכער	Wikipedia:Bokkilder
ניי שקל	Ny israelsk shekel
היץ פאמפע	Varmepumpe
ארון הברית	Paktens ark
מיסוראטאה	Misurata
זשענעט זשעקסאן	Janet Jackson
באם	Bostedsløs
פראפעסיאנעלע ראנגלען	Profesjonell wrestling
אינטערנאציאנאלע דאטע ליניע	Datolinjen
ווורשט	Pølse
קאמעמבערט	Camembert
ERP	Enterprise resource planning
פארמער	Bonde
אפמאך	Traktat
ספר ירמיהו	Jeremias bok
שטאַל	Gård
מעראן	Meran
ספר עזרא	Esras bok
רעזערוואואר	Vannmagasin
האנטוך	Håndkle
פלוטאקראטיע	Plutokrati
ספר טוביה	Tobits bok
פארפום	Parfyme
גרעסטער געמיינזאמער טיילער	Største felles divisor
אידעע	Idé
גומע	Gummi
שינזא אבע	Shinzō Abe
פערמא'ס לעצטער טעארעם	Fermats siste teorem
Grand Theft Auto (סעריע גאמעס)	Grand Theft Auto
אדמיראל	Admiral
גרינלענדישער ים	Grønlandshavet
וויאטשעסלאוו מאלאטאוו	Vjatsjeslav Molotov
ליפט	Heis
יום כיפור	Jom kippúr
מאזשיארן	Madjarere
שמואל יוסף עגנון	Samuel Josef Agnon
בראך	Brokk
פארהאנדלונג באציאונגען	Informasjon og samfunnskontakt
באקסהארן	Bukkehornkløver
מוסלעם ברידערשאפט	Det muslimske brorskapet
קאסינא	Kasino
רוקן	Rygg (anatomi)
גרענעץ	Grense (geografisk)
כנסת	Knesset
טאל פון די מלכים	Kongenes dal
שטאטס שטאַט	Bystat
רב	Rabbiner
בריוו	Brev
לערנען	Læring
אליהו הנביא	Elia
נארמאלע פארטיילונג	Normalfordeling
ערשטע הילף	Førstehjelp
ערעקשאן	Ereksjon
כינעזישער קאלענדאר	Den kinesiske kalender
מבול וואסער	Syndflod
ציינבערשטל	Tannbørste
זשאנאס ברידער	Jonas Brothers
קוואדראט ווארצל	Kvadratrot
טייס	Tisza
יוסיפון	Josefus
בלעק אייד פיס	The Black Eyed Peas
סינגל	Singel (musikk)
פאסיק	Belte
עקסעטער	Exeter
קאמיל פיסארא	Camille Pissarro
אילת	Eilat
קאקטייל	Cocktail
כותל	Vestmuren
פרעפיקס	Prefiks
אפמאך פון ווערדון	Traktaten i Verdun
שאמפאניע	Champagne
ביבליאגראפיע	Bibliografi
מעשה בראשית	Skapelse (teologi)
טראן דאק לואנג	Tran Duc Luong
אטלאנטיק סיטי	Atlantic City
בריסק	Brest (Hviterussland)
יושב ראש	Styreleder
אראבישע לענדער	Den arabiske verden
קארלא ברוני	Carla Bruni
דאטיוו	Dativ
יוסף	Josef (stamfar)
אגד	Egged
אקוזאטיוו	Akkusativ
קאניאק (בראנפן)	Brandy
כוסיין קעניג פון יארדאניע	Hussein av Jordan
טשארטקאוו	Tsjortkiv
ברונא שולץ	Bruno Schulz
ארכעוו	Horokhiv
עדזשווער	Edgware
גאלדערס גרין	Golders Green
קאסעטע	Musikkassett
אתרוג	Cedrat
דזשארדזש קארלין	George Carlin
לאנדאנער בארא פון בארנעט	Barnet (distrikt)
ספינקס	Sfinks
װיקיפּעדיע:וויאזוי צו רעדאקטירן א בלאט	Hjelp:Redigering
ציפי ליבני	Tzipi Livni
טבריה	Tiberias
אירענא סענדלער	Irena Sendler
בוריק	Sukkerbete
גלח	Pastor
טרעבלינקע	Treblinka
געטא	Getto
בערנארד מאנטגאמערי	Bernard Law Montgomery
יאן אנטאנעסקו	Ion Antonescu
מסטיסלאוו ראסטראפאוויטש	Mstislav Rostropovitsj
באיער	Bayer (selskap)
BP	BP
טייק דעט	Take That
באנקראטירונג	Konkurs
אש	Aske
קאנצענטראציע לאגער	Konsentrasjonsleir
וואנע	Badekar
שווארצער סעפטעמבער	Sort September (organisasjon)
סטריפיז	Striptease
עדווארד בענעש	Edvard Beneš
שאנדע	Skam
אראם כאטשאטוריאן	Aram Khatsjaturjan
איסאראקו יאמאמאטא	Isoroku Yamamoto
בית שאן	Bet-Sjean
קרית ביאליק	Kiryat Bialik
דימונה	Dimona
קרית גת	Kiryat Gat
כפר סבא	Kfar Saba
יאנוש קורטשאק	Janusz Korczak
בית שמש	Beit Shemesh
עפולה	Afula
בני ברק	Bnei Brak
ערד, ישראל	Arad (Israel)
הרצליה	Herzliya
מאנטל	Jakke
פרייע פראנקרייך	Frie Frankrike
צומי	Smokk
סאביבאר	Sobibór
ראול וואלענבערג	Raoul Wallenberg
לאטקע	Røstipotet
ראטנבורג	Rothenburg ob der Tauber
לחיים	Skål (gest)
מאגל	Gomp
גארנישט	Ingenting
פראנסוא אראגא	Dominique François Jean Arago
ווארשעווער געטא	Warszawagettoen
ישיבה	Yeshiva
קארל מאריע פאן וועבער	Carl Maria von Weber
ארץ ישראל	Israels land
עוזי	Uzi
איגאר טאם	Igor Tamm
פארמעזאן	Parmesan
שפייעכץ	Spytt
בן סירא	Siraks bok
אייראסטאר	Eurostar
עקסאן-מאביל	Exxon Mobil
מתושלח	Metusalem
עטיאלאגיע	Etiologi
מנשה מלך יהודה	Manasse av Juda
קעלטער	Vineri
יד ושם	Yad Vashem
קאוולע	Kovel
אונגוואר	Uzjhorod
זשיטאמיר	Zjytomyr
ראוונע	Rivne
פאלטאווע	Poltava
יהודי מענוחין	Yehudi Menuhin
מאנמעטה	Monmouth
סאמועל האנעמאן	Samuel Hahnemann
דינגען	Husleie
ישראל אוימאן	Robert Aumann
פאנטאנאל	Pantanal
טשערנאוויץ	Tsjernivtsi
מעלות	Dyd
זאפאראזשיע	Zaporizjzja
פירסינג	Piercing
פיעטרקאוו	Piotrków Trybunalski
ראמאללא	Ramallah
דיאספער	Kaki
פייסעליס	Lyktslekta
װאשינגטאניא	Washingtonia
קאליפארניער מאנרענדל	Kaliforniavalmue
ראדאמסק	Radomsko
פאפירוס	Papyrus (plante)
מייק הוקאבי	Mike Huckabee
עי די על	Anti-Defamation League
דראהביטש	Drohobytsj
ירמיהו	Jeremia
נינא האגען	Nina Hagen
עקאנאמיע	Økonomi
אבסטראקטע אלגעברע	Abstrakt algebra
רוסישע־יאפאנעזער מלחמה	Den russisk-japanske krig
צווילינג	Tvilling
פינק	P!nk
מאגלעוו באן	Maglev
פלוין	Slette
וויע	Øyenvipp
מיידאנעק	Konzentrationslager Majdanek
באל-פאוינט פעדער	Kulepenn
מאטהויזען	Mauthausen-Gusen konsentrasjonsleir
חיים סוטין	Chaim Soutine
בעלזשיץ פארטיליקונג לאגער	Belzec
מארק ראטקא	Mark Rothko
כעלמנא פארטיליקונג לאגער	Chełmno (konsentrasjonsleir)
יעווגעני קיסין	Jevgenij Kissin
זשאסעף ליבערמאן	Joe Lieberman
פייל קרייץ	Pilkors-partiet
נארמאן פינקעלשטיין	Norman Finkelstein
דער שטירמער	Der Stürmer
דאטשע	Datsja
אסיפ צאדקין	Ossip Zadkine
טערעזנשטאט	Theresienstadt konsentrasjonsleir
האס	Hat
אוניווערסיטעט פון עדינבורג	University of Edinburgh
פראספער מערימע	Prosper Mérimée
קאליקסט דער דריטער	Callistus III
מישעל באקמאן	Michele Bachmann
וואלדיוויא	Valdivia
וואלס מיט באשיר	Vals med Bashir
שרויפן-ציער	Skrutrekker
קרעדיט קארטל	Kredittkort
קיבוץ	Kibbutz
מגן דוד	Davidsstjerne
קאלעג צו קאלעג	Peer-to-peer
היסטאריע פון רוסלאנד	Russlands historie
אקעאנוס	Okeanos
אפטאלמאלאגיע	Oftalmologi
צירונג	Smykke
דברי הימים	Krønikebøkene
כוואסטוב	Fastiv
קויציע	Kausjon
אנקאלאגיע	Onkologi
אולטראשאל	Ultralyd
אקאדעמיע	Akademi
מאזשינא ליניע	Maginotlinjen
אורי צבי גרינבערג	Uri Zvi Grinberg
נגב	Negevørkenen
זיגל	Segl
פעטראלאגיע	Petrologi
צידון	Sidon
דרוזן	Drusere
העלענע	Helena
לעמבערגער גובערניע	Lviv oblast
מוזיקאלאגיע	Musikkvitenskap
בינארישע אפעראציע	Binær operasjon
שינקאנסען	Shinkansen
אונגארישע רעוואלוציע	Oppstanden i Ungarn
איבערלעבונג	Erfaring
קארי	Curry
מאכאמעד אמין על כוסייני	Haj Amin al-Husseini
וואל סטריט זשורנאל	The Wall Street Journal
פאפקארן	Popkorn
הדס	Myrt
מייוווד (אילינויס)	Maywood (Illinois)
טורקיז	Turkis (edelsten)
פעדער	Penn
דער אייביגער יודע	Der Ewige Jude
StarCraft	StarCraft
שפיאנאזש	Spionasje
ווינער אוניווערסיטעט	Universitetet i Wien
בלוטשטורץ	Blødning
אינפעקציע	Infeksjon
קאנדענסירונג	Kondensasjon
ראמזיי מאקדאנאלד	Ramsay MacDonald
הערבערט הענרי אסקוויט	Herbert Asquith
פארלאמענטארע דעמאקראטיע	Parlamentarisme
שפאקטיוו	Lupe
קארפאראציע	Entreprise
ערלוי	Eger
נעשונאל זשיאגראפיק	National Geographic Society
באטאנישער גארטן	Botanisk hage
פעלשער	Falskmyntnerne i Sachsenhausen
טירא	Tira
רהט	Rahat
אופקים	Ofakim
נתיבות	Netivot
נהריה	Nahariya
וואהלינער גובערניע	Volyn oblast
זיידע-באבע	Besteforeldre
טמרה	Tamra
אינטערנעט פארום	Diskusjonsforum
חברון	Hebron
הונגער	Hungersnød
בטלמיוס	Ptolemaios I Soter
גאלף פון סועץ	Suezbukten
קארניע	Hornhinne
ביהייוויאריזם	Behaviorisme
שאפראן	Sopron
גייסטליכקייט	Åndelighet
טריפאלי (לבנון)	Tripoli (Libanon)
דזשעסיקא סימפסאן	Jessica Simpson
הענטשקע	Hansker
דיסקרימינאציע	Forskjellsbehandling
אומעט	Sørgmodighet
אַלטינאָ אַראַנטעס בנין	Edifício Altino Arantes
פיזיקער	Fysiker
סימפטאם	Symptom
וואלד פייער	Skogbrann
אוניווערסיטעט פון לאנדאן	University of London
ארקאדיע	Arkadia
קאנװערט	Konvolutt
יאכט	Lystbåt
סיטואציע קאמעדיע	Situasjonskomedie
איי-קיו	IQ
עם 16	M16
קארלאס סלים	Carlos Slim
פאסעיק	Passaic
מנורה	Menorá
זעגלשיף	Seilskip
שינקען	Skinke
גלאסטער	Gloucester
אגאדיר	Agadir
פאראדיע	Parodi
באלקאן	Balkong
לאכן	Latter
נענסי פעלאוסי	Nancy Pelosi
רעפובליק פון טעקסעס	Republikken Texas
איטאליע בנין	Edifício Itália
געגאסענע בליי אפעראציע	Gaza-krigen
נס	Mirakel
ריבית	Rente
גאסטראנאמיע	Gastronomi
טאבו	Tabu
בלאגער	Blogger
חסידות	Ḥasidisk jødedom
נירעדהאז	Nyíregyháza
קאמף פון טראפאלגאר	Slaget ved Trafalgar
אקצידענט	Ulykke
אשדוד	Ashdod
בלעקבערי	BlackBerry
אלפרעד דרייפוס	Alfred Dreyfus
אלדא מארא	Aldo Moro
מענעלאוס	Menelaos
מידלזברא	Middlesbrough
נעקטאר	Nektar
קאנצעסיע	Franchising
יוחנן וואלאך	Yochanan Vollach
חיים ווייצמאן	Chaim Weizmann
באגי מען	Buse
דאטן גראבן	Data mining
אינטעליגענטע אויספלאנעווען	Intelligent design
צפון וויעטנאם	Nord-Vietnam
בעזים	Sopelime
בראנכן אנצינדונג	Bronkitt
כוזרים	Khazarer
שווארצאפל	Pupill
געדרוקטער שטראמקרייז	Kretskort
לוויה	Grav
סיסקא	Cisco Systems
בלאז אינסטרומענטן	Blåseinstrument
האנט גראנאט	Håndgranat
וושט	Spiserør
לופטקילער	Klimaanlegg
פארוויילונג	Underholdning
ראדיוס	Radius
רעגענט	Regent
העברעאישער אוניווערסיטעט אין ירושלים	Det hebraiske universitetet i Jerusalem
B-52 סטראטופארטרעס	Boeing B-52 Stratofortress
לאנדאנער שולע פון עקאנאמיק	London School of Economics
V-1 און V-2 ראקעטן	V2
מייקל מאור	Michael Moore
טעקע סיסטעם	Filsystem
בעסאראביע	Bessarabia
הענגען	Hengning
קאנטרי	Bygd
װיקיפּעדיע:אויסשפארן פאליסי	Wikipedia:Retningslinjer for blokkering
לופטרער	Luftrør
מעט דעימאן	Matt Damon
וויטאמין D	Vitamin D
פאביע	Fobi
רעסעסיע	Resesjon
זינגער	Låtskriver
מיינפריים	Stormaskin
אסאציאטיוויטעט	Assosiativ lov
געמיינדע	Gemeinschaft
פאגראם	Pogrom
טראטואר	Fortau
סטערויד	Steroid
קאנאלא אויל	Raps
טייג	Deig
ליבידא	Libido
קעטשאפ	Ketchup
אבסעסיוו קאמפאלסיוו דיסארדער	Tvangslidelser
שכיר חרב	Leiesoldat
סברה	Fornuft
עופות	Fjærkre
ניר שטיין	Nyrestein
גראמען	Rim
ליקער	Likør
פאטאך	Fatah
קוקי	Informasjonskapsel
בערזע	Børs
אראן בור	Aaron Burr
אלמן	Enke (sivilstand)
איינקונפט שטייער	Inntektsskatt
אינפיניטיוו	Infinitiv
דזיאוואני דא פאלעסטרינא	Giovanni Pierluigi da Palestrina
סיטי פון וועסטמינסטער	City of Westminster
מאסאזש	Massasje
סאפטוועיר באג	Programvarefeil
סטאטוע	Statue
זכריה הנביא	Sakarjas bok
באאט	Ba'athpartiet
פאלעאגראפיע	Paleografi
איוב	Job
עיר פארס וואן	Air Force One
פערגי	Fergie
חלשות	Besvimelse
גאליציע	Galicia (Sentral-Europa)
פורים	Purim
פאטימא	Fatima az-Zahra
יפו	Jaffa
פערסישער קאלענדאר	Iransk kalender
וואפיטי	Wapiti
אמבולאנס	Ambulanse
צימער	Husrom
מאנדלען	Mandler (anatomi)
דרום וויעטנאם	Sør-Vietnam
באריס זשאנסאן	Boris Johnson
סטיוון זשעי גאלד	Stephen Jay Gould
געפעכט	Konflikt
בעדואינער	Beduiner
קאמפיוטער ווארעם	Dataorm
די מיזעראבלער	De elendige
טרורא	Truro
דאו דשאונס אידאסטריאלער עוורעדזש	Dow Jones Industrial Average
היינעקען אינטערנאציאנאל	Heineken
כארעאגראפיע	Koreografi
פרייצייט	Fritid
אבו מוסאב אל-זארקאווי	Abu Musab al-Zarqawi
פראנקפורטער	Pølse i brød
סאאיד כאסאן נאסראללא	Hassan Nasrallah
שאצער קאנט	Suceava (fylke)
אסמאניע	Osmaniye
בן גוריון פליפעלד	Ben Gurion internasjonale lufthavn
דארלינג טייך	Darling (elv)
פאציענט	Pasient
אליעזר בן יהודה	Eliezer Ben-Yehuda
ליסטע פון שטעט אין אונגארן	Liste over byer i Ungarn
משה קצב	Moshe Katsav
מערב האלבקיילעך	Den vestlige halvkule
קרעדיט (פינאנץ)	Kredit
גארטל הערפעס	Helvetesild
ווערטיקאל	Vertikal
סוכות	Løvhyttefest
צאל (שטייעראמט)	Toll
ען קא ווע דע	NKVD
כנבוזי דער צווייטער	Kambyses II av Persia
רוסטאווי	Rustavi
כיראמאנטיע	Kiromanti
ניוט גינגריטש	Newt Gingrich
פלארעסענט באלב	Lysrør
פ.ג. ראָסטאָוו	FK Rostov
ארטור רובינשטיין	Arthur Rubinstein
פאהאד בין אבדול אזיז	Fahd bin Abdul Aziz
ספרעדשיט	Regneark
באנק פון ענגלאנד	Bank of England
ניו עידזש	New age
טעריטאריע	Territorium
באר (באדייטן)	Bar
באפי די וואמפיר יעגערין	Buffy, vampyrenes skrekk
מישעל ראדריגעז	Michelle Rodríguez
צדקיהו	Sidkia av Juda
יצחק שמיר	Yitzhak Shamir
ניבול פה	Banneord
מעד	Mjød
קאבל-טעלעוויזיע	Kabel-TV
קארע	Bark
אידיאם	Idiom
צעהן מכות	Egyptens ti plager
סטארטפאס	Rullebane
טארף	Torv
ערעקטייל דיספאנקשען	Erektil dysfunksjon
קרב מגע	Krav Maga
סימבאל פון ישראל	Israels riksvåpen
היסטאגראם	Histogram
איוואן קאניעוו	Ivan Konev
שפרינגען מיט א טיטשקע	Stavsprang
גאון	Geni
וואזעלין	Vaselin
פוקס	Ekte rever
כרמל בארג	Karmelberget
סי-פי-אר	Hjerte-lunge-redning
אמסטעל	Amstel
מיטגלידשטאט פונעם אייראפעישן פארבאנד	Den europeiske unions medlemsstater
וויליאם דזשיימס אדאמס	Will.i.am
מלחמה קעגן טעראר	Krigen mot terror
פילאנטראפ	Filantropi
טראפן (פליסיגקייט)	Dråpe
אנאלאגיע	Analogi
חיפה דיסטריקט	Haifa-distriktet
מופטי	Mufti
Fox News	Fox News Channel
סייסמישע כוואליעס	Seismisk bølge
פעך	Tjære
איימאן על-זאוואהירי	Ayman al-Zawahiri
באראט	Borat: Cultural Learnings of America for Make Benefit Glorious Nation of Kazakhstan
ניו דיל	New Deal
קראנקן שוועסטער	Sykepleier
אנגינע	Halsbetennelse
פאראזיט	Parasittisme
קאשע	Grøt
איבל	Kvalme og brekninger
ליכוד	Likud
פיליפ ראטה	Philip Roth
לאביאונג	Korridorpolitikk
באלפורס דעקלאראציע	Balfourerklæringen i 1917
ביסטריץ	Bistrița
אלכסנדר קארעלין	Aleksandr Karelin
סידרא איינגאס	Sidrabukten
ווינדל	Bleie
שענק	Bar (utested)
באקלאווא	Baklava
זעל מיללער	Zell Miller
עמיגראציע	Utvandring
קבר-קירך	Den hellige gravs kirke
פיטבול	Pitbull (rapper)
זומערשפרענקלעך	Fregner
פראזע (לינגוויסטיק)	Frase (grammatikk)
פאבריקאציע	Industriteknikk
דיסטריבוטיוו	Distributiv lov
עקאנאמיסט	Samfunnsøkonom
א סכנה'דיגע מעטאד	A Dangerous Method
צפת	Safed
פאקט	Faktum
IMAX	IMAX
קאמין	Ildsted
הוידלקע	Huske
פריוואטקייט	Personvern
קנאה	Misunnelse
דרום דיסטריקט (ישראל)	Sørdistriktet
משה דיין	Moshe Dayan
צענטער דיסטריקט (ישראל)	Sentraldistriktet
פאלאפעל	Falafel
פילגש	Konkubinat
דעוויד שווימער	David Schwimmer
ישעיהו	Jesaja
שחיטה אין ווירזשיניע-טעק	Virginia Tech-massakren
קעניגלעכע בארא פון קענזינגטאן און טשעלסי	Kensington and Chelsea
פאקטאריזאציע	Faktorisering
מאראמאראשער דיסטריקט	Maramureș (fylke)
LDAP	Lightweight Directory Access Protocol
ווייב	Hustru
וואלונטיר	Frivillighet
פעלד	Åker
קישקע קענסער	Tarmkreft
ישראל נאציאנאלע ביבליאטעק	Israels nasjonalbibliotek
קאלעדזש	College
טראנסזשענדער	Transperson
קנאות	Seloter
לאטעריע	Lotteri
אקאדעמישע דיפלאמע	Akademisk grad
באָרג	Lån
צפון דיסטריקט (ישראל)	Norddistriktet
אסיפ מאנדעלשטאם	Osip Mandelstam
אקאדעמיע פאר דער העברעישער שפראך	Akademiet for hebraisk språk
אלעמאל-גרין	Eviggrønn
סופרים קארט	Høyesterett
פתח תקוה	Petah Tiqwa
הערש	Gaseller
שטיוול	Støvler
טרענסעקסואליזם	Transkjønnethet
דזשונגל	Jungel
טאן	Tonn
לוי אשכול	Levi Eshkol
כשרות	Kasjrut
דועל	Duell
CFA פראנק	CFA-franc
פאדאליע	Podolia
אפאלגאטיקע	Apologetikk
עזרא	Esra
משניות	Misjná
חולון	Holon
קאטיושא	Katjusja
נתניה	Netanya
ירושלים דיסטריקט	Jerusalem-distriktet
סיודאד דעל עסטע	Ciudad del Este
איך האב א חלום	I Have a Dream
האנגאר	Hangar
פוערטעווענטורא	Fuerteventura
לימביק סיסטעם	Limbiske systemet
שטעלע	Yrke
מימיקרי	Mimikry
ראפיק על כארירי	Rafiq Hariri
אבדאללא קעניג פון יארדאניע	Abdullah I av Jordan
פאנטשקע	Doughnut
גלית	Goliat
ראבערט וואדלאוו	Robert Wadlow
רמת גן	Ramat Gan
תל אביב דיסטריקט	Tel Aviv-distriktet
ריב אייזן	Rivjern
סייענס (זשורנאל)	Science
הורדוס אנטיפס	Herodes Antipas
מינסקער גובערניע	Minsk voblast
הייבריד אויטא	Hybridbil
הר הבית	Tempelhøyden
היינט	Nåtid
מלך פון פוילן	Liste over Polens herskere
ווען	Varebil
ישראל דיסטריקטן	Israels distrikter
אסימילאציע	Assimilering
קייט רייען	Kate Ryan
בריטישער מאנדאט	Palestinamandatet
פלשתים	Filistere
הר תבור	Tabor
קאמעניץ, אוקראינע	Kamenets-Podolsk
מוכאמעד אמאר	Muhammed Omar
ווידעא קליפ	Musikkvideo
יחזקאל	Esekiel
קארליק	Kortvoksthet
MS Freedom of the Seas	MS «Freedom of the Seas»
ווערט	Verdi (etikk)
פארקויפן	Salg
אוניווערסיטעט פון בוענאס איירעס	Universitetet i Buenos Aires
סודעטן	Sudetenland
זשאנגלירן	Sjonglering
שרה	Sara
Windows Explorer	Windows Utforsker
מיקראסקאפ	Mikroskop
פעלץ	Pelsverk
אייער ברויט	Arme riddere (mat)
ציל	Mål (målsetting)
היסטאריע פון פוילן	Polens historie
וויטאמין C	Vitamin C
יונה סאלק	Jonas Salk
ווידרע	Otere
ירושה	Arv
וועלט היסטאריע	Verdens historie
שיצפאס	Sikkerhetsbelte
סעודה	Fest
גיאם דע מאשא	Guillaume de Machaut
שם	Sem (bibelsk person)
ראשון לציון	Rishon LeZion
פאלעסטינער	Det palestinske folk
שבועות	Sjabuót
דאנא אינטערנאשיאנאל	Dana International
פאווע	Påfugler
סטאטוס קווא	Status quo
היפאקריטיע	Hykleri
סאניק	Sanok
לאנדאנער בארא פון לאמבעט	Lambeth (distrikt)
טאלק	Talk (andre betydninger)
לאנדאנער בארא פון קאמדן	Camden (distrikt)
פאס דו איגוואסו	Foz do Iguaçu
לבנון טאל	Bekaadalen
רשימה פון מדרשים	Midrasj
דזשעסיקא סוטא	Jessica Sutta
קאנסענסוס	Konsensus
פאלאשן	Beta Israel
בראהמאגופטא	Brahmagupta
איינס קרייז	Enhetssirkelen
מצבה	Gravminne
מערת המכפלה	Makpela-hulen
גיחון קוואל	Gihonkilden
גאז קאמער	Gasskammer
צענטראלע ליניע	Central-linjen
לאנדאנער בארא פון בארקינג און דעגנהעם	Barking and Dagenham
קין	Kain
אבשלום	Absalom
ערפינדער	Oppfinner
גרינוויטש וויליזש	Greenwich Village
אלוועלטלעכע ציוניסטישע באוועגונג	World Zionist Organization
זוהר	Zohar
אלגעברעישע סטרוקטור	Algebraisk struktur
קאנסערוואטיוו יידנטום	Konservativ jødedom
סטינגרעי	Piggrokker
לאנדאנער בארא פון האקני	Hackney (distrikt)
לאנדאנער בארא פון הילינגדן	Hillingdon (distrikt)
לאנדאנער בארא פון איזלינגטאן	Islington (distrikt)
פיאדאר יעמעליאנענקא	Fjodor Jemeljanenko
טאלאנט	Ferdighet
שיכרות	Rus
הר הזיתים	Oljeberget
גוגל ביכער	Google Books
ביאמאלעקול	Biomolekyl
אלישע	Elisja
איזאפאד	Tanglus
ציריכער אוניווערסיטעט	Universitetet i Zürich
סימפאזיום	Symposion
ALS	Amyotrofisk lateralsklerose
פייזער	Pfizer
דורכגאס פון סיציליע	Siciliastredet
סנחריב	Sankerib
לאנדאנער בארא פון ברענט	Brent (distrikt)
לאנדאנער בארא פון בעקסלי	Bexley (distrikt)
לאנדאנער בארא פון אילינג	Ealing (distrikt)
באברויסק	Babrujsk
כבוד	Ære
הענגאווער	Bakrus
רחובות	Rehovot
קאלא-קאלא	Colo-Colo
רחל	Rakel (bibelsk person)
וויספע	Holme (geografi)
לוד	Lod
מוזיקאלישע קאמפאזיציע	Komposisjon
פיקאדילי ליניע	Piccadilly-linjen
בלאדי מערי	Bloody Mary
אצ"ל	Irgun
עריק ראבערטס	Eric Roberts
קאקאא	Kakao
גוואנטאנאמע בעי	Guantánamobukta
לאנדאנער בארא פון נייהעם	Newham
לאנדאנער בארא פון טאר האמלעטס	Tower Hamlets
כתובים	Ketubim
ניסן	Nisán
אב	Ab
סאברא און שאטילא	Massakrene i Sabra og Shatila
לאנדאנער בארא פון בראמלי	Bromley (distrikt)
בעדפארד	Bedford (England)
לעשאויטא	Brannbil
גראן טשאקא	Gran Chaco
עיל	Ale (øl)
ספערויד	Rotasjonsellipsoide
קראי	Karaitter
פשעמישל	Przemyśl
אדום	Edom
משה שרת	Moshe Sharett
לבנון ברודער קריג	Den libanesiske borgerkrigen
פרעמיער מיניסטער פון ישראל	Israels statsminister
אל על	El Al
אומאן	Uman (Ukraina)
גראד (ווינקל)	Gon
פלירטינג	Kurtisering
טשילענישער פלאט	Armada de Chile
בת ים	Bat Yam
הייך	Høyde
לאנדאנער בארא פון רעדברידזש	Redbridge (distrikt)
ביאלע	Biała Podlaska
דינדיש	Gyöngyös
לאנדאנער בארא פון הארוי	Harrow (distrikt)
לאנדאנער בארא פון ענפילד	Enfield (distrikt)
לאנדאנער בארא פון וואנדזווערט	Wandsworth (distrikt)
פסיכיאטער	Psykiater
מקווה	Mikvé
איסאאק לעװיטאן	Isaak Levitan
מצה	Massá
פרינציפ	Prinsipp
בלעך	Blikk (metall)
פולין גדול	Stor-Polen
ניו יארק פאסט	New York Post
סאאיד קטב	Sayyid Qutb
פארקויף מאשין	Myntautomat
רחבעם	Rehabeam av Juda
סייקס-פיקא פארשטענדעניש	Sykes-Picot-avtalen
בלוט צעל	Blodcelle
אריאן	Orion (romskip)
גאלף	Golf (andre betydninger)
ענטעבע	Entebbe
באצילן	Basiller
מאנארך פלאטערל	Monarksommerfugl
אייר	Ijár
פייסל דער ערשטער	Faisal I av Irak
רודאלף זשוליאני	Rudy Giuliani
מאניקע לעווינסקי	Monica Lewinsky
אדר	Adár
סטיווען קאלבערט	Stephen Colbert
חרדים	Haredisk jødedom
קלעזמער	Klezmer
פארטיזאנער	Partisan
טלית	Tallit
חנוך	Enok
ווילקאמיר	Ukmergė kommune
מזרח יאריד	Orient Fair
לערי קינג	Larry King
געשעפט	Butikk
לאנדאנער בארא פון הארינגיי	Haringey
שפינדל	Håndtein
לאנדאנער בארא פון האונסלא	Hounslow (distrikt)
שכם	Nablus
שטאף	Materiale
שמשון הגיבור	Samson (person)
גלעד שליט	Gilad Shalit
סעגוויי	Segway
היטש	Haiking
לעטיסיע	Leticia
דראמאטורג	Dramatiker
לאנדאנער בארא פון לואישעם	Lewisham (distrikt)
לאנדאנער בארא פון העווערינג	Havering (distrikt)
עטיאפישער קאלענדאר	Etiopisk kalender
פידעל ראמאס	Fidel V. Ramos
מוזיקאלישע טרופע	Band
שוים	Skum
קאפל	Kippa
הר חרמון	Hermonfjellet
דזשערי סיינפעלד	Jerry Seinfeld
לוי	Levi
שטים בענדער	Stemmebånd
ווייסוויידל הערש	Hvithalehjort
ישעיהו לעבאוויטש	Yeshayahu Leibowitz
דאקלאנדס לייכטע באן	Docklands Light Railway
גייטסהעד	Gateshead
טיין	Tyne (England)
נביאים	Nebiim
כסלו	Kislév
הארץ (צייטונג)	Haaretz
אדלערפיש	Ørnefisker
דונאם	Dunam
ראמזאן קאדיראוו	Ramzan Kadyrov
אראקל	Orakel
תמוז	Tammuz
אלול	Elúl
טבת	Tebét
Sky News	Sky News
דעיוויד לעטערמאן	David Letterman
דער ניו יארקער	The New Yorker
זשאן עדווארדס	John Edwards
זעלבסטמארד אטאקע	Selvmordsbombe
שבט (חודש)	Sjebát
טשעסטער נימיץ	Chester Nimitz
אמעריקאנער מוזיי פון נאטירלעכער היסטאריע	American Museum of Natural History
תשרי	Tisjré
לארענס סטערן	Laurence Sterne
מאראנצן זאפט	Appelsinjuice
איבונגען	Fysisk aktivitet
לאפע	Labb
פאול וואלפאוויטש	Paul Wolfowitz
ריימאנד קארווער	Raymond Carver
קינגס קראס באן סטאנציע	King's Cross stasjon
דארף מענטשן	Village People
עמא בונטאן	Emma Bunton
גוגל ווידעא	Google Video
קריגס פירער	Krigsherre
טייוול אינזל	Djevleøya
גוגל אנאליטיקס	Google Analytics
רעכטס און לינקס פארקער	Høyre- og venstrekjøring
אנגון	Anggun
רמלה	Ramla
לאנדישער אויטאנאמישער אוניווערסיטעט פון מעקסיקא	Universidad Nacional Autónoma de México
טשערעפאכע	Skilpadder
Microsoft Exchange Server	Microsoft Exchange Server
בית"ר ירושלים	Beitar Jerusalem
מכבי תל אביב	Maccabi Tel Aviv FC
מגילת העצמאות	Den israelske selvstendighetserklæringen
גסיסה	Hjernedød
סנדק	Fadder
ליינען	Reading
VOA	Voice of America
שאפונג	Skapelse
ישראלדיקער ספארטלער אומקום ביי דער מינכן אלימפיאדע	München-massakren
חם	Kam (bibelsk person)
מלכות ישראל	Kongedømmet Israel (Samaria)
דעיל קארנעגי	Dale Carnegie
געלע זשורנאליזם	Den gule presse
אוניווערסיטעט פון טשילע	Universitetet i Chile
דראגאן פרוכט	Pitahaya
בעני דעפארטמענט	Beni (departement)
סעמינאר	Seminar (kirkelig)
קאטשאבאמבא דעפארטמענט	Cochabamba (departement)
טאריכא דעפארטמענט	Tarija (departement)
באנגאר	Bangor (Wales)
ישראל (באדייטן)	Israel (andre betydninger)
ניאוף	Hor
האדזש	Hajj
סאנטא קרוז (דעפארטמענט אין באליוויע)	Santa Cruz (departement)
טשוקיסאקא דעפארטמענט	Chuquisaca
פאנדא דעפארטמענט	Pando
עפיגלאטיס	Epiglottis
אחאב	Akab av Israel
קעלצער פאגראם	Pogromen i Kielce
פאטאסי דעפארטמענט	Potosí (departement)
שלום עליכם (שרייבער)	Sjolom-Alejkhem
אמעריקאנער חורבן אייראפע מוזיי	United States Holocaust Memorial Museum
90 (נומער)	90 (tall)
שלמה אבן גבירול	Solomon ibn Gabirol
דייוויד דער צווייטער, מלך פון שאטלאנד	David II av Skottland
בויגן	Bogen
מן	Manna
לידא	Lida
חיה	Vilt
קאטשקע (מאסקאווי)	Moskusand
קעגן לבנון בערג	Anti-Libanon
קאוואדא דער ערשטער	Kavadh I av Persia
ארקילאוס	Herodes Arkhelaos
באנק פון ישראל	Bank of Israel
חזקיהו	Hiskia av Juda
קאמיקער	Komiker
מזוזה	Mezuza
מאיר כהנא	Meir Kahane
יואי	Yui
מאטערסדארף	Mattersburg
רויטע ארמיי	Den røde armé
האלאווין	Allehelgensaften
הגנה	Haganah
לאגער (ביר)	Lager (øl)
קרימער מלחמה	Krimkrigen
גראזשניידער	Plenklipper
קאפירעכט	Opphavsrett
ניוגראונדס	Newgrounds
סאדע וואסער	Kullsyreholdig vann
יונתן פאלארד	Jonathan Pollard
שלומציון המלכה	Salome Alexandra
ען קאלטער	Ann Coulter
יידישע קאמף ארגאניזאציע	Żydowska Organizacja Bojowa
באטעריע	Elektrisk batteri
טעלעמארקעטינג	Telefonsalg
דאן ריקלס	Don Rickles
לאנדאנער זאא	London Zoo
דיג	Digg
קאלטקייט	Kulde
בת שבע	Batseba
פרעסע קאנפערענץ	Pressekonferanse
יאסוהירא יאמאשיטא	Yasuhiro Yamashita
לא פאז (דעפארטמענט אין באליוויע)	La Paz (departement)
סוספענדירונג	Hjuloppheng
מארטיני	Martini (cocktail)
דער עניאגראם פון דער פערזענלעכקייט	Enneagram
אר קעלי	R. Kelly
אבים	Abia av Juda
דעזש	Dej
קייסער סאלאט	Cæsarsalat
מאסאווע	Massawa
פאל ראד	Paul Rudd
לייסיק	LASIK
געארג דער זעקסטער	Georg VI av Storbritannia
סאציעלע פאביע	Sosial fobi
43 (נומער)	43 (tall)
יהודה	Juda
סיקריקין	Sikariere
טשעט	Chatting
אגנאסטיציזם	Agnostisisme
יעקב אבינו	Jakob (stamfar)
לח"י	Stern-gjengen
חיים הערצאג	Chaim Herzog
איניגא דזשאנס	Inigo Jones
אסימא	Asimo robot
פרעד טאמפסאן	Fred Thompson
זלמן שזר	Zalman Shazar
סאוט טשיינע מאלל	New South China Mall
בלוט מאראנץ	Blodappelsin
אדמיניסטראציע	Administrasjon
אבא אבן	Abba Eban
אנאנימיטעט	Anonymitet
פארצוימטע באוועגונג	Stop-motion
אוניווערסיטעט פון סאלאמאנקע	Universitetet i Salamanca
דעאדאראנט	Deodorant
רעננה	Ra'anana
אפאסטיל	Apostille
יום השואה	Jom Hashva
דייוויד קוק	David Cook
מתתיהו מיללער	Matisyahu
דזשעסי דזשעקסאן	Jesse Jackson
דעניס קוסיניטש	Dennis Kucinich
גלען בעק	Glenn Beck
ביל אריילי	Bill O'Reilly
סעמי שילט	Semmy Schilt
קארל ראוו	Karl Rove
שמעון וויזענטאל צענטער	Simon Wiesenthal-senteret
יצחק נבון	Yitzhak Navon
מירענדע ווארענונג	Mirandaadvarsel
עיִן תחת עיִן	Øye for øye
יפו טויער	Jaffaporten
הר הצופים	Scopusfjellet
אחזיהו (מלך יהודה)	Akasja av Juda
יהורם (מלך יהודה)	Joram
עוזיהו	Ussia av Juda
ירבעם בן נבט	Jeroboam av Israel
יאשיהו	Josjia av Juda
יהואש (מלך יהודה)	Joasj av Juda
אמציה	Amasja av Juda
אסא	Asa av Juda
אמון	Amon av Juda
דזשעף גארדאן	Jeff Gordon
וואסילי גראסמאן	Vasilij Grossman
באשיר זשומייעל	Bashir Gemayel
קאמאדיטי	Vare
וואדיה סאאדעה	Wadih Saadeh
יגאל אלון	Yigal Allon
אלה	Ela av Israel
יגאל עמיר	Yigal Amir
יהויקים	Jojakim av Juda
הושע בן אלה	Hosea av Israel
יוחנן הורקנוס דער ערשטער	Johannes Hyrkanos
יהויכין	Jojakin av Juda
בעל שם טוב	Jisraél ben Elingézer
קהאליד שייך מוכאמעד	Khalid Sheikh Mohammed
ראש לימבאו	Rush Limbaugh
אנטיפטרוס	Antipatros fra Idumea
באב דאול	Bob Dole
על פרענקען	Al Franken
דן חלוץ	Dan Halutz
מייקל דוקאקיס	Michael Dukakis
אלכסנדר ינאי	Alexander Jannaios
קריסטאפער דאד	Chris Dodd
נתן הנביא	Natan
אלעקס זשאונס	Alex Jones
בערי גאלדוואטער	Barry Goldwater
שעלדאן איידלסאהן	Sheldon Gary Adelson
בועז מעודה	Boaz Mauda
גוש דן	Gush Dan
תל אביבער אוניווערסיטעט	Universitetet i Tel Aviv
קסרי	Caesarea Maritima
שעדליץ	Siedlce
זאב זשאבאטינסקי	Vladimir Jabotinsky
לאנדאנער בארא פון סאטן	Sutton (distrikt)
צאפ	Fletting
אבישג פון שונם	Abisjag
אפשוואכן קריג	Utmattelseskrigen
אינטעריגאציע	Forhør
שלאכט פון אאכן	Slaget om Aachen
אגענטור	Etat
קרית שמונה	Qiryat Shemona
שערן	Frisyre
לאדזשער געטא	Ghetto Litzmannstadt
אמין זשומייעל	Amin Gemayel
דעל.איס.אס	Del.icio.us
געלע לאטע	Jødestjerne
פאראמעדיקער	Ambulansepersonell
אברהם סוצקעווער	Abraham Sutzkever
קבר	Begravelse
געמיט	Humør
פלוראליזם	Pluralisme (vitenskap)
איבעראשונג	Forbauselse
קאסאם	Qassam-rakett
געזונט פארזיכערונג	Helseforsikring
אבו האמזא	Abu Hamza al-Masri
יהודה אריסטובולוס דער ערשטער	Aristobulos I
ראיעל קענעדיען מאונטעד פאליציי	Royal Canadian Mounted Police
יהואחז	Joakas av Juda
ראדני קינג	Rodney King
טאנגא	Tango
מוילאייזל הערש	Mulhjort
בורידאן'ס אייזל	Buridans esel
דעמאקראט	Demokratene
אקטאן שטאט אונטערגרונט סטאנציע	Acton Town undergrunnsstasjon
לאנצהוט	Łańcut
פיליפוס	Herodes Filippo
גאלדשטיין	Goldstein
יהודה אריסטובולוס דער צווייטער	Aristobulos II
יוחנן הורקנוס דער צווייטער	Johannes Hyrkanos II
מתתיהו אנטיגונוס דער צווייטער	Antigonos Mattathias
שאול מופז	Shaul Mofaz
מענדעלע מוכר ספרים	Salomon Abramovitsj
יגאל ידין	Yigael Yadin
שמעון התרסי	Simon Thassi
מוכאמאד סאאיד אל-סאהאף	Mohammed Said al-Sahhaf
אדוניהו	Adonja
אמנון	Amnon
מישעל אאון	Michel Aoun
מהר"ל מפראג	Judah Loew
קעניג מענעליק	Menelik I av Etiopia
יו-עס קאסטומס ענד בארדער פראטעקשן	U.S. Customs and Border Protection
ארדשיר	Ardasjir I av Persia
בייבל קריטיק	Tekstkritisk bibelforskning
טשיטאגאנג	Chittagong
דרעטל	Heftestift
מעמד הר סיני	Sinai (fjell)
וויליאם באקלי	William F. Buckley jr.
אתגר קרת	Etgar Keret
אדווערב	Adverb
דאדולא	Mullah Dadullah
שב"כ	Shin Bet
באשרייבנדיקע סטאטיסטיק	Deskriptiv statistikk
על שארפטאן	Al Sharpton
ברוך גאלדשטיין	Baruch Goldstein
לואיס ליבי	Lewis Libby
דזשאן קארזיין	Jon Corzine
מסורה (טעקסט)	Den masoretiske bibelteksten
מנחם מענדל שניאורסאהן	Menachem Mendel Schneerson
כראניש	Kronisk sykdom
ארטאדאקס	Ortodoksi
קאבל אינטערנעט	Kabelmodem
קאנסטרוקציע	Bygge- og anleggsnæringen
פויקער	Trommeslager
אגדה	Aggada
װיקיפּעדיע:נאכפאלג ליסטע	Hjelp:Overvåke sider
װיקיפּעדיע:באוועגן	Hjelp:Flytte en side
בג"ץ	Israels høyesterett
אחיתופל	Akitofel
סובסטיטוט	Substitutt
10000 (נומער)	10 000
וויאלעט	Lilla
ראזע	Rosa
נצרת	Nasaret
27 (נומער)	27 (tall)
35 (נומער)	35 (tall)
64 (נומער)	64 (tall)
99 (נומער)	99 (tall)
סטענלי פישער	Stanley Fischer
אמ"ן	Aman (IDF)
אפער איסט סייד	Upper East Side
ליטאני טייך	Litani (elv)
ארפכשד	Arpaksjad
זיסקייט	Søtt
בנימין	Benjamin (bibelsk person)
סאהא	SoHo
פאריזער קלוב	Parisklubben
Cbc	Canadian Broadcasting Corporation
ווייט פלעינס, ניו יארק	White Plains (New York)
נאריש און נארישער	Dum og dummere
סינדי שעהין	Cindy Sheehan
עתליה	Atalja
עיפאק	American Israel Public Affairs Committee
היסטאריע פון טעכנאלאגיע	Teknologihistorie
הימל ליניע	Skyline
עמאקא	Amoco
קאנווענץ פאר קינדער-רעכט	FNs konvensjon om barns rettigheter
פיער זשומייעל	Pierre Gemayel
מאקס וויינרייך	Max Weinreich
עד קאטש	Ed Koch
דוד האלבערשטאם (שרייבער)	David Halberstam
רודאלף ווערבע	Rudolf Vrba
אורי לופאליאנסקי	Uri Lupolianski
טאמי לאפיד	Tommy Lapid
זשעק אבראמאף	Jack Abramoff
אידענטיטעט גניבות	ID-tyveri
חדרה	Hadera
דע בירס	De Beers
סידור	Siddur
סייף	Safe
עמיר פרץ	Amir Peretz
השכלה	Haskalá
אנטיק	Antikvitet
סטאק מארקעט	Aksjemarked
פינקטלעכע וויסנשאפטן	Eksakt vitenskap
קערפער שפראך	Kroppsspråk
די לוסטיגע אלמנה	Den glade enke
קאריטיבע פוטבאל גרופע	Coritiba Foot Ball Club
בילד	Bilde
רוקן ביין	Ryggsøyle
אלבאם	Musikkalbum
ראציאנאליזם	Rasjonalisme
Windows 98	Windows 98
פּלאַנאָיסע	Planoise
גווען סטעפעני	Gwen Stefani
זשאנער	Sjanger
קעלי קלערקסאן	Kelly Clarkson
וואל-מארט	Walmart
סוניס	Sunniislam
פאלא פערנאנדעס	Paula Fernandes
Windows 2000	Windows 2000
שינדלערס ליסטע	Schindlers liste
מיסטער בין	Mr. Bean
אויטאנאמיע	Autonomi
נאציאנאלער הימען פון טשילע	Himno Nacional de Chile
Windows Me	Windows Me
סקינהעד	Skinhead
אוואירו	Aveiro (Portugal)
CRM	Kunderelasjonshåndtering
איסטמאן קאדאק	Eastman Kodak
פידלער אויפן דאך	Spelemann på taket
אביעקט	Objekt
Maxthon	Maxthon
בצלאל אקאדעמיע פאר מאדעלירונג און קונסט	Bezalel Academy of Art and Design
חשמונאים	Hasmonske dynasti
אייער ליקער	Advocaat
טאבעלע	Tabell
קרית מלאכי	Kiryat Malakhi
טאמעס און פריינט	Lokomotivet Thomas og vennene hans
עדות המזרח	Mizrahisk jødedom
שטילקייט	Stillhet
זשאני וואקער	Johnnie Walker
מעלה אדומים	Ma'ale Adumim
פאלאנגען	Falangistpartiet (Libanon)
עבר	Eber
ווייכביין	Brusk
גוי	Goy
געהיימע דינסט פון די פאראייניגטע שטאטן	U.S. Secret Service
פראטאפלאנעטארישער דיסק	Protoplanetarisk skive
סופר	Soferim
וועגן מאפע	Veikartet for fred
גערשטן	Byggslekten
טורנהאם גרין אונטערגרונט סטאנציע	Turnham Green undergrunnsstasjon
מיידיי	Flyhavarikommisjonen (TV-dokumentar)
בלאט שניידער בין	Buksamlerbier
אליגאטאר	Alligatorer
טישטיך	Duk
עתניאל בן קנז	Otniel
דאמינעטריקס	Domina
יידישער וועלט קאנגרעס	World Jewish Congress
פארזארג	Tilbud
בערבעין	Bourbon (whisky)
29 (נומער)	29 (tall)
מארך ביין	Beinmarg
הורדוס פון כאלקיס	Herodes av Chalkis
20/20 זעהקראפט	Visus (synsskarphet)
רודאלף קאסטנער	Rudolf Kastner
ישראל יהושע זינגער	Israel Joshua Singer
שאן הענעטי	Sean Hannity
רעי נעיגין	Ray Nagin
וועטשערע	Supé
מייפל סטארי	Maple Story
טראפיק טיקעט	Parkeringsbot
אנטי-פעמיניזם	Antifeminisme
מגן דוד אדום	Magen David Adom
כעמישע ענערגיע	Kjemisk energi
באזעצונג	Israelske bosetninger
אנטי ציוניזם	Antisionisme
באסקין-ראבינס	Baskin-Robbins
מזל טוב	Mazel tov
תרח	Tarah
28 (נומער)	28 (tall)
נאטאליי הארלער	Natalie Horler
עליה אין ארץ ישראל	Aliyah
הילטאן האטעלס	Hilton-hoteller
38 (נומער)	38 (tall)
האנדל	Handel
פּאַן-אייראפעישער פארבאנד	Pan-Europa-bevegelsen
ראדיא גא גא	Radio Ga Ga
האנד טארמאז	Parkeringsbrems
שטעטל	Shtetl
פינפטע עליה	Femte aliyah
בשן	Basan
ראבערט קאטשאריאן	Robert Kotsjarjan
אפטייקעריי	Farmasi
זבולן	Sebulon
האלאנד פארק אונטערגרונט סטאנציע	Holland Park undergrunnsstasjon
רשימה:יידישע שפראכן	Jødiske språk
שידוך	Kirsten Giftekniv
טעיזם	Teisme
אנטוישונג	Skuffelse
באונטי האנטערס	Dusørjeger
פאו'ס געזעץ	Poes lov
הגדה של פסח	Haggadá sjel Pesah
ראובן	Ruben (bibelsk person)
דינער (סעודה)	Bankett
סווינגינג	Swinging
ניו יארק דיילי ניוז	Daily News (New York)
45 (נומער)	45 (tall)
קאני איילענד	Coney Island
קאמפאט	Kompott
אלכסנדר דער צווייטער	Alexander av Judea
מוזיקער	Musiker
נטורי קרתא	Neturei Karta
חשוון	Hesjván
בונדיזם	Bund (jødisk organisasjon)
קווינסוויי אונטערגרונט סטאנציע	Queensway undergrunnsstasjon
יששכר	Jissakar
אנגעשטעלטער	Ansettelse
מיטאג	Middag
פנחס לבון	Pinhas Lavon
אלעקסאנדער, פוילן	Aleksandrów Łódzki
אריסטובולוס דער דריטער	Aristobulos III
פריימעריס	Primærvalg i USA
יצחק אבינו	Isak
וויסנשאפט מוזיי	Science Museum (London)
הענרי דער זיבעטער פון ענגלאנד	Henrik VII av England
טעלאנגאנע	Telangana
אקספארד צירקוס אונטערגרונט סטאנציע	Oxford Circus undergrunnsstasjon
בערלין זאאלאגישער גארטן באן סטאנציע	Zoologischer Garten stasjon
טראנספארט פאר לאנדאן	Transport for London
אנוש	Enosj
אראקל פון דעלפי	Oraklet i Delfi
ניו יארק מעטראפאליטען שטח	Storbyområdet New York
אומבאוועגלעכע גיטער	Fast eiendom
קערפער פלעק	Føflekk
ריינקייט	Renhold
לאנדאנער בארא פון גריניטש	Greenwich (distrikt)
מזומן	Kontanter
קעטאלאגיע	Cetologi
ראנאלד לאודער	Ronald Lauder
אדעס רציחה	Odessamassakren
קוואדראט קילאמעטער	Kvadratkilometer
גליד	Organ
80 (נומער)	80 (tall)
21 (נומער)	21 (tall)
22 (נומער)	22 (tall)
70 (נומער)	70 (tall)
50 (נומער)	50 (tall)
לימפאטישע סיסטעם	Lymfesystem
41 (נומער)	41 (tall)
34 (נומער)	34 (tall)
33 (נומער)	33 (tall)
47 (נומער)	47 (tall)
31 (נומער)	31 (tall)
32 (נומער)	32 (tall)
44 (נומער)	44 (tall)
46 (נומער)	46 (tall)
49 (נומער)	49 (tall)
48 (נומער)	48 (tall)
37 (נומער)	37 (tall)
39 (נומער)	39 (tall)
36 (נומער)	36 (tall)
81 (נומער)	81 (tall)
69 (נומער)	69 (tall)
0.999...	0,999…
ש. אנ-סקי	An-sky
200 (נומער)	200 (tall)
מערב דייטשלאנד	Vest-Tyskland
144 (נומער)	144 (tall)
121 (נומער)	121 (tall)
אריסטובולוס דער פערטער	Aristobulus, sønn av Herodes den store
196 (נומער)	196 (tall)
169 (נומער)	169 (tall)
סט פאנקראס באן סטאנציע	St. Pancras stasjon
מגילה	Skriftrull
אפמאך פון פאריז (1951)	EKSF-traktaten
נארלס בארקלי	Gnarls Barkley
שותפות	Samliv
כהן	Kohen
לאנדאנער בארא פון סאדארק	Southwark (distrikt)
דען רעדער	Dan Rather
טאני סנאו	Tony Snow
מנשה בן ישראל	Menasseh Ben Israel
מאלטע פערסאן	Malte Persson
ווימבלדאן	Wimbledon (London)
אז	Oz
מסכת אבות	Fedrenes ord
נירן איבערפלאנץ	Nyretransplantasjon
לאַכערייַקע	Sketsj
170 (נומער)	170 (tall)
פישטראן	Tran
ל"ג בעומר	Lag la‘ómer
דריטע שינע	Strømskinne
טאפלישאן	Topoľčany
מארטין לוטער קינג דיי	Martin Luther King Day
ניו יארק מאראטאן	New York City Marathon
דאקטאר (פילאסאפיע)	Filosofisk doktorgrad
וועטעראן'ס טאג	Veterans Day
טראדיציע	Masoreter
Directory Service	Katalogtjeneste
אויטאנאמישע רעפובליק פון קרים	Den autonome republikken Krim
דיים	Dime
אגרת ירמיהו	Jeremias brev
אגער	Hingst
גערטנעריי	Gartner
יזרעאל טאל	Jisreeldalen
טרייבעקע	TriBeCa
דרום אזיע	Sør-Asia
דויערהאפטיקייט	Utholdenhet
אידישע געמיינדע	Kehilla
רעכט	Rettighet
פיוט	Pijjut
פירמע	Selskap (jus)
מייל ענד אונטערגרונט סטאנציע	Mile End undergrunnsstasjon
מארבל ארטש אונטערגרונט סטאנציע	Marble Arch undergrunnsstasjon
דזשיבעריש	Kaudervelsk
דעפארטמענט פון שטאט פון די פאראייניגטע שטאטן	Utenriksdepartementet (USA)
בעלגישע מאנארכיע	Liste over Belgias monarker
ברעזשאן	Berezjany
וואטערלו באן סטאנציע	Waterloo stasjon
סאבאטאזש (פילם)	Sabotage (film)
עבספליט אינטערנאציאנאלע באן סטאנציע	Ebbsfleet International stasjon
אילינג בראדוויי באן סטאנציע	Ealing Broadway stasjon
ליווערפול סטריט סטאנציע	Liverpool Street stasjon
באנק-מאנומענט באן סטאנציע	Bank og Monument undergrunnsstasjoner
42 (נומער)	42 (tall)
בער סטערנס	Bear Stearns
רעספיראטאר (מעדיצין)	Respirator
בלינצע	Blini
שווארצע	Svart (hudfarge)
האליפאקס	Halifax (England)
קילאמעטער	Kilometer
טעמע	Subjekt (filosofi)
בית דין	Bet din
בעטנל גרין אונטערגרונט סטאנציע	Bethnal Green undergrunnsstasjon
קאאליציע	Koalisjonsregjering
גאלער	Kabaret (matrett)
זשורי	Jury
גימטריא	Gematri
קאלאנסקאפי	Koloskopi
קארפאטשיא	Carpaccio
לבן	Laban (bibelsk person)
Windows PowerShell	Windows PowerShell
געצנדינעריי	Avgudsdyrkelse
קלאסיק	Klassisk
קאנסיסטואר	Konsistorium
Windows Live	Windows Live
מאדקאן	Madcon
דעטעקטיוו	Kriminalpoliti
טאוול קאמפיוטער	Notatblokk-PC
בייזש	Beige
ספר היובלים	Boken om Jubelårene
קינן	Kenan
ישראל באנען	Jernbane i Israel
בית החיים	Jødiske gravlunder
דארמיטארי	Internat
לעיבער דעי	Labor Day
ברית מילה	Brit Mila
דאקטאראט	Doktorgrad
קאפטער	Hette
גד	Gad (bibelsk person)
געשיר	Dekketøy
קונה	Kunde
עוף	Ande- og hønsefugler
פאלם	Palm, Inc.
טיף פרעגלען	Fritering
קייטנעס	Caithness
באגאזש	Bagasje
לעצט וועגאס	Last Vegas
טשיינעטאון	Chinatown (New York)
עדיטאריעל	Lederartikkel
גרופע	Gruppe (psykologi)
גרופע טעאריע	Gruppeteori
די טשיקאַווע אינצידענט פון דער הונט אין דער נאַכט-צייַט	Den merkelige hendelsen med hunden den natten
רויז (אינפעקציע)	Cellulitis
געיעג	Veddeløp
אקערן	Jordbearbeiding
מאדערניזאציע	Modernisering
שלעפע באבע	Blindebukk
באנד סטריט אונטערגרונט סטאנציע	Bond Street undergrunnsstasjon
על כוסייני	Al-Husseini
רעקרוטירן	Rekruttering
טראנסניסטריע	Transnistria
נעטפליקס	Netflix
עירוני קריית שמונה	Hapoel Ironi Kiryat Shmona FC
קאנטערטעראריזם	Kontraterrorisme
כנסת וואלן 2009	Valget i Israel 2009
הילף:אינהאלט	Hjelp:Portal
וואונדער פרוכט	Mirakelbær
כלב בן יפונה	Kaleb (sønn av Jefunne)
גלעד	Gilead
ליסטע פון פרעמיער מיניסטארן פון קאנאדע	Liste over Canadas statsministere
סיירת מטכל	Sayeret Matkal
ירד	Jared
צד"ל	Sør-Libanon-Arméen
גיטאר וועלט	Guitar World
מסכתא	Gemara
אפענער פראקסי	Åpen proxy
עמענטאל	Sveitserost
ערשטע עליה	Første aliyah
לארן	Larne
שער שכם	Damaskusporten
אבאזשור	Lampeskjerm
אומקער געזעץ	Loven om tilbakevending
יום העצמאות	Yom Ha'atzmaut
צינגאלע	Joint
נאציאנאלע ביבליאטעק פון שוועדן	Kungliga biblioteket
גראגער	Skralle (musikk)
חולה טאל	Huladalen
דזשין	Gin
שלעגער	Slager
אראסטאטיקע	Aerostatikk
יידישע היסטאריע	Jødisk historie
צווייטע עליה	Andre aliyah
אלבערט מאל	Albert Mol
פארמל	Formel (matematikk)
אדער	Blodåre
גוש עציון	Gush Etzion
אפאטשנא	Opoczno
שווארצע שאכטל	Ferdsskriver
C-SPAN	C-SPAN
ווראהאוויצע	Vrahovice
CNBC	CNBC
מאגן	Magesekk
העטראסעקסואליטעט	Heterofili
ישראל צענטראלע ביורא פאר סטאטיסטיק	Israels statistiske sentralbyrå
וועסט עדמאנטאן מאלל	West Edmonton Mall
דרום קענזינגטאן	South Kensington
ישיבה אוניווערסיטעט	Yeshiva University
פינאנציעלער דיסטריקט	Financial District (New York)
לאנג איילענד אייז טיי	Long Island Iced Tea
פלאשינג, ניו יארק	Flushing (Queens)
ארורא דעפארטמענט	Oruro (departement)
טשאנסערי ליין אונטערגרונט סטאנציע	Chancery Lane undergrunnsstasjon
ביליאנער	Milliardær
דעלפין מעשה	Dolphin Tale
טשארלס קראוטהאמער	Charles Krauthammer
חזנות	Hazzán
טשעלסי	Chelsea (New York)
שיוואס ריגעל	Chivas Regal
פרישוואסער פיש	Ferskvannsfisk
טשיסיק פארק אונטערגרונט סטאנציע	Chiswick Park undergrunnsstasjon
עגיפטישע באוואפנטע קרעפטן	Egypts forsvar
מיליאנער	Millionær
גענעראל פארזאמלונג	Generalforsamling
בענזין אלטערנאטיוון	Alternative drivstoff
אנדרוגינוס	Interseksualitet
קליאטשע	Hoppe
גארטן	Hage
אוואד	Kuklegg
עליסא	Elissa
ליטאני אקציע	Konflikten i Sør-Libanon 1978
עשרת השבטים	Israels ti forsvunne stammer
דאו זשאונס	Dow Jones & Company
דעסיידיאוס	Lauvfellende
געטריישאפט	Lojalitet
גרינע ליניע	Grønne Linje
רעפארם יידנטום	Reformjødedom
זאל	Vindfang
כוש (זון פון חם)	Kusj (bibelsk person)
שייטת 13	Shayetet 13
שטאט אוניווערסיטעט פון ניו יארק	State University of New York
עלעקטרישע זעג	Stikksag
יואב בן צרויה	Joab
מעדיקעיד	Medicaid
לבנון קרעפטן	Al Qouwat al Lubnania
פאפיר טייגער	Papirtiger
קארפאטארוס	Karpato-Ruthenia
קוואדער	Quarter
הייליגקייט	Hellighet
פאליסי	Policy
בעדפארד סטייוועסענט	Bedford-Stuyvesant
MLB	Major League Baseball
מאפלער	Lyddemper (kjøretøy)
דעלטע (באדייטן)	Delta
רובע היהודי	Det jødiske kvarter
ליטערארישע זשאנער	Genrelitteratur
װיקיפּעדיע:אמבאסאדע	Wikipedia:Ambassade
לויבן	Lovprisning
שעפערדס בוש אונטערגרונט סטאנציע	Shepherd's Bush undergrunnsstasjon (Central)
ארום די וועלט אין 80 טעג	Jorden rundt på 80 dager
דייטשע לענדער	Tysklands delstater
צעטיילונג	Divisjon (matematikk)
דיסקאטעק	Diskotek
וויינרייך	Weinreich
ראציאנאלע צאל	Rasjonalt tall
פליפעלד	Flyplass
ספין	Spin
אילינג קאמאן אונטערגרונט סטאנציע	Ealing Common undergrunnsstasjon
מזרח אקטאן אונטערגרונט סטאנציע	East Acton undergrunnsstasjon
מייקל סעוועזש	Michael Savage
שומרון	Samaria (region)
עמערגענץ צימער	Legevakt
קאמפיוטער נעצווערק	Datanett
דערציילונג	Narrativ
ליסטע פון טייכן אין אייראפע	Liste over elver i Europa
גרענד דזשורי	Storjury
טוקאן	Tukaner
אליהו דעסלער	Eliyahu Eliezer Dessler
ספא	Spa
מיכל	Mikal (bibelsk person)
תוספתא	Tosefta
פרירונג ברי	Frostskade
אַגנעס מאָניקאַ	Agnes Monica
מערהייט	Kvalifisert flertall
מערב אקטאן אונטערגרונט סטאנציע	West Acton undergrunnsstasjon
קעש ביי דעליווערי	Postoppkrav
משה פייגלין	Moshe Feiglin
ראסל סקווער אונטערגרונט סטאנציע	Russell Square undergrunnsstasjon
300 (נומער)	300 (tall)
גדעון האוזנער	Gideon Hausner
ארעסט	Anholdelse
קאַטעגאָריע:מענער	Kategori:Menn
קאַטעגאָריע:דייטשלאנד	Kategori:Tyskland
קאַטעגאָריע:איטאליע	Kategori:Italia
קאַטעגאָריע:פאראייניגטע שטאטן	Kategori:USA
קאַטעגאָריע:רוסלאנד	Kategori:Russland
קאַטעגאָריע:קאנאדע	Kategori:Canada
קאַטעגאָריע:פאראייניקטע קעניגרייך	Kategori:Storbritannia
קאַטעגאָריע:שפאניע	Kategori:Spania
קאַטעגאָריע:יאפאן	Kategori:Japan
קאַטעגאָריע:אויסטראליע	Kategori:Australia
קאַטעגאָריע:מעקסיקא	Kategori:Mexico
קאַטעגאָריע:אינדיע	Kategori:India
קאַטעגאָריע:ישראל	Kategori:Israel
קאַטעגאָריע:וואטיקאן	Kategori:Vatikanstaten
קאַטעגאָריע:טערקיי	Kategori:Tyrkia
קאַטעגאָריע:דרום אפריקע	Kategori:Sør-Afrika
קאַטעגאָריע:עגיפטן	Kategori:Egypt
קאַטעגאָריע:איראן	Kategori:Iran
קאַטעגאָריע:ניו זילאנד	Kategori:New Zealand
קאַטעגאָריע:ארגענטינע	Kategori:Argentina
קאסערנע	Tøyhus
גלות	Den jødiske diaspora
ניוקאסטל	Newcastle upon Tyne
לאנקאסטער גייט אונטערגרונט סטאנציע	Lancaster Gate undergrunnsstasjon
סאנט פאלס אונטערגרונט סטאנציע	St. Pauls undergrunnsstasjon
טאטנהאם קארט ראד אונטערגרונט סטאנציע	Tottenham Court Road undergrunnsstasjon
האבארן אונטערגרונט סטאנציע	Holborn undergrunnsstasjon
רוה טאג	Helligdag
מפא"י	Mapai
קאַטעגאָריע:אפגאניסטאן	Kategori:Afghanistan
קאַטעגאָריע:עסטרייך	Kategori:Østerrike
קאַטעגאָריע:קובא	Kategori:Cuba
קאַטעגאָריע:עטיאפיע	Kategori:Etiopia
קאַטעגאָריע:איראק	Kategori:Irak
קאַטעגאָריע:ניגעריע	Kategori:Nigeria
קאַטעגאָריע:פאקיסטאן	Kategori:Pakistan
קאַטעגאָריע:פוילן	Kategori:Polen
קאַטעגאָריע:פארטוגאל	Kategori:Portugal
קאַטעגאָריע:סינגאפור	Kategori:Singapore
קאַטעגאָריע:שווייץ	Kategori:Sveits
קאַטעגאָריע:טאנזאניע	Kategori:Tanzania
קאַטעגאָריע:אוקראינע	Kategori:Ukraina
קאַטעגאָריע:וויעטנאם	Kategori:Vietnam
קאַטעגאָריע:זויגערס	Kategori:Pattedyr
קאַטעגאָריע:רעפטילן	Kategori:Krypdyr
קאַטעגאָריע:אמפיביעס	Kategori:Amfibier
קאַטעגאָריע:פויגלען	Kategori:Fugler
קאַטעגאָריע:פאנגי	Kategori:Sopp
קאַטעגאָריע:באקטעריעס	Kategori:Bakterier
קאַטעגאָריע:ווירוסן	Kategori:Virus
קאַטעגאָריע:פלאנצן	Kategori:Planter
קאַטעגאָריע:פיזיק	Kategori:Fysikk
קאַטעגאָריע:נאטור-וויסנשאפטן	Kategori:Naturvitenskap
קאַטעגאָריע:ביאלאגיע	Kategori:Biologi
קאַטעגאָריע:כעמיע	Kategori:Kjemi
קאַטעגאָריע:ערד וויסנשאפטן	Kategori:Geovitenskap
קאַטעגאָריע:היסטאריע	Kategori:Historie
קאַטעגאָריע:געאגראפיע	Kategori:Geografi
קאַטעגאָריע:געזעלשאפט	Kategori:Samfunn
קאַטעגאָריע:רעליגיע	Kategori:Religion
קאַטעגאָריע:ספארט	Kategori:Sport
קאַטעגאָריע:וויסנשאפט	Kategori:Vitenskap
קאַטעגאָריע:פאראייניגטע פעלקער	Kategori:FN
קאַטעגאָריע:אייראפעישער פארבאנד	Kategori:Den europeiske union
קאַטעגאָריע:פילם	Kategori:Film
קאַטעגאָריע:וועלט ירושה ערטער	Kategori:Verdensarven
קאַטעגאָריע:געביידעס	Kategori:Byggverk
קאַטעגאָריע:קאמוניקאציע	Kategori:Kommunikasjon
קאַטעגאָריע:ערד	Kategori:Jorden
קאַטעגאָריע:אינפארמאציע	Kategori:Informasjon
פראזע	Frase (musikk)
טישו פאפיר	Mykpapir
גדליהו בן אחיקם	Gedalja
פאלעסטינע פליטים	Palestinske flyktninger
טעלעגראם	Telegram
400 (נומער)	400 (tall)
אטשאקאטשי	Achacachi
תרפ"א ראיאטן	Jaffa-opptøyene
בתואל	Betuel
טאמעס סילווערסטין	Thomas Silverstein
ליסטע פון אויל אויסגיסונגען	Liste over oljesøl
דארא גובערניע	Darʿā (guvernement)
פינאנץ-מיניסטעריום (ישראל)	Liste over Israels finansministre
מאל	Nattsvermere
אוראלט רוים	Romerriket
אינטיפאדע	Intifada
דיר יאסין	Deir Yassin
שמעון	Simeon (bibelsk person)
רות	Rut
נחשון בן עמינדב	Naksjon
סטרונע אינסטרומענטן	Strengeinstrument
הייסע לופט סיסטעם	Varme-, ventilasjons- og sanitærteknikk
נאטינג היל גייט אונטערגרונט סטאנציע	Notting Hill Gate undergrunnsstasjon
קעשענעוו פאגראם	Chisinau-pogromen
אור עקיבא	Or Akiva
באסטיל	Bastillen
סטעפני גרין אונטערגרונט סטאנציע	Stepney Green undergrunnsstasjon
סמבטיון	Sambatyon
טיזעם	TISM
מעטראפאליטען שטח	Byregion
זשורנאליסט	Journalist
שו בינג	Xu Bing
טערמין	Begrep
קאַטעגאָריע:עקאלאגיע	Kategori:Økologi
קאַטעגאָריע:באדייטן	Kategori:Pekere
קאַטעגאָריע:פילאסאפיע	Kategori:Filosofi
קאַטעגאָריע:פסיכאלאגיע	Kategori:Psykologi
קאַטעגאָריע:קריסטנטום	Kategori:Kristendom
קאַטעגאָריע:איסלאם	Kategori:Islam
קאַטעגאָריע:יידישקייט	Kategori:Jødedom
אראנזש (באדייטן)	Orange
ארגאן	Organ (andre betydninger)
פומבדיתא	Pumbedita
גוגל אלערטס	Google Alerts
אדלער	Ørner
ווייט סיטי אונטערגרונט סטאנציע	White City undergrunnsstasjon
מכבי חיפה	Maccabi Haifa FC
קלייד	Kjole og skjørt
באנעם	Kognisjon
טוילעט הומער	Toaletthumor
סיון	Siván
ספר תורה	Torarull
ברכת החמה	Birkàt haḥammá
בת מצוה	Bat mitsva
פערטע עליה	Fjerde aliyah
טראנספארט אין ישראל	Samferdsel i Israel
דגניה א'	Degania
באכאטניץ	Bochotnica
דריטע עליה	Tredje aliyah
אייסיס	Den islamske staten Irak og Levanten
פאלק	Folkeslag
פארטיידיגונגס מיניסטעריום	Forsvarsminister
רעזשיסאר	Filmregissør
IPv6	IPv6
פייערלעשער סעם	Brannmann Sam
קאנסערוואטיזם אין די פאראייניגטע שטאטן	Amerikansk konservatisme
דערציונגס מיניסטעריום	Liste over Israels utdanningsministre
געזעלשאפט	Selskapsrett
פאערבאול	Powerball
ווילרייק	Wilrijk
היסטאריע פון מדינת ישראל	Israels historie
סטאמפארד היל	Stamford Hill
כנסת וואלן 2006	Valget i Israel 2006
גניבה	Tyveri
אנערקענונג	Takknemlighet
ניוקליז	Kjerne
פארטאל:ליטעראטור	Portal:Litteratur
שטויב	Pulver
שוואגער	Svigerfamilie
ישיבה מרכז הרב שחיטה	Terrorangrepet i Jerusalem 6. mars 2008
ברסלב	Breslover-hasidisme
פרה אדומה	Rød kvige
אליעזר סילווער	Eliezer Silver
שוק מחנה יהודה	Mahaneh Yehuda
פירערשאפט	Ledelse
קאַטעגאָריע:שטומף	Kategori:Stubber
קאַטעגאָריע:פלאנעטן	Kategori:Planeter
קאַטעגאָריע:מוזיק שטומף	Kategori:Musikkstubber
קאַטעגאָריע:קולטור	Kategori:Kultur
קאַטעגאָריע:קאטעגאריעס	Kategori:Kategoriinnhold
קאַטעגאָריע:יארן	Kategori:Årstall
קאַטעגאָריע:גייסט וויסנשאפט	Kategori:Humaniora
קאַטעגאָריע:וויסן	Kategori:Kunnskap
קאַטעגאָריע:קאנטינענטן	Kategori:Kontinenter
קאַטעגאָריע:געאלאגיע	Kategori:Geologi
קאַטעגאָריע:רשימות	Kategori:Lister
קאַטעגאָריע:וויקיפעדע אפהאנדעלונגן	Kategori:Wikipedia:Essayer
צוועלף יאר א קנעכט (פילם)	12 Years a Slave
װיקיפּעדיע:נאמען פון ארטיקל	Wikipedia:Navnekonvensjoner
װיקיפּעדיע:וויקיפעד	Wikipedia:Wikipedianere
טשערעמאיע	Cherimoya
הילף:לעצטע ענדערונגען	Wikipedia:Siste endringer
הארטקייט	Hardhet (materialvitenskap)
סטאוו	Pytt
מאדזשענטא	Magenta
װיקיפּעדיע:אריבערשליסן	Wikipedia:Transklusjon
קאַטעגאָריע:טרופעס	Kategori:Musikkgrupper
שווארמא	Shawarma
מדרש תהלים	Midrasj Tehillim
שוויצן	Svette
װיקיפּעדיע:איינשרייבן	Hjelp:Logge inn
מיר זענען די מילערס	We're the Millers
קורטיס סליווע	Curtis Sliwa
װיקיפּעדיע:עטיקעט	Wikipedia:Wikikette
שליים	Snørr
קאַטעגאָריע:וויקיפעדיע באטס	Kategori:Boter
צייכן	Tegn
פארטאל:סאציאלע װיסנשאפטן	Portal:Samfunn
כוסיין	Hussein
אפעראציע (מאטעמאטיק)	Regneart
בית המקדש	Tempelet i Jerusalem
װיקיפּעדיע:קוואליטעט אטאקע	Wikipedia:Kvalitetsoffensiv
מוסטער:ביכער	Mal:Autoritetsdata
װיקיפּעדיע:זיי דרייסט אין פארבעסערן ארטיקלן	Wikipedia:Vær modig
ברוקווע	Vanlig nepe
מוסטער:ציטירן	Mal:Sitat
קאַטעגאָריע:דייטשן	Kategori:Tyskere
קאַטעגאָריע:אמעריקאנער	Kategori:Personer fra USA
קאַטעגאָריע:אקטיארן	Kategori:Skuespillere
קאַטעגאָריע:בריטישע מענטשן	Kategori:Briter
קאַטעגאָריע:פראנצויזן	Kategori:Franskmenn
קאַטעגאָריע:דענער	Kategori:Dansker
קאַטעגאָריע:איטאליענער	Kategori:Italienere
קאַטעגאָריע:טייכן אין אייראפע	Kategori:Elver i Europa
קאַטעגאָריע:ראמאנען	Kategori:Romaner
קאַטעגאָריע:סצענאר שרייבער	Kategori:Manusforfattere
מוסטער:מל	Mal:Mal
הינריכטונג	Liste over henrettelsesmetoder
קאַטעגאָריע:גוגל	Kategori:Google
קאַטעגאָריע:בלעטערערס	Kategori:Nettlesere
מוסטער:אויסדערוויילטע ארטיקלען	Mal:Aktuelt
קאַטעגאָריע:פרייע ווייכווארג	Kategori:Fri programvare
קאַטעגאָריע:געזעץ	Kategori:Rettsvitenskap
קאַטעגאָריע:לענדער	Kategori:Land
קאַטעגאָריע:אדמיניסטראציע	Kategori:Administrasjon
קאַטעגאָריע:עקאנאמיע	Kategori:Nasjonaløkonomi
װיקיפּעדיע:אדמיניסטראטארן	Wikipedia:Administratorer
קאַטעגאָריע:קאזאכסטאן	Kategori:Kasakhstan
קאַטעגאָריע:פערזענלעכקייטן	Kategori:Personer
װיקיפּעדיע:צוריקדרייען	Hjelp:Hvordan sette en side tilbake til en tidligere versjon
קאַטעגאָריע:פאכן	Kategori:Beskjeftigelser
קאַטעגאָריע:מענטשן לויטן פאך	Kategori:Personer etter beskjeftigelse
װיקיפּעדיע:באט	Wikipedia:Roboter
קאַטעגאָריע:באהאלטענע קאטעגאריעס	Kategori:Skjulte kategorier
װיקיפּעדיע:טשעקיוזער	Wikipedia:CheckUser
קאַטעגאָריע:צייט	Kategori:Tid
קאַטעגאָריע:נאטור	Kategori:Natur
קאַטעגאָריע:אינטערנעט	Kategori:Internett
קאַטעגאָריע:באטאניק	Kategori:Botanikk
קאַטעגאָריע:אינזשעניריע	Kategori:Ingeniørvitenskap
קאַטעגאָריע:מאטעריאלן	Kategori:Materialer
װיקיפּעדיע:קאנטראלירן בלעטער	Wikipedia:WikiProject Check Wikipedia
קאַטעגאָריע:היסטארישע לענדער אין אייראפע	Kategori:Historiske stater og riker i Europa
קאַטעגאָריע:אנאטאמיע	Kategori:Anatomi
קאַטעגאָריע:מעדיצין	Kategori:Medisin
קאַטעגאָריע:פאליטיק	Kategori:Politikk
קאַטעגאָריע:חינוך	Kategori:Utdanning
קאַטעגאָריע:אפטיק	Kategori:Optikk
קאַטעגאָריע:קונסט	Kategori:Kunst
קאַטעגאָריע:ווייכווארג	Kategori:Programvare
קאוונע	Kaunas
בוך האלטעריי	Regnskap
עגיפטן	Egypt
װיקיפּעדיע:זאקן פאפעט	Wikipedia:Sokkedukker
װיקיפּעדיע:באדייטן	Wikipedia:Flertydige titler
װיקיפּעדיע:קאטעגאריזאציע	Wikipedia:Kategorier
הילף:מוסטער	Hjelp:Maler
ספר מלכים	Kongebøkene
קאַטעגאָריע:פילאסאפן	Kategori:Filosofer
קאַטעגאָריע:סטאטיסטיק	Kategori:Statistikk
קאַטעגאָריע:וואלן	Kategori:Valg
מוסטער:באט	Mal:Bot
פינאקיא (1940 פילם)	Pinocchio (1940)
װיקיפּעדיע:וואס וויקיפעדיע איז נישט	Wikipedia:Hva Wikipedia ikke er
קאנאדע	Canada
קאַטעגאָריע:אונגארן	Kategori:Ungarn
קאַטעגאָריע:בעלגיע	Kategori:Belgia
קאַטעגאָריע:טשעכיי	Kategori:Tsjekkia
קאַטעגאָריע:דענמארק	Kategori:Danmark
קאַטעגאָריע:פינלאנד	Kategori:Finland
קאַטעגאָריע:גריכנלאנד	Kategori:Hellas
קאַטעגאָריע:לעטלאנד	Kategori:Latvia
קאַטעגאָריע:איסלאנד	Kategori:Island
קאַטעגאָריע:לוקסעמבורג	Kategori:Luxembourg
קאַטעגאָריע:ליטע	Kategori:Litauen
קאַטעגאָריע:שוועדן	Kategori:Sverige
קאַטעגאָריע:סלאוואקיי	Kategori:Slovakia
קאַטעגאָריע:סלאוועניע	Kategori:Slovenia
קאַטעגאָריע:אירלאנד	Kategori:Republikken Irland
װיקיפּעדיע:קאפירעכטן	Wikipedia:Opphavsrett
קאַטעגאָריע:רעקאמענדירטע ארטיקלען	Kategori:Utmerkede artikler
װיקיפּעדיע:וועגן	Wikipedia:Om
פעלקעררעכט	Folkerett
קאר סיט	Barnesete
געפאנצערטער סאלדאטן טראנספארט	Pansret personellkjøretøy
קאַטעגאָריע:כעמיקער	Kategori:Kjemikere
דימענסיע	Dimensjon
קאַטעגאָריע:מלחמות	Kategori:Kriger
קאַטעגאָריע:ווידעא שפילעריי	Kategori:Videospill
קאַטעגאָריע:שפילעריי	Kategori:Spill
קאַטעגאָריע:מייקראסאפט	Kategori:Microsoft
הילף:קורץ ווארט	Hjelp:Redigeringsforklaring
פארטאל:וויסנשאפט	Portal:Vitenskap
װיקיפּעדיע:בקשות פון די סיסאפן	Wikipedia:Administratorenes oppslagstavle
קאַטעגאָריע:וויקיפעדיע פאליסיס און אנווייזונגן	Kategori:Regler og retningslinjer på Wikipedia
קאַטעגאָריע:לענדער אין אייראפע	Kategori:Land i Europa
קאַטעגאָריע:אייראפע	Kategori:Europa
קאַטעגאָריע:וויקיפעדיע הילף	Kategori:Hjelp
װיקיפּעדיע:שמועס	Hjelp:Diskusjonsside
װיקיפּעדיע:באניצער בלאט	Wikipedia:Brukersider
װיקיפּעדיע:פרעפערענצן	Hjelp:Brukerinnstillinger
קאַטעגאָריע:וויקיפעדיע אויסמעקן	Kategori:Sletting
װיקיפּעדיע:ארטיקל באשיצונג	Wikipedia:Denne siden er beskyttet
קאַטעגאָריע:וויקיפעדיע קאטעגאריע אריבערפירן	Kategori:Wikipedia omdirigertekategorier
קאַטעגאָריע:פֿאַרשלאָסענע אַרטיקלען	Kategori:Wikipedia semibeskyttede sider
דאקטאר	Doktor
װיקיפּעדיע:איי אר סי טשענעלס	Wikipedia:Chat
קאַטעגאָריע:באנוצער קאטעגאריעס	Kategori:Wikipedia-brukere
װיקיפּעדיע:קאנסענסוס	Wikipedia:Konsensus
װיקיפּעדיע:ציוויליטעט	Wikipedia:Høflighet
װיקיפּעדיע:קיין פערזענלעכע אטאקעס	Wikipedia:Ingen personangrep
װיקיפּעדיע:קאנטאקט אונדז	Wikipedia:Kontakt
װיקיפּעדיע:פארלאמענט	Wikipedia:Portal
קאַטעגאָריע:באַניצער	Kategori:Wikipedia-brukere etter språk
װיקיפּעדיע:פאליסיס און אנווייזונגען	Wikipedia:Regler og retningslinjer
װיקיפּעדיע:פינף זיילן	Wikipedia:Fem søyler
קאַטעגאָריע:וויקיפעדיע אפיציעלער פאליסי	Kategori:Wikipedia-politikk
קאַטעגאָריע:וויקיפעדיע אנווייזונגען	Kategori:Anbefalte regler og retningslinjer
װיקיפּעדיע:נייטראל	Wikipedia:Objektivitet
װיקיפּעדיע:קיין אריגינעלע פארשונג	Wikipedia:Original forskning
װיקיפּעדיע:אויטאביאגראפיע	Wikipedia:Selvbiografi
װיקיפּעדיע:מערקווערדיג	Wikipedia:Relevanskriterier
װיקיפּעדיע:דרויסענדיגע לינקען	Wikipedia:Retningslinjer for eksterne lenker
װיקיפּעדיע:באניצער קעסטלעך	Wikipedia:Brukerbokser
װיקיפּעדיע:אונטערשרייבן	Hjelp:Signatur
װיקיפּעדיע:שטומף	Wikipedia:Stubb
װיקיפּעדיע:דן זיין לכף זכות	Wikipedia:Ta ting i beste mening
װיקיפּעדיע:ביאגראפיעס פון לעבעדיגע פערזענליכקייטן	Wikipedia:Biografier om levende personer
װיקיפּעדיע:פארטאל	Wikipedia:Portaler
װיקיפּעדיע:וואנדאליזם	Wikipedia:Vandalisme
הילף:באהעפטן	Bruker:Iceblock/Fletting
װיקיפּעדיע:בעטן ארטיקלען	Wikipedia:Ønskelisten
סלעש	Skråstrek
אריה ווארשל	Arieh Warshel
ביזנעס	Næringsliv
מוסטער:Softredirect	Mal:Softredirect
װיקיפּעדיע:וויקידאטן	Wikipedia:Wikidata
מוסטער:שנעל אויסמעקן	Mal:Hurtigsletting
קאַטעגאָריע:טעכנאלאגיע	Kategori:Teknologi
ביל די בלאזיא	Bill de Blasio
ליגן	Løgn
קאַטעגאָריע:שפראכן	Kategori:Språk
קאַטעגאָריע:גראמאטיק	Kategori:Grammatikk
קאַטעגאָריע:גענעאלאגיע	Kategori:Slektsforskning
קאַטעגאָריע:קאלענדארן	Kategori:Kalendere
קאַטעגאָריע:ימים טובים	Kategori:Høytider og helligdager
הילף:אנהייבן א נייעם בלאט	Hjelp:Hvordan starte en side
קאַטעגאָריע:וויקיפעדיע	Kategori:Wikipedia
קאַטעגאָריע:וויקיפעדיעס אין אנדערע שפראכן	Kategori:Språk på Wikipedia
װיקיפּעדיע:קלארשטעלונג	Wikipedia:Generelle forbehold
קאַטעגאָריע:בלעטער מיט צעבראכענע טעקע לינקען	Kategori:Sider med brutte fillenker
מאנומענט	Monument
סאלדאט	Soldat
קאַטעגאָריע:אקטועלע ארטיקלן	Kategori:Pågående hendelser
קאַטעגאָריע:שטעט אין טשעכיי	Kategori:Byer i Tsjekkia
קאַטעגאָריע:שטעט אין אייראפע	Kategori:Byer i Europa
װיקיפּעדיע:סטאטיסטיק	Wikipedia:Statistikk
װיקיפּעדיע:נאמענטייל	Wikipedia:Navnerom
װיקיפּעדיע:שרייבן און סטיל אנווייזונגען	Wikipedia:Stilmanual
װיקיפּעדיע:טראל	Wikipedia:Hva er et troll?
מוסטער:נאוויגאציע גרופעס	Mal:Navboks
קענגורו	Kenguruer
נויטפאל	Nød
מוסטער:הערב	Mal:Våpenskjold
יוסטיץ	Rettferdighet
קאַטעגאָריע:געגנטן	Kategori:Bydeler
קאַטעגאָריע:שטעט אין איראן	Kategori:Byer i Iran
נייע צייט	Tidlig moderne tid
קאַטעגאָריע:לעבעדיגע מענטשן	Kategori:Biografier om levende personer
קאַטעגאָריע:ווייטערפירן	Kategori:Omdirigeringer
קאַטעגאָריע:וויקיפעדיע אויפהאלטונג	Kategori:Wikipedia-vedlikehold
פאראכטונג	Forakt
קאַטעגאָריע:כנסת דעפוטאטן	Kategori:Medlemmer av Knesset
מוסטער:!	Mal:!
קאַטעגאָריע:פאן מוסטערן	Kategori:Flaggmaler
מוסטער:=	Mal:=
מוסטער:טינעוובאר	Mal:Tnavbar
קאַטעגאָריע:פארמאט מוסטערן	Kategori:Formateringsmaler
מוסטער:קלאווישדרוק	Mal:Tastekombo
מוסטער:אויבערשטראך	Mal:Overlinje
מוסטער:קליין	Mal:Small
מוסטער:עמוד-שפאלט	Mal:Col-break
מוסטער:עמוד-אנהייב	Mal:Col-begin
מוסטער:עמוד-סוף	Mal:Col-end
מוסטער:נישט וויקלען	Mal:Nowrap
מוסטער:Bots	Mal:Bots
מוסטער:Anchor	Mal:Anchor
G-string	G-streng
װיקיפּעדיע:וויכטיגע ארטיקלען	Wikipedia:Liste over artikler vi bør ha
קאַטעגאָריע:אפריקע	Kategori:Afrika
קאַטעגאָריע:יולי	Kategori:Dager i juli
קאַטעגאָריע:נומערן	Kategori:Tall
קאַטעגאָריע:יוני	Kategori:Dager i juni
קאַטעגאָריע:עלעקטראניק	Kategori:Elektronikk
קאַטעגאָריע:דאקומענטן	Kategori:Dokumenter
קאַטעגאָריע:ביכער	Kategori:Bøker
קאַטעגאָריע:מאנאטן	Kategori:Måneder
מוסטער:Babel-3	Mal:Babel-3
מוסטער:באבעל	Mal:Babel
קאַטעגאָריע:שפיטעלער	Kategori:Sykehus
װיקיפּעדיע:מקורות	Wikipedia:Bruk av kilder
װיקיפּעדיע:זוכן	Hjelp:Søking
הילף:אפטיילונג	Hjelp:Avsnitt
מוסטער:User ar-1	Mal:Bruker ar-1
מוסטער:User eo-1	Mal:Bruker eo-1
מוסטער:User da-2	Mal:Bruker da-2
מוסטער:User eo-3	Mal:Bruker eo-3
מוסטער:User de	Mal:Bruker de
מוסטער:User de-1	Mal:Bruker de-1
מוסטער:User es	Mal:Bruker es
מוסטער:User de-3	Mal:Bruker de-3
מוסטער:User en-3	Mal:Bruker en-3
מוסטער:User en-1	Mal:Bruker en-1
מוסטער:User en-2	Mal:Bruker en-2
מוסטער:User en-4	Mal:Bruker en-4
מוסטער:User fi	Mal:Bruker fi
מוסטער:User en	Mal:Bruker en
מוסטער:User de-2	Mal:Bruker de-2
מוסטער:User es-1	Mal:Bruker es-1
מוסטער:User fr-1	Mal:Bruker fr-1
קאַטעגאָריע:לעבן	Kategori:Livet
מוסטער:User he-2	Mal:Bruker he-2
מוסטער:User he-1	Mal:Bruker he-1
האריזאנטאל	Horisontal
מוסטער:User fr-2	Mal:Bruker fr-2
מוסטער:User ja	Mal:Bruker ja
מוסטער:User it-1	Mal:Bruker it-1
מוסטער:User fr	Mal:Bruker fr
מוסטער:נישט געחתמעט	Mal:Usignert
מוסטער:User he	Mal:Bruker he
קאַטעגאָריע:טוריזם	Kategori:Turisme
קאַטעגאָריע:האר	Kategori:Hår
קאַטעגאָריע:פעברואר	Kategori:Dager i februar
קאַטעגאָריע:נאוויגאציע מוסטערן	Kategori:Navigasjonsmaler
קאַטעגאָריע:אינסעקטן	Kategori:Insekter
קאַטעגאָריע:מאלדאווע	Kategori:Moldova
קאַטעגאָריע:אזיע	Kategori:Asia
קאַטעגאָריע:טשילע	Kategori:Chile
קאַטעגאָריע:21סטער י"ה	Kategori:2000-tallet
קאַטעגאָריע:אויפהאלטונג מוסטערן	Kategori:Artikkelmerker
קאַטעגאָריע:באַניצער uk	Kategori:Bruker uk
קאַטעגאָריע:דרום אמעריקע	Kategori:Sør-Amerika
קאַטעגאָריע:באַניצער uk-N	Kategori:Bruker uk-N
קאַטעגאָריע:עסנווארג	Kategori:Mat
קאַטעגאָריע:פוסבאל	Kategori:Fotball
מוסטער:Mod	Mal:Mod
מוסטער:User sv	Mal:Bruker sv
מוסטער:User it	Mal:Bruker it
מוסטער:User uk	Mal:Bruker uk
מוסטער:User es-2	Mal:Bruker es-2
קאַטעגאָריע:ענציקלאפעדיעס	Kategori:Oppslagsverk
מוסטער:שלום עליכם	Mal:Reg-velkommen
קאַטעגאָריע:וועבלינק מוסטערן	Kategori:Maler for eksterne lenker
קאַטעגאָריע:טעג	Kategori:Dager i uken
קאַטעגאָריע:לבנה	Kategori:Månen
קאַטעגאָריע:שטעט אין בעלארוס	Kategori:Byer i Hviterussland
קאַטעגאָריע:ארגאניזאציעס	Kategori:Organisasjoner
קאַטעגאָריע:באַניצער ms	Kategori:Bruker ms
קאַטעגאָריע:לינגוויסטיק	Kategori:Lingvistikk
מוסטער:Edit this page	Mal:Rediger
קאַטעגאָריע:מאטראסן	Kategori:Sjøfolk
קאַטעגאָריע:פארבינדונג מוסטערן	Kategori:Lenkemaler
מוסטער:Wikivar	Mal:Wikivar
קאַטעגאָריע:באַניצער fr-1	Kategori:Bruker fr-1
מוסטער:בילד קלעבל	Mal:Image label
קאַטעגאָריע:רעגירונג זינגלידער	Kategori:Nasjonalsanger
מוסטער:אפריקע	Mal:Afrikaland
קאַטעגאָריע:מענטשן פון ניו יארק	Kategori:Personer fra New York
מוסטער:קיין בילד	Mal:Trenger bilde
קאַטעגאָריע:פראווינצן	Kategori:Provinser
מוסטער:מדינה	Mal:Infoboks land2
קאַטעגאָריע:פילם פראדוצירער	Kategori:Filmprodusenter
מוסטער:וויסנשאפטלער	Mal:Infoboks vitenskapsmann
מוסטער:אוניווערסיטעט	Mal:Infoboks universitet
קאַטעגאָריע:אזארטשפילן	Kategori:Hasard
מוסטער:שפראך-ar	Mal:Ar
מוסטער:רעקאמענדירטער ארטיקל	Mal:Utmerket
קאַטעגאָריע:פאריז	Kategori:Paris
קאַטעגאָריע:באַניצער en-4	Kategori:Bruker en-4
קאַטעגאָריע:באַניצער en	Kategori:Bruker en
קאַטעגאָריע:באַניצער zh	Kategori:Bruker zh
קאַטעגאָריע:קראאטיע	Kategori:Kroatia
קאַטעגאָריע:באַניצער en-2	Kategori:Bruker en-2
קאַטעגאָריע:פרעמיער מיניסטארן פון ישראל	Kategori:Israelske statsministre
מוסטער:לעגענדע	Mal:Legend
קאַטעגאָריע:פרעמיער מיניסטארן פון טערקיי	Kategori:Tyrkiske statsministre
קאַטעגאָריע:ביורא געצייג	Kategori:Kontorrekvisita
מוסטער:אקטועל	Mal:Pågående
קאַטעגאָריע:ביאגראפיע	Kategori:Biografier
קאַטעגאָריע:אוויאציע	Kategori:Luftfart
קאַטעגאָריע:קאטעגאריעס לויט לענדער	Kategori:Kategorier etter land
קאַטעגאָריע:נעמען	Kategori:Navn
קאַטעגאָריע:שטעט אין טערקיי	Kategori:Byer i Tyrkia
מוסטער:GeoTemplate	Mal:GeoTemplate
קאַטעגאָריע:עסנווארג און געטראנקען	Kategori:Mat og drikke
קאַטעגאָריע:מאגאזינען	Kategori:Tidsskrifter
מוסטער:Coor URL	Mal:Koor URL
קאַטעגאָריע:איבערזעצונג	Kategori:Oversettelse
קאַטעגאָריע:קאנסטרוקציע	Kategori:Bygg og anlegg
מוסטער:User nl-1	Mal:Bruker nl-1
מוסטער:באן ליניע אפטיילונג	Mal:JBS
מוסטער:User nl-2	Mal:Bruker nl-2
מוסטער:באן ליניע אפט3	Mal:JBS3
קאַטעגאָריע:רוימער	Kategori:Romere
קאַטעגאָריע:ספרים זאמלער	Kategori:Boksamlere
קאַטעגאָריע:לאנדווירטשאפט	Kategori:Landbruk
מוסטער:Babel-4	Mal:Babel-4
מוסטער:Babel-5	Mal:Babel-5
קאַטעגאָריע:חורבן אייראפע	Kategori:Holocaust
קאַטעגאָריע:שטעט אין קאזאכסטאן	Kategori:Byer i Kasakhstan
מוסטער:Babel-2	Mal:Babel-2
מוסטער:Babel-9	Mal:Babel-9
מוסטער:Babel-6	Mal:Babel-6
קאַטעגאָריע:וואסער טראנספארט	Kategori:Sjøfart
קאַטעגאָריע:באַניצער hi	Kategori:Bruker hi
קאַטעגאָריע:מיקראביאלאגיע	Kategori:Mikrobiologi
קאַטעגאָריע:פרעזידענטן	Kategori:Presidenter
קאַטעגאָריע:בערג	Kategori:Fjell
מוסטער:User ru	Mal:Bruker ru
מוסטער:Babel-8	Mal:Babel-8
קאַטעגאָריע:20סטער י"ה	Kategori:1900-tallet
מוסטער:IPA	Mal:IPA
מוסטער:באן ליניע אפט2	Mal:JBS2
קאַטעגאָריע:פאליטיקער	Kategori:Politikere
מוסטער:יתום	Mal:Foreldreløs
קאַטעגאָריע:אמעריקע	Kategori:Amerika
מוסטער:אנדערע באדייטן	Mal:Andrebetydninger
מוסטער:Babel-1	Mal:Babel-1
קאַטעגאָריע:געווירצן	Kategori:Krydder
מלאכי	Malaki
קאַטעגאָריע:זיכערהייט	Kategori:Sikkerhet
קאַטעגאָריע:פעלקער	Kategori:Personer etter nasjonalitet
קאַטעגאָריע:פאלעסטינע	Kategori:Palestina
קאַטעגאָריע:איבערזעצער	Kategori:Oversettere
מוסטער:פרעזידענטן פון די פאראייניגטע שטאטן	Mal:USAs presidenter
קאַטעגאָריע:באנוצער שפראך מוסטערן	Kategori:Babel-maler
קאַטעגאָריע:וואשינגטאן	Kategori:Washington
מוסטער:הויפטשטעט אין אפריקע	Mal:Hovedsteder i Afrika
קאַטעגאָריע:מאס	Kategori:Måleenheter
מוסטער:MONTHNAME	Mal:MONTHNAME
מוסטער:קאטעגאריע אריבערפירן	Mal:Kategoriomdirigering
מוסטער:מאטעמאטיק-שטומף	Mal:Matematikkstubb
קאַטעגאָריע:ביאגראפיע שטומף	Kategori:Biografistubber
מוסטער:איקאן	Mal:Ikon
קאַטעגאָריע:תנ"ך	Kategori:Tanákh
קאַטעגאָריע:יידן	Kategori:Jøder
קאַטעגאָריע:19טער י"ה	Kategori:1800-tallet
קאַטעגאָריע:שרייבער	Kategori:Forfattere
קאַטעגאָריע:מיליטער	Kategori:Militærvesen
קאַטעגאָריע:פילאנטראפן	Kategori:Filantroper
קאַטעגאָריע:אוניווערסיטעטן	Kategori:Universiteter
מוסטער:שפראך-he	Mal:Lang-he
טעאריע פון משמעותדיקייט	Sannsynlighetsteori
קאַטעגאָריע:יאנואר	Kategori:Dager i januar
מוסטער:שפראך-fa	Mal:Lang-fa
קאַטעגאָריע:רעזשיסארן	Kategori:Regissører
מוסטער:User nl	Mal:Bruker nl
קאַטעגאָריע:שפיאנאזש אגענטורן	Kategori:Etterretningsorganisasjoner
מוסטער:Babel-7	Mal:Babel-7
מוסטער:גאנצע צאל	Mal:Infoboks tall
װיקיפּעדיע:אריינפיר 2	Wikipedia:Introduksjon 2
מוסטער:ביאלאגיע פיסל	Mal:Biologi
מוסטער:אינפאקעסטל באן סטאנציע	Mal:Infoboks jernbanestasjon
קאַטעגאָריע:מאלעריי	Kategori:Malerkunst
קאַטעגאָריע:פארטן	Kategori:Havner
קאַטעגאָריע:געפילן	Kategori:Følelser
קאַטעגאָריע:קאסמאלאגיע	Kategori:Kosmologi
קאַטעגאָריע:קערפער פון וואסער	Kategori:Vannmasser
טורקיז (קאליר)	Turkis (farge)
אינדעך	Indigo
קאַטעגאָריע:פירמעס	Kategori:Selskaper
קאַטעגאָריע:מידות	Kategori:Etikk
מוסטער:User pl-1	Mal:Bruker pl-1
מוסטער:בילד קלעבל קליין	Mal:Image label small
קאַטעגאָריע:צלם-בלומיקע	Kategori:Korsblomstfamilien
מוסטער:User fr-3	Mal:Bruker fr-3
מוסטער:הילפקעסטל	Mal:Helpbox
קאַטעגאָריע:שטעט אין יאפאן	Kategori:Byer i Japan
קאַטעגאָריע:געצייג	Kategori:Verktøy
מוסטער:User ar-2	Mal:Bruker ar-2
מוסטער:User SUL Box	Mal:SUL-boks
מוסטער:טעג פון דער וואך	Mal:Ukedager
קאַטעגאָריע:בלאגס	Kategori:Blogger
מוסטער:לענדער ארום דעם מיטלענדישן ים	Mal:Land og territorier som grenser til Middelhavet
קאַטעגאָריע:פילמען לויט שפראך	Kategori:Filmer etter språk
מוסטער:מידות	Mal:Følelser
קאַטעגאָריע:שטעט אין די פאראייניגטע שטאטן פון אמעריקע	Kategori:Byer i USA
מוסטער:PDF	Mal:PDFlink
מוסטער:שפראך-ru	Mal:Lang-ru
קאַטעגאָריע:מוזיק זשאנערס	Kategori:Musikksjangre
מוסטער:רוימישע נומערן	Mal:Romertall
קאַטעגאָריע:שטעט אין שװעדן	Kategori:Byer i Sverige
מוסטער:באדייטן	Mal:Peker
קאַטעגאָריע:פלעצער פון תנ"ך	Kategori:Bibelske steder
קאַטעגאָריע:געזונט וויסנשאפטן	Kategori:Helsevitenskap
קאַטעגאָריע:אינפאבאקס מוסטערן	Kategori:Infobokser
קאַטעגאָריע:מעדיצינישע באהאנדלונגען	Kategori:Medisinske behandlinger
קאַטעגאָריע:ישובים אין ישראל	Kategori:Byer og landsbyer i Israel
קאַטעגאָריע:מיטל מזרח	Kategori:Midtøsten
מוסטער:ווארענונג	Mal:Uw-vandalism1
קאַטעגאָריע:צייטונגען	Kategori:Aviser
קאַטעגאָריע:פאליציי	Kategori:Politi
קאַטעגאָריע:נאציזם	Kategori:Nasjonalsosialisme
קאַטעגאָריע:לאנדאנער באראס	Kategori:Londons bydeler
קאַטעגאָריע:קעז	Kategori:Ost
קאַטעגאָריע:זיסווארג	Kategori:Søtsaker
קאַטעגאָריע:מאלצייטן	Kategori:Måltider
קאַטעגאָריע:שטעט אין לבנון	Kategori:Byer og landsbyer i Libanon
מוסטער:שפראך-uk	Mal:Lang-uk
קאַטעגאָריע:טעאלאגיע	Kategori:Teologi
קאַטעגאָריע:קאמפיוטער נעצווערקן	Kategori:Datanett
קאַטעגאָריע:ארכיטעקטור	Kategori:Arkitektur
מוסטער:סלאווישע שפראכן	Mal:Slaviske språk
מוסטער:הויפטשטעט אין דרום אמעריקע	Mal:Hovedsteder i Sør-Amerika
מוסטער:Harvnb	Mal:Harvnb
קאַטעגאָריע:מאנגאליי	Kategori:Mongolia
קאַטעגאָריע:באן טראנספארט	Kategori:Jernbane
קאַטעגאָריע:פארדייאונג סיסטעם	Kategori:Fordøyelsessystemet
מוסטער:וויקיפעדיע	Mal:InterWiki
קאַטעגאָריע:שטעט אין האלאנד	Kategori:Byer i Nederland
קאַטעגאָריע:וויין	Kategori:Vin
מוסטער:Coord	Mal:Koord
מוסטער:לענדער פון אייראפע	Mal:Europa
מוסטער:ביאלאגיע-שטומף	Mal:Biologistubb
קאַטעגאָריע:מוסטער דאקומענטאציע	Kategori:Maldokumentasjonssider
קאַטעגאָריע:באַניצער eo	Kategori:Bruker eo
קאַטעגאָריע:באַניצער fr	Kategori:Bruker fr
קאַטעגאָריע:באַניצער ja	Kategori:Bruker ja
קאַטעגאָריע:באַניצער la	Kategori:Bruker la
קאַטעגאָריע:באַניצער nn	Kategori:Bruker nn
קאַטעגאָריע:באַניצער pt	Kategori:Bruker pt
קאַטעגאָריע:באַניצער ro	Kategori:Bruker ro
קאַטעגאָריע:באַניצער sv	Kategori:Bruker sv
קאַטעגאָריע:באַניצער cs-3	Kategori:Bruker cs-3
קאַטעגאָריע:באַניצער fr-3	Kategori:Bruker fr-3
קאַטעגאָריע:באַניצער nl-3	Kategori:Bruker nl-3
קאַטעגאָריע:באַניצער nl-1	Kategori:Bruker nl-1
קאַטעגאָריע:באַניצער pl-1	Kategori:Bruker pl-1
קאַטעגאָריע:באַניצער ro-1	Kategori:Bruker ro-1
קאַטעגאָריע:באַניצער ar-1	Kategori:Bruker ar-1
קאַטעגאָריע:באַניצער da-2	Kategori:Bruker da-2
קאַטעגאָריע:באַניצער fr-2	Kategori:Bruker fr-2
קאַטעגאָריע:באַניצער hi-2	Kategori:Bruker hi-2
קאַטעגאָריע:באַניצער nl-2	Kategori:Bruker nl-2
קאַטעגאָריע:באַניצער ar-2	Kategori:Bruker ar-2
קאַטעגאָריע:באַניצער cs-N	Kategori:Bruker cs-N
קאַטעגאָריע:באַניצער fr-M	Kategori:Bruker fr-N
קאַטעגאָריע:באַניצער is-N	Kategori:Bruker is-N
קאַטעגאָריע:באַניצער it-N	Kategori:Bruker it-N
קאַטעגאָריע:באַניצער nl-N	Kategori:Bruker nl-N
קאַטעגאָריע:באַניצער ru-N	Kategori:Bruker ru-N
קאַטעגאָריע:פארוויילונג	Kategori:Underholdning
קאַטעגאָריע:ביזנעס	Kategori:Næringsliv
קאַטעגאָריע:שריפט	Kategori:Skriftsystem
מוסטער:וועב פראגראמען	Mal:Nettlesere
קאַטעגאָריע:וויקיפעדיע אויסרייניגונג	Kategori:Opprydning
קאַטעגאָריע:באַניצער ar	Kategori:Bruker ar
קאַטעגאָריע:יידיש-שפראך פילמען	Kategori:Jiddiskspråklige filmer
קאַטעגאָריע:ביאלאגיע אינפאבאקס מוסטערן	Kategori:Infobokser biologi
קאַטעגאָריע:יידיש	Kategori:Jiddisch
קאַטעגאָריע:באַניצער cs	Kategori:Bruker cs
קאַטעגאָריע:אינדזלען	Kategori:Øyer
קאַטעגאָריע:היסטאריקער	Kategori:Historikere
קאַטעגאָריע:באַניצער da	Kategori:Bruker da
קאַטעגאָריע:פאציפישער אקעאן	Kategori:Stillehavet
קאַטעגאָריע:באַניצער de	Kategori:Bruker de
קאַטעגאָריע:באַניצער de-2	Kategori:Bruker de-2
קאַטעגאָריע:באַניצער de-3	Kategori:Bruker de-3
קאַטעגאָריע:באַניצער de-N	Kategori:Bruker de-N
קאַטעגאָריע:באַניצער en-3	Kategori:Bruker en-3
קאַטעגאָריע:באַניצער en-N	Kategori:Bruker en-N
קאַטעגאָריע:באַניצער eo-1	Kategori:Bruker eo-1
קאַטעגאָריע:באַניצער eo-2	Kategori:Bruker eo-2
קאַטעגאָריע:באַניצער eo-3	Kategori:Bruker eo-3
קאַטעגאָריע:באַניצער eo-N	Kategori:Bruker eo-N
קאַטעגאָריע:באַניצער es	Kategori:Bruker es
קאַטעגאָריע:באַניצער es-1	Kategori:Bruker es-1
מוסטער:EU מיטגלידער	Mal:EU-bunn
קאַטעגאָריע:רבנים	Kategori:Rabbinere
קאַטעגאָריע:באַניצער es-2	Kategori:Bruker es-2
קאַטעגאָריע:באַניצער es-3	Kategori:Bruker es-3
קאַטעגאָריע:באַניצער es-N	Kategori:Bruker es-N
קאַטעגאָריע:באַניצער fi	Kategori:Bruker fi
קאַטעגאָריע:באַניצער fi-N	Kategori:Bruker fi-N
קאַטעגאָריע:1680ער	Kategori:Hendelser i 1680-årene
קאַטעגאָריע:באַניצער he	Kategori:Bruker he
קאַטעגאָריע:באַניצער he-1	Kategori:Bruker he-1
קאַטעגאָריע:באַניצער he-2	Kategori:Bruker he-2
קאַטעגאָריע:באַניצער he-3	Kategori:Bruker he-3
קאַטעגאָריע:באַניצער he-N	Kategori:Bruker he-N
קאַטעגאָריע:באַניצער hu	Kategori:Bruker hu
קאַטעגאָריע:באַניצער is	Kategori:Bruker is
קאַטעגאָריע:באַניצער is-1	Kategori:Bruker is-1
קאַטעגאָריע:באַניצער is-2	Kategori:Bruker is-2
קאַטעגאָריע:באַניצער is-3	Kategori:Bruker is-3
קאַטעגאָריע:טיטלען	Kategori:Titler
אייגנטום	Eiendomsrett
קאַטעגאָריע:אלף בית	Kategori:Hebraisk alfabet
קאַטעגאָריע:העברעיש	Kategori:Hebraisk
קאַטעגאָריע:מלכי ישראל	Kategori:Konger av det gamle Israel
קאַטעגאָריע:פרעזידענטן פון ווענעזועלע	Kategori:Venezuelanske presidenter
קאַטעגאָריע:באַניצער pl-N	Kategori:Bruker pl-N
קאַטעגאָריע:געאמעטריע	Kategori:Geometri
קאַטעגאָריע:גארטן	Kategori:Hagebruk
קאַטעגאָריע:שטעט אין ישראל	Kategori:Byer i Israel
קאַטעגאָריע:קינסטלערס	Kategori:Kunstnere
מוסטער:נומערן	Mal:Tallmengder
קאַטעגאָריע:באַניצער it	Kategori:Bruker it
קאַטעגאָריע:באַניצער it-1	Kategori:Bruker it-1
קאַטעגאָריע:פראנצויזישע יידן	Kategori:Franske jøder
קאַטעגאָריע:וועבזייטלעך	Kategori:Nettsteder
קאַטעגאָריע:באַניצער ko	Kategori:Bruker ko
קאַטעגאָריע:שטאטן אין די פאראייניגטע שטאטן	Kategori:USAs delstater
קאַטעגאָריע:באַניצער la-1	Kategori:Bruker la-1
יא	Ja
קאַטעגאָריע:וואולקאנען	Kategori:Vulkaner
קאַטעגאָריע:שפיאנאזש	Kategori:Etterretning
קאַטעגאָריע:שטעט אין טשילע	Kategori:Kommuner i Chile
מוסטער:גראפנשאפטן אין ענגלאנד	Mal:Engelske counties
מאלצייט	Måltid
קאַטעגאָריע:באן טראנספארט מוסטערן	Kategori:Tyske jernbanemaler
קאַטעגאָריע:וועטער	Kategori:Vær
קאַטעגאָריע:שטעט אין פראנקרייך	Kategori:Byer i Frankrike
קאַטעגאָריע:נאוועמבער	Kategori:Dager i november
קאַטעגאָריע:אפמאכן	Kategori:Internasjonale avtaler
קאַטעגאָריע:באַניצער ru-1	Kategori:Bruker ru-1
װיקיפּעדיע:באבעל	Wikipedia:Babel
מוסטער:הילף אינהאלט צוריק	Mal:Hjelp-portal-tilbake
קאַטעגאָריע:פארברעכן	Kategori:Kriminalitet
קאַטעגאָריע:לאקאלע רעגירונג	Kategori:Lokale myndigheter
מוסטער:וו"פ הילף קעפל	Mal:Hjelpesider
מוסטער:·וויקל	Mal:·wrap
מוסטער:User sv-1	Mal:Bruker sv-1
קאַטעגאָריע:כעמישע פארבינדונגען	Kategori:Kjemiske forbindelser
קאַטעגאָריע:פארשטעלונגען	Kategori:Skuespill
קאַטעגאָריע:1970ער	Kategori:Hendelser i 1970-årene
קאַטעגאָריע:1890ער	Kategori:Hendelser i 1890-årene
קאַטעגאָריע:דיכטער	Kategori:Lyrikere
קאַטעגאָריע:אידישע משפחות	Kategori:Jødiske slekter
קאַטעגאָריע:מערץ	Kategori:Dager i mars
קאַטעגאָריע:פוילישע	Kategori:Polakker
קאַטעגאָריע:ענגלענדער	Kategori:Engelskmenn
קאַטעגאָריע:סעפטעמבער	Kategori:Dager i september
קאַטעגאָריע:איטאליענישע היסטאריע	Kategori:Italias historie
קאַטעגאָריע:דיפלאמאטן	Kategori:Diplomater
קאַטעגאָריע:השכלה	Kategori:Opplysningstiden
קאַטעגאָריע:אקטאבער	Kategori:Dager i oktober
קאַטעגאָריע:באַניצער ms-2	Kategori:Bruker ms-2
קאַטעגאָריע:שטעט און שטעטלעך אין סלאוואקיי	Kategori:Byer i Slovakia
קאַטעגאָריע:ימען	Kategori:Hav
קאַטעגאָריע:שטעט און שטעטלעך אין פוילן	Kategori:Byer i Polen
קאַטעגאָריע:דעצעמבער	Kategori:Dager i desember
קאַטעגאָריע:אויגוסט	Kategori:Dager i august
קאַטעגאָריע:מיי	Kategori:Dager i mai
קאַטעגאָריע:אויטאמאביל פירמעס	Kategori:Bilprodusenter
גלוסט	Lyst
וואקאבולאר	Ordforråd
קאַטעגאָריע:ענגלאנד	Kategori:England
קאַטעגאָריע:מעטאלורגיע	Kategori:Metallurgi
קאַטעגאָריע:קאנגרעסלייט	Kategori:Kongressrepresentanter i USA
עקספלאראציע	Oppdagelsesreise
קאַטעגאָריע:ספרי קודש	Kategori:Jødiske tekster
קאַטעגאָריע:מאדעלן	Kategori:Modeller
קאַטעגאָריע:אפריל	Kategori:Dager i april
קאַטעגאָריע:פרייצייט	Kategori:Fritid
קאַטעגאָריע:יידן לויט וואוינארט	Kategori:Jøder etter nasjonalitet
קאַטעגאָריע:קאנפערענצן	Kategori:Konferanser
קאַטעגאָריע:מיטל מזרח קאנפליקט	Kategori:Midtøsten-konflikten
קאַטעגאָריע:קאמפיוטער וויסנשאפט	Kategori:Informatikk
מוסטער:באן ליניע איבערדעק	Mal:JBS-overlapp
קאַטעגאָריע:זשאנערס	Kategori:Litterære sjangre
קאַטעגאָריע:זון סיסטעם	Kategori:Solsystemet
קאַטעגאָריע:אינטערנאציאנאלע ארגאניזאציעס	Kategori:Internasjonale organisasjoner
קאַטעגאָריע:ענטאמאלאגיע	Kategori:Entomologi
קאַטעגאָריע:אינדוסטריע	Kategori:Industri
קאַטעגאָריע:ערפינדערס	Kategori:Oppfinnere
קאַטעגאָריע:וואסער	Kategori:Vann
מוסטער:Sfn	Mal:Sfn
קאַטעגאָריע:געטראנקען	Kategori:Drikke
קאַטעגאָריע:זאאלאגיע	Kategori:Zoologi
קאַטעגאָריע:קאגניציע	Kategori:Kognisjon
קאַטעגאָריע:ישראל'דיגע מוסטערן	Kategori:Israelske maler
קאַטעגאָריע:פרעמיעס	Kategori:Utmerkelser
קאַטעגאָריע:סימבאלן	Kategori:Symboler
קאַטעגאָריע:טעאטערס	Kategori:Teatre
קאַטעגאָריע:סאציאל וויסנשאפט	Kategori:Samfunnsvitenskap
קאַטעגאָריע:בעלארוס	Kategori:Hviterussland
קאַטעגאָריע:מאסאטשוסעטס	Kategori:Massachusetts
װיקיפּעדיע:אינטערוויקי לינקען	Wikipedia:Interwiki
קאַטעגאָריע:ראיאנען	Kategori:Regioner
קאַטעגאָריע:לענדער אין אפריקע	Kategori:Land i Afrika
מוסטער:קאנאדישע פראווינצן	Mal:Canadas provinser og territorier
קאַטעגאָריע:1940ער	Kategori:Hendelser i 1940-årene
קאַטעגאָריע:1900ער	Kategori:Hendelser i 1900-årene
קאַטעגאָריע:1910ער	Kategori:Hendelser i 1910-årene
קאַטעגאָריע:1920ער	Kategori:Hendelser i 1920-årene
קאַטעגאָריע:1930ער	Kategori:Hendelser i 1930-årene
קאַטעגאָריע:1950ער	Kategori:Hendelser i 1950-årene
קאַטעגאָריע:1960ער	Kategori:Hendelser i 1960-årene
קאַטעגאָריע:1980ער	Kategori:Hendelser i 1980-årene
קאַטעגאָריע:1990ער	Kategori:Hendelser i 1990-årene
קאַטעגאָריע:2000ער	Kategori:Hendelser i 2000-årene
קאַטעגאָריע:2010ער	Kategori:Hendelser i 2010-årene
מוסטער:באן ליניע אנווייזונגען	Wikipedia:Linjekart/tegnforklaring
מוסטער:ארגאניזאציע פאר עקאנאמישע קאאפעראציע און אנטוויקלונג	Mal:OECD
מוסטער:User cs	Mal:User cs
מוסטער:User es-3	Mal:Bruker es-3
קאַטעגאָריע:באַניצער ro-2	Kategori:Bruker ro-2
קאַטעגאָריע:באַניצער ro-3	Kategori:Bruker ro-3
קאַטעגאָריע:באַניצער ro-N	Kategori:Bruker ro-N
קאַטעגאָריע:באַניצער ru	Kategori:Bruker ru
קאַטעגאָריע:באַניצער ru-2	Kategori:Bruker ru-2
קאַטעגאָריע:באַניצער ru-3	Kategori:Bruker ru-3
קאַטעגאָריע:באַניצער sv-1	Kategori:Bruker sv-1
קאַטעגאָריע:באַניצער sv-N	Kategori:Bruker sv-N
קאַטעגאָריע:באַניצער uk-4	Kategori:Bruker uk-4
קאַטעגאָריע:באַניצער yi	Kategori:Bruker yi
קאַטעגאָריע:באַניצער yi-1	Kategori:Bruker yi-1
קאַטעגאָריע:באַניצער yi-2	Kategori:Bruker yi-2
מוסטער:שפייצן	Mal:Mellomrom
קאַטעגאָריע:מוזיקער	Kategori:Musikere
קאַטעגאָריע:מאלערס	Kategori:Malere
װיקיפּעדיע:בילדער	Wikipedia:Retningslinjer for billedbruk
קאַטעגאָריע:צווייטע וועלט מלחמה רעגירער	Kategori:Personer fra andre verdenskrig
קאַטעגאָריע:לאגערן	Kategori:Konsentrasjonsleirer fra andre verdenskrig
קאַטעגאָריע:טערמינאלאגיע	Kategori:Terminologi
קאַטעגאָריע:ביימער	Kategori:Tresorter
קאַטעגאָריע:סאציאלאגיע	Kategori:Sosiologi
אנטראפאמעטריע	Antropometri
קאַטעגאָריע:1560ער	Kategori:Hendelser i 1560-årene
קאַטעגאָריע:1820ער	Kategori:Hendelser i 1820-årene
קאַטעגאָריע:1670ער	Kategori:Hendelser i 1670-årene
קאַטעגאָריע:1770ער	Kategori:Hendelser i 1770-årene
קאַטעגאָריע:1760ער	Kategori:Hendelser i 1760-årene
קאַטעגאָריע:1710ער	Kategori:Hendelser i 1710-årene
קאַטעגאָריע:1650ער	Kategori:Hendelser i 1650-årene
קאַטעגאָריע:1610ער	Kategori:Hendelser i 1610-årene
קאַטעגאָריע:1810ער	Kategori:Hendelser i 1810-årene
קאַטעגאָריע:1640ער	Kategori:Hendelser i 1640-årene
סטרוקטור	Struktur
קאַטעגאָריע:1850ער	Kategori:Hendelser i 1850-årene
קאַטעגאָריע:17טער י"ה	Kategori:1600-tallet
קאַטעגאָריע:1880ער	Kategori:Hendelser i 1880-årene
קאַטעגאָריע:1720ער	Kategori:Hendelser i 1720-årene
קאַטעגאָריע:1750ער	Kategori:Hendelser i 1750-årene
קאַטעגאָריע:1870ער	Kategori:Hendelser i 1870-årene
קאַטעגאָריע:1780ער	Kategori:Hendelser i 1780-årene
קאַטעגאָריע:1860ער	Kategori:Hendelser i 1860-årene
קאַטעגאָריע:1790ער	Kategori:Hendelser i 1790-årene
קאַטעגאָריע:1730ער	Kategori:Hendelser i 1730-årene
קאַטעגאָריע:1800ער	Kategori:Hendelser i 1800-årene
קאַטעגאָריע:1700ער	Kategori:Hendelser i 1700-årene
קאַטעגאָריע:פאבריקאציע	Kategori:Produksjon
קאַטעגאָריע:מענטשליכע אויפפירונג	Kategori:Menneskelig atferd
קאַטעגאָריע:מענטשן	Kategori:Mennesker
קאַטעגאָריע:קאטעגאריע קעפל מוסטערן	Kategori:Kategorimaler
קאַטעגאָריע:וויקימעדיע פראיעקטן	Kategori:Wikimedia-prosjekter
קאַטעגאָריע:Windows	Kategori:Microsoft Windows
קאַטעגאָריע:2014	Kategori:2014
מוסטער:בריטישע מאנארכן	Mal:Britiske monarker
קרנית פלוג	Karnit Flug
מוסטער:User sv-3	Mal:Bruker sv-3
קאַטעגאָריע:פארטאל	Kategori:Portaler
קאַטעגאָריע:ביאכעמיע	Kategori:Biokjemi
קאַטעגאָריע:באן טראנספארט אין פראנקרייך	Kategori:Jernbane i Frankrike
קאַטעגאָריע:קאמפיוטער פראגראמירן	Kategori:Programmering
קאַטעגאָריע:וויטאמינען	Kategori:Vitaminer
קאַטעגאָריע:צירונגען	Kategori:Smykker
קאַטעגאָריע:ריעל עסטעיט	Kategori:Grunneiendom
מוסטער:אנווייז צום הויפט ארטיקל	Mal:Utdypende artikkel
מוסטער:Coord/dec2dms/dm	Mal:Koord/dec2dms/dm
קאַטעגאָריע:איידעלע גאזן	Kategori:Edelgasser
קאַטעגאָריע:ניו יארק	Kategori:New York State
קאַטעגאָריע:ניו זשערסי	Kategori:New Jersey
קאַטעגאָריע:אהאיא	Kategori:Ohio
קאַטעגאָריע:קאליפארניע	Kategori:California
קאַטעגאָריע:קאנעטיקעט	Kategori:Connecticut
קאַטעגאָריע:מאדע	Kategori:Mote
קאַטעגאָריע:צווייטע וועלט מלחמה	Kategori:Andre verdenskrig
קאַטעגאָריע:ערשטע וועלט מלחמה	Kategori:Første verdenskrig
קאַטעגאָריע:ציטירן מוסטערן	Kategori:Referansemaler
קאַטעגאָריע:ישראל פילמען	Kategori:Israelske filmer
קאַטעגאָריע:טעקסטיל	Kategori:Tekstiler
קאַטעגאָריע:שטעט אין ענגלאנד	Kategori:Byer i England
קאַטעגאָריע:אמעריקאנער שרייבער	Kategori:Forfattere fra USA
קאַטעגאָריע:דראמאטורגן	Kategori:Dramatikere
מוסטער:ישראל פרעזידענטן	Mal:Israels president
קאַטעגאָריע:ארכיטעקטן	Kategori:Arkitekter
קאַטעגאָריע:גאבאן	Kategori:Gabon
קאַטעגאָריע:קאמערון	Kategori:Kamerun
קאַטעגאָריע:ליביע	Kategori:Libya
קאַטעגאָריע:מאראקא	Kategori:Marokko
קאַטעגאָריע:היסטאריע פון פוילן	Kategori:Polens historie
קאַטעגאָריע:בריטישע אינזלען	Kategori:De britiske øyer
מוסטער:Citation/core	Mal:Citation/core
קאַטעגאָריע:2006	Kategori:2006
קאַטעגאָריע:2007	Kategori:2007
קאַטעגאָריע:2008	Kategori:2008
קאַטעגאָריע:2009	Kategori:2009
קאַטעגאָריע:2010	Kategori:2010
קאַטעגאָריע:2011	Kategori:2011
מוסטער:באן ליניע אפט4	Mal:JBS4
קאַטעגאָריע:געלט	Kategori:Valuta
קאַטעגאָריע:טייכן	Kategori:Elver
קאַטעגאָריע:ארץ ישראל	Kategori:Israels geografi
מוסטער:User he-3	Mal:Bruker he-3
מוסטער:User ru-1	Mal:Bruker ru-1
מוסטער:User uk-4	Mal:Bruker uk-4
מוסטער:User zh-1	Mal:Bruker zh-1
קאַטעגאָריע:היסטאריע פון רוסלאנד	Kategori:Russlands historie
קאַטעגאָריע:ספארט אין ישראל	Kategori:Sport i Israel
מוסטער:צייט זאנעס אין אייראפע	Mal:Tidssoner i Europa
קאַטעגאָריע:אסטראנויטן	Kategori:Romfarere
קאַטעגאָריע:אייראוויזיאן	Kategori:Eurovision Song Contest
קאַטעגאָריע:געזאנג	Kategori:Sang
קאַטעגאָריע:שוועדישע מענטשן	Kategori:Svensker
קאַטעגאָריע:אינדיער	Kategori:Indere
קאַטעגאָריע:יאפאנעזער	Kategori:Japanere
קאַטעגאָריע:טעאטער	Kategori:Teater
קאַטעגאָריע:אינזשענירן	Kategori:Ingeniører
קאַטעגאָריע:ביזנעסלייט	Kategori:Forretningsfolk
קאַטעגאָריע:לינגוויסטן	Kategori:Lingvister
קאַטעגאָריע:מחברי ספרים	Kategori:Sakprosaforfattere
קאַטעגאָריע:קאמיקער	Kategori:Komikere
קאַטעגאָריע:פרעמיער מיניסטארן פון בריטאניע	Kategori:Britiske premierministre
קאַטעגאָריע:פיליפינען	Kategori:Filippinene
קאַטעגאָריע:ישראלדיקע זינגערס	Kategori:Israelske sangere
קאַטעגאָריע:באַניצער nl	Kategori:Bruker nl
קאַטעגאָריע:באַניצער no	Kategori:Bruker no
קאַטעגאָריע:באַניצער zh-1	Kategori:Bruker zh-1
קאַטעגאָריע:מעכאניק	Kategori:Mekanikk
קאַטעגאָריע:דיפלאמען	Kategori:Akademiske grader
קאַטעגאָריע:ארמעניע	Kategori:Armenia
קאַטעגאָריע:טאליבאן	Kategori:Taliban
קאַטעגאָריע:מלכי פרס	Kategori:Persiske monarker
קאַטעגאָריע:מענטשלעכע אנאטאמיע	Kategori:Menneskets anatomi
קאַטעגאָריע:טעראר	Kategori:Terrorisme
מוסטער:שפראך-yi	Mal:Lang-yi
קאַטעגאָריע:פארזיכערונג	Kategori:Forsikring
קאַטעגאָריע:פובליק אינפארמאציע	Kategori:Informasjon og samfunnskontakt
קאַטעגאָריע:רעפראדוקציע	Kategori:Formering
קאַטעגאָריע:איבונגען	Kategori:Mosjon
קאַטעגאָריע:שרייבן	Kategori:Skrift
קאַטעגאָריע:פינאנץ	Kategori:Finans
קאַטעגאָריע:נאוויגאציע	Kategori:Navigasjon
קאַטעגאָריע:געריכט	Kategori:Domstoler
קאַטעגאָריע:אלטערנאטיווע מעדיצין	Kategori:Alternativ behandling
קאַטעגאָריע:קאמפף קונסט	Kategori:Kampsport
קאַטעגאָריע:טעלעוויזיע	Kategori:TV
קאַטעגאָריע:נייעס	Kategori:Nyheter
קאַטעגאָריע:סיריע	Kategori:Syria
קאַטעגאָריע:באסקעטבאל	Kategori:Basketball
קאַטעגאָריע:בעלגיער	Kategori:Belgiere
קאַטעגאָריע:1550ער	Kategori:Hendelser i 1550-årene
קאַטעגאָריע:1740ער	Kategori:Hendelser i 1740-årene
קאַטעגאָריע:1840ער	Kategori:Hendelser i 1840-årene
קאַטעגאָריע:סקולפטארן	Kategori:Billedhuggere
קאַטעגאָריע:רוסישע פאליטיקער	Kategori:Russiske politikere
קאַטעגאָריע:יארהונדערט	Kategori:Århundrer
קאַטעגאָריע:16טער י"ה	Kategori:1500-tallet
קאַטעגאָריע:18טער י"ה	Kategori:1700-tallet
קאַטעגאָריע:נאציאנאליזם	Kategori:Nasjonalisme
קאַטעגאָריע:ראסיזם	Kategori:Rasisme
קאַטעגאָריע:טויט	Kategori:Døden
קאַטעגאָריע:פארברעכנס	Kategori:Lovbrudd
קאַטעגאָריע:פיאניסטן	Kategori:Pianister
קאַטעגאָריע:האלבאינדזלען	Kategori:Halvøyer
קאַטעגאָריע:דייטשע קאמפאזיטארן	Kategori:Tyske komponister
קאַטעגאָריע:וויעטנאמעזער	Kategori:Vietnamesere
קאַטעגאָריע:אמעריקאנער פאליטיקער	Kategori:Politikere i USA
קאַטעגאָריע:רוסן	Kategori:Russere
קאַטעגאָריע:בריטישע פאליטיקער	Kategori:Britiske politikere
קאַטעגאָריע:סקאטישע מענטשן	Kategori:Skotter
קאַטעגאָריע:ישראלישע פאליטיקער	Kategori:Israelske politikere
קאַטעגאָריע:ישראלים	Kategori:Israelere
קאַטעגאָריע:טשעכן	Kategori:Tsjekkere
קאַטעגאָריע:פיקטיווע כאראקטערן	Kategori:Fiktive personer
קאַטעגאָריע:דורכגאסן	Kategori:Sund
קאַטעגאָריע:קלאסישע מוזיק	Kategori:Klassisk musikk
קאַטעגאָריע:אויג	Kategori:Øyet
קאַטעגאָריע:ציינדאקטעריי	Kategori:Odontologi
קאַטעגאָריע:פליפעלדער	Kategori:Flyplasser
קאַטעגאָריע:צענטראלבענק	Kategori:Sentralbanker
קאַטעגאָריע:2012	Kategori:2012
קאַטעגאָריע:כעמישע עלעמענטן	Kategori:Grunnstoffer
קאַטעגאָריע:ניו יארק סיטי	Kategori:New York
קאַטעגאָריע:לעבאנעזער פאליטיקער	Kategori:Libanesiske politikere
קאַטעגאָריע:וויסנשאפטלער	Kategori:Forskere
קאַטעגאָריע:אויספארשערס	Kategori:Oppdagere
קאַטעגאָריע:ראמאניסטן	Kategori:Romanforfattere
קאַטעגאָריע:משפחה נעמען	Kategori:Etternavn
קאַטעגאָריע:וויקיפעדיע גוטע ארטיקלען	Kategori:Anbefalte artikler
קאַטעגאָריע:מאטעמאטיק שטומף	Kategori:Matematikkstubber
קאַטעגאָריע:ביאלאגיע שטומף	Kategori:Biologistubber
קאַטעגאָריע:געאגראפיע שטומף	Kategori:Geografistubber
קאַטעגאָריע:נאבעל פריז	Kategori:Nobelprisen
קאַטעגאָריע:קערפערליכע פליסיגקייט	Kategori:Kroppsvæsker
קאַטעגאָריע:גרוזיע	Kategori:Georgia
קאַטעגאָריע:כינעזער	Kategori:Kinesere
קאַטעגאָריע:טעראריסטן	Kategori:Terrorister
קאַטעגאָריע:עסקנים	Kategori:Politiske aktivister
קאַטעגאָריע:מטבעות	Kategori:Mynter
קאַטעגאָריע:וויעטנאמעזער פאליטיקער	Kategori:Vietnamesiske politikere
קאַטעגאָריע:איראנער פאליטיקער	Kategori:Iranske politikere
קאַטעגאָריע:פאקיסטאנער פאליטיקער	Kategori:Pakistanske politikere
קאַטעגאָריע:USA מיליטער	Kategori:USAs forsvar
קאַטעגאָריע:רעדאקטארן	Kategori:Redaktører
קאַטעגאָריע:זשורנאליסטן	Kategori:Journalister
קאַטעגאָריע:זשורנאליזם	Kategori:Journalistikk
קאַטעגאָריע:קארעע	Kategori:Korea
קאַטעגאָריע:לבנון	Kategori:Libanon
קאַטעגאָריע:טורקמעניסטאן	Kategori:Turkmenistan
קאַטעגאָריע:אוזבעקיסטאן	Kategori:Usbekistan
קאַטעגאָריע:דאקטוירים	Kategori:Leger
קאַטעגאָריע:דייטשישע זינגערס	Kategori:Tyske sangere
קאַטעגאָריע:שפאניער	Kategori:Spanjoler
קאַטעגאָריע:פאראייניגטע קעניגרייך מוסטערן	Kategori:Britiske maler
קאַטעגאָריע:אמעריקאנער מוסטערן	Kategori:USA-maler
קאַטעגאָריע:ראטנפארבאנד	Kategori:Sovjetunionen
קאַטעגאָריע:איראקער פאליטיקער	Kategori:Irakiske politikere
קאַטעגאָריע:יוגאסלאוויע	Kategori:Jugoslavia
קאַטעגאָריע:וויקיפעדיע ניצלעכקייט מוסטערן	Kategori:Hjelpemaler
קאַטעגאָריע:טראנספארט מוסטערן	Kategori:Transportmaler
קאַטעגאָריע:שפראך שטומף	Kategori:Språkstubber
קאַטעגאָריע:פאליטיק שטומף	Kategori:Politikkstubber
קאַטעגאָריע:היסטאריע שטומף	Kategori:Historiestubber
קאַטעגאָריע:אטמאספערע	Kategori:Atmosfære
קאַטעגאָריע:עקאנאמיק שטומף	Kategori:Økonomistubber
קאַטעגאָריע:וויילס	Kategori:Wales
קאַטעגאָריע:ברוקלין	Kategori:Brooklyn
קאַטעגאָריע:טשעכאסלאוואקיי	Kategori:Tsjekkoslovakia
קאַטעגאָריע:פרעזידענטן פון פראנקרייך	Kategori:Franske presidenter
קאַטעגאָריע:USA פרעזידענטן	Kategori:USAs presidenter
קאַטעגאָריע:פרעזידענטן פון איראן	Kategori:Iranske presidenter
קאַטעגאָריע:אידישע היסטאריע	Kategori:Jødisk historie
קאַטעגאָריע:היסטאריע פון אייראפע	Kategori:Europas historie
קאַטעגאָריע:היסטאריע פון וויסנשאפט	Kategori:Vitenskapshistorie
קאַטעגאָריע:נעווראלאגיע	Kategori:Nevrologi
קאַטעגאָריע:יארדאניע	Kategori:Jordan
קאַטעגאָריע:נארוועגיע	Kategori:Norge
קאַטעגאָריע:פאנאמא	Kategori:Panama
קאַטעגאָריע:אנדארע	Kategori:Andorra
קאַטעגאָריע:סערביע	Kategori:Serbia
קאַטעגאָריע:עקוואדאר	Kategori:Ecuador
קאַטעגאָריע:תימן	Kategori:Jemen
קאַטעגאָריע:באליוויע	Kategori:Bolivia
קאַטעגאָריע:לענדער אין אקעאניע	Kategori:Land i Oseania
קאַטעגאָריע:פיש	Kategori:Fisk
קאַטעגאָריע:מיטאלאגיע	Kategori:Mytologi
קאַטעגאָריע:גרינסן	Kategori:Grønnsaker
קאַטעגאָריע:מילכיקע פראדוקטן	Kategori:Meieriprodukter
קאַטעגאָריע:פרוכט	Kategori:Frukt
קאַטעגאָריע:פאליטישע פארטייען	Kategori:Politiske partier
קאַטעגאָריע:מוזייען	Kategori:Museer
קאַטעגאָריע:קערנפיזיק	Kategori:Kjernefysikk
קאַטעגאָריע:קאטאסטראפע	Kategori:Katastrofer
קאַטעגאָריע:2008 פילמען	Kategori:Filmer fra 2008
קאַטעגאָריע:פראגראם שפראכן	Kategori:Dataspråk
קאַטעגאָריע:היסטארישע לענדער	Kategori:Historiske steder
קאַטעגאָריע:קלימאטאלאגיע	Kategori:Klimatologi
קאַטעגאָריע:געאגראפישע נאוויגאציע מוסטערן	Kategori:Navigasjonsmaler geografi
קאַטעגאָריע:ביליאנערן	Kategori:Milliardærer
קאַטעגאָריע:לאנדאנער אונטערגרונט	Kategori:Londons undergrunnsbane
קאַטעגאָריע:אפערירן סיסטעמען	Kategori:Operativsystemer
קאַטעגאָריע:נומערן סיסטעם	Kategori:Tallsystemer
קאַטעגאָריע:פאליטישע וויסנשאפט	Kategori:Statsvitenskap
קאַטעגאָריע:קאנאדישע פראווינצן און טעריטאריעס	Kategori:Canadas provinser og territorier
קאַטעגאָריע:לאנדאן	Kategori:London
קאַטעגאָריע:אמנאניים	Kategori:Ciklider
קאַטעגאָריע:פאנטאזיע	Kategori:Fantastisk litteratur
קאַטעגאָריע:גריכיש	Kategori:Gresk kultur
קאַטעגאָריע:וויקימעדיע פונדאציע	Kategori:Wikimedia
קאַטעגאָריע:ראדיא	Kategori:Radio
קאַטעגאָריע:סאציאליזם	Kategori:Sosialisme
קאַטעגאָריע:בעלי חיים	Kategori:Dyr
קאַטעגאָריע:פאנעטיק	Kategori:Fonetikk
קאַטעגאָריע:רעפובליקן	Kategori:Republikker
קאַטעגאָריע:וואג	Kategori:Vektenheter
קאַטעגאָריע:טאלן	Kategori:Daler
קאַטעגאָריע:אויער	Kategori:Øre
מוסטער:אמעריקעמיל	Mal:USAs forsvar
קאַטעגאָריע:דעמאגראפיע	Kategori:Demografi
קאַטעגאָריע:מעדיצינישע טערמינען	Kategori:Medisinsk terminologi
קאַטעגאָריע:ראשי תיבות	Kategori:Akronymer
קאַטעגאָריע:סימפטאמען	Kategori:Medisinske symptomer
קאַטעגאָריע:געווער	Kategori:Våpen
קאַטעגאָריע:אייראוויזיאן באטייליקטערס	Kategori:Deltakere i Eurovision Song Contest
קאַטעגאָריע:מעבל	Kategori:Møbler
קאַטעגאָריע:מוזיק אינסטרומענטן	Kategori:Musikkinstrumenter
קאַטעגאָריע:איידלשטיינער	Kategori:Edelstener
קאַטעגאָריע:בליצפאסט	Kategori:E-post
קאַטעגאָריע:מעטעאראלאגיע	Kategori:Meteorologi
קאַטעגאָריע:צענטראלע אמעריקע	Kategori:Sentral-Amerika
קאַטעגאָריע:קאמאנוועלט	Kategori:Samveldet av nasjoner
קאַטעגאָריע:אלקאהאלישע געטראנקען	Kategori:Alkoholholdige drikker
קאַטעגאָריע:וויקיפעדיע טולס	Kategori:Wikipedia-verktøy
קאַטעגאָריע:קליידונג	Kategori:Klær
קאַטעגאָריע:גראפנשאפטן אין ענגלאנד	Kategori:Grevskap i England
קאַטעגאָריע:ברענווארג	Kategori:Brensel
קאַטעגאָריע:רוימישע מיטאלאגיע	Kategori:Romersk mytologi
קאַטעגאָריע:גריכישע מיטאלאגיע	Kategori:Gresk mytologi
קאַטעגאָריע:געוועב	Kategori:Biologisk vev
קאַטעגאָריע:פלייש	Kategori:Kjøtt
קאַטעגאָריע:לידער	Kategori:Sanger
קאַטעגאָריע:הויפטשטעט	Kategori:Hovedsteder
קאַטעגאָריע:שטעט אין גרוזיע	Kategori:Byer i Georgia
קאַטעגאָריע:שטעט אין דער שווייץ	Kategori:Byer i Sveits
קאַטעגאָריע:שטעט אין רוסלאנד	Kategori:Byer i Russland
קאַטעגאָריע:שטעט אין אונגארן	Kategori:Byer i Ungarn
קאַטעגאָריע:שטעט אין קאנאדע	Kategori:Byer i Canada
קאַטעגאָריע:בלוט	Kategori:Blod
קאַטעגאָריע:גאזן	Kategori:Gasser
קאַטעגאָריע:יידישע אויטאנאמע געגנט	Kategori:Den jødiske autonome oblast
קאַטעגאָריע:טעלעקאמוניקאציע	Kategori:Telekommunikasjon
קאַטעגאָריע:ארכעאלאגיע	Kategori:Arkeologi
קאַטעגאָריע:ווארט פראצעסארן	Kategori:Tekstbehandling
קאַטעגאָריע:קרענק	Kategori:Sykdommer
קאַטעגאָריע:באקטערישע קרענק	Kategori:Bakterielle infeksjoner
קאַטעגאָריע:האטעלן	Kategori:Hoteller
קאַטעגאָריע:מעטאלן	Kategori:Metaller
קאַטעגאָריע:עלעקטריע	Kategori:Elektrisitet
קאַטעגאָריע:באַניצער pl	Kategori:Bruker pl
קאַטעגאָריע:טראנספארט	Kategori:Transport
קאַטעגאָריע:טאנץ	Kategori:Dans
קאַטעגאָריע:כאליפן	Kategori:Kalifer
קאַטעגאָריע:משפחה	Kategori:Familie
קאַטעגאָריע:1590ער	Kategori:Hendelser i 1590-årene
קאַטעגאָריע:1620ער	Kategori:Hendelser i 1620-årene
קאַטעגאָריע:1600ער	Kategori:Hendelser i 1600-årene
קאַטעגאָריע:1690ער	Kategori:Hendelser i 1690-årene
קאַטעגאָריע:קאמוניזם	Kategori:Kommunisme
קאַטעגאָריע:קוילנשטאף	Kategori:Karbon
קאַטעגאָריע:שלענג	Kategori:Slanger
קאַטעגאָריע:קיסרים	Kategori:Keisere
קאַטעגאָריע:טיילן פון רעדן	Kategori:Ordklasser
קאַטעגאָריע:אמעריקאנער יידן	Kategori:Jøder fra USA
קאַטעגאָריע:לאגיק	Kategori:Logikk
קאַטעגאָריע:לעגענדעס	Kategori:Legender
קאַטעגאָריע:ריכטער	Kategori:Dommere
קאַטעגאָריע:נומערן טעאריע	Kategori:Tallteori
קאַטעגאָריע:צפון אמעריקע	Kategori:Nord-Amerika
קאַטעגאָריע:זינגער	Kategori:Sangere
קאַטעגאָריע:מדבריות	Kategori:Ørkener
קאַטעגאָריע:אזערעס	Kategori:Innsjøer
קאַטעגאָריע:פאנען	Kategori:Flagg
קאַטעגאָריע:אדוואקאטן	Kategori:Advokater
קאַטעגאָריע:באנקירן	Kategori:Bankierer
קאַטעגאָריע:פוסבאלערס	Kategori:Fotballspillere
קאַטעגאָריע:מאטעמאטיקער	Kategori:Matematikere
קאַטעגאָריע:פיזיקער	Kategori:Fysikere
קאַטעגאָריע:אקעאניע	Kategori:Oseania
קאַטעגאָריע:אונגארישע יידן	Kategori:Ungarske jøder
קאַטעגאָריע:שטעט אין דרום אמעריקע	Kategori:Byer i Sør-Amerika
קאַטעגאָריע:שטעט אין אפריקע	Kategori:Byer i Afrika
קאַטעגאָריע:1830ער	Kategori:Hendelser i 1830-årene
קאַטעגאָריע:מעלות	Kategori:Dyder
קאַטעגאָריע:פיקציע	Kategori:Fiksjon
קאַטעגאָריע:וואסערפאלן	Kategori:Fosser
קאַטעגאָריע:בוענאס איירעס	Kategori:Buenos Aires
קאַטעגאָריע:דעמאקראטיע	Kategori:Demokrati
קאַטעגאָריע:GFDL images	Kategori:GFDL
קאַטעגאָריע:מעדיעוויקי	Kategori:MediaWiki
קאַטעגאָריע:מעדיקאמענטן	Kategori:Legemidler
קאַטעגאָריע:אויטאמאבילן	Kategori:Biler
קאַטעגאָריע:הויפטשטעט אין צפון אמעריקע	Kategori:Hovedsteder i Nord-Amerika
קאַטעגאָריע:שטעט אין צפון אמעריקע	Kategori:Byer i Nord-Amerika
קאַטעגאָריע:הויפטשטעט אין דרום אמעריקע	Kategori:Hovedsteder i Sør-Amerika
קאַטעגאָריע:הויפטשטעט אין אפריקע	Kategori:Hovedsteder i Afrika
קאַטעגאָריע:שטעטלעך אין רומעניע	Kategori:Byer i Romania
קאַטעגאָריע:שטעט אין וויעטנאם	Kategori:Byer i Vietnam
קאַטעגאָריע:שטעט אין בעלגיע	Kategori:Byer i Belgia
קאַטעגאָריע:שטעט אין בראזיל	Kategori:Byer i Brasil
קאַטעגאָריע:שטעט אין שפאניע	Kategori:Byer i Spania
קאַטעגאָריע:שטעט אין אוקראינע	Kategori:Byer i Ukraina
קאַטעגאָריע:שטעט אין איטאליע	Kategori:Byer i Italia
קאַטעגאָריע:שטעט אין ליטע	Kategori:Byer i Litauen
קאַטעגאָריע:היטן	Kategori:Hatter
קאַטעגאָריע:רעגיי זינגערס	Kategori:Reggaemusikere
קאַטעגאָריע:חתונה	Kategori:Ekteskap
קאַטעגאָריע:רציחות	Kategori:Massakrer
קאַטעגאָריע:סקאטלאנד	Kategori:Skottland
קאַטעגאָריע:בריסל	Kategori:Brussel
קאַטעגאָריע:הויפטשטעט אין אייראפע	Kategori:Hovedsteder i Europa
קאַטעגאָריע:הויפטשטעט אין אזיע	Kategori:Hovedsteder i Asia
קאַטעגאָריע:טעם	Kategori:Smak
מוסטער:Babel-10	Mal:Babel-10
קאַטעגאָריע:טורעמס	Kategori:Tårn
קאַטעגאָריע:רעסטאראנען	Kategori:Restauranter
מוסטער:אפיציעלע EU שפראכן	Mal:EUs offisielle språk
קאַטעגאָריע:באל שפילעריי	Kategori:Ballsport
קאַטעגאָריע:בענק	Kategori:Banker
הילף:בלעטער װעלכע פארבינדן אהער	Hjelp:Lenker hit
קאַטעגאָריע:זשורנאלן	Kategori:Vitenskapelige tidsskrifter
קאַטעגאָריע:פערד	Kategori:Hestefamilien
קאַטעגאָריע:ישראל פאלעסטינער קאנפליקט	Kategori:Israel–Palestina-konflikten
מוסטער:פרעמיער מיניסטארן פון ישראל	Mal:Israels statsminister
קאַטעגאָריע:מיטל אלטער	Kategori:Middelalderen
קאַטעגאָריע:קאווקאז	Kategori:Kaukasia
קאַטעגאָריע:מוזיקפילמען	Kategori:Musikaler
קאַטעגאָריע:נאגערס	Kategori:Gnagere
קאַטעגאָריע:אפפאל	Kategori:Avfall
קאַטעגאָריע:מעדיטאציע	Kategori:Meditasjon
קאַטעגאָריע:שולעס	Kategori:Skoler
קאַטעגאָריע:פולער באשיצונג	Kategori:Wikipedia sidebeskyttelse
קאַטעגאָריע:געזונט	Kategori:Helse
קרעמער	Kjøpmann
קאַטעגאָריע:לעגענדע	Kategori:Sagn
הויפטקווארטיר	Hovedkvarter
קאַטעגאָריע:פאליטישע פארטייען אין ישראל	Kategori:Politiske partier i Israel
קאַטעגאָריע:פאפ מוזיק	Kategori:Popmusikk
קאַטעגאָריע:פארט שטעט אינעם פאראייניגטן קעניגרייך	Kategori:Havner i Storbritannia
קאַטעגאָריע:אלבאמען	Kategori:Musikkalbum
גרופע סעקס	Gruppesex
קאַטעגאָריע:וויצע פרעזידענטן	Kategori:Visepresidenter
קאַטעגאָריע:ירושלים בערג	Kategori:Fjell i Jerusalem
קאַטעגאָריע:צייטונגען ארויסגעגעבן אין ישראל	Kategori:Israelske aviser
קאַטעגאָריע:יידישע שרייבער	Kategori:Jødiske forfattere
קאַטעגאָריע:רוסישע יידן	Kategori:Russiske jøder
קאַטעגאָריע:פיזיאלאגיע	Kategori:Fysiologi
מוסטער:בילדונג-שטומף	Mal:Utdanningsstubb
קאַטעגאָריע:ציוניסטן	Kategori:Sionister
גאטקעס	Truse
קאַטעגאָריע:זאא-גערטנער	Kategori:Dyreparker
קאַטעגאָריע:ציוניזם	Kategori:Sionisme
קאַטעגאָריע:שטעטלעך אין אוקראינע	Kategori:Tettsteder i Ukraina
קאַטעגאָריע:פראפעסארן	Kategori:Professorer
קאַטעגאָריע:קאמפאזיטארן	Kategori:Komponister
קאַטעגאָריע:לענדער אין אזיע	Kategori:Land i Asia
מוסטער:קאליפארניע	Mal:California
מוסטער:אינטערסטעיט הייוועיס	Mal:Interstate Highway
קאַטעגאָריע:Windows קאמפאנענטן	Kategori:Windows-komponenter
קאַטעגאָריע:ווייסע הויז	Kategori:Det hvite hus
מוסטער:שפראך-et	Mal:Lang-et
קאַטעגאָריע:פרעמיער מיניסטארן פון רוסלאנד	Kategori:Russiske statsministre
קאַטעגאָריע:טי ווי קאנאלן	Kategori:TV-kanaler
מוסטער:BSpx	Mal:JBSpx
קאַטעגאָריע:וואשינגטאן די סי	Kategori:Washington, DC
קאַטעגאָריע:געזעצן	Kategori:Lover
װיקיפּעדיע:ספעציעלע בלעטער	Hjelp:Spesialside
קאַטעגאָריע:אלגעברע	Kategori:Algebra
קאַטעגאָריע:אריטמעטיק	Kategori:Aritmetikk
קאַטעגאָריע:גענעאלאגן	Kategori:Genealoger
קאַטעגאָריע:סעקס	Kategori:Seksualitet
קאַטעגאָריע:באנוצער מוסטערן	Kategori:Brukerbokser
קאַטעגאָריע:בריקן	Kategori:Broer
קאַטעגאָריע:דארבי	Kategori:Derby
טערמינאלאגיע	Terminologi
קאַטעגאָריע:קאמעדיע	Kategori:Komedier
קאַטעגאָריע:קריג	Kategori:Krig
קאַטעגאָריע:בילדונג שטומף	Kategori:Utdanningsstubber
קאַטעגאָריע:נויטפאל מעדיצין	Kategori:Akuttmedisin
קאַטעגאָריע:ענערגיע	Kategori:Energi
קאַטעגאָריע:סביבה	Kategori:Miljø
קאַטעגאָריע:פליגן	Kategori:Fluer
קאווע שטיבל	Kafeteria
קאַטעגאָריע:גאליציע	Kategori:Galicia (Sentral-Europa)
קאַטעגאָריע:גערמאנישע שפראכן	Kategori:Germanske språk
מוסטער:Precision1	Mal:Precision1
קאַטעגאָריע:הורדוס פאמיליע	Kategori:Herodes-slekten
קאַטעגאָריע:היסטאריע פון ארץ ישראל	Kategori:Palestinas historie
קאַטעגאָריע:הארמאנען	Kategori:Hormoner
קאַטעגאָריע:הומאריסטן	Kategori:Humorister
קאַטעגאָריע:הומאר	Kategori:Humor
קאַטעגאָריע:ריינקייט	Kategori:Hygiene
קאַטעגאָריע:אנארכיזם	Kategori:Anarkisme
קאַטעגאָריע:איסלאמיסטן	Kategori:Islamister
קאַטעגאָריע:ישראל שטומף	Kategori:Israelstubber
װיקיפּעדיע:היסטאריע	Hjelp:Revisjonshistorikk
קאַטעגאָריע:ירושלים	Kategori:Jerusalem
קאַטעגאָריע:פרומע אידישע געגנטן	Kategori:Jødiske samfunn
קאַטעגאָריע:שופטים	Kategori:Dommere i oldtidens Israel
קאַטעגאָריע:ביבליאטעקן	Kategori:Biblioteker
הילף:אינהאלט/באנוצער און קאנטע	Hjelp:Portal/Redigere Wikipedia
הילף:אינהאלט/וויקיפעדיע קהילה	Hjelp:Portal/Wikipedia-samfunnet
הילף:אינהאלט/וואס איז וויקיפעדיע	Hjelp:Komme i gang
הילף:באנוצער'ס אלע טיילונגען	Hjelp:Brukerbidrag
קאַטעגאָריע:ראסע	Kategori:Menneskerase
קאַטעגאָריע:באן טראנספארט אין בעלגיע	Kategori:Jernbane i Belgia
קאַטעגאָריע:באן סטאנציעס	Kategori:Jernbanestasjoner
קאַטעגאָריע:מוניציפאליטעטן אין ניו יארק	Kategori:Kommuner i New York State
קאַטעגאָריע:קליינהאנדל	Kategori:Detaljhandel
קאַטעגאָריע:רוים	Kategori:Roma
קאַטעגאָריע:ארגאנישע כעמיע	Kategori:Organisk kjemi
קאַטעגאָריע:שיפן	Kategori:Skip
קאַטעגאָריע:רויכערונג	Kategori:Røyking
קאַטעגאָריע:סאציאליסטן	Kategori:Sosialister
קאַטעגאָריע:דיכטונגען	Kategori:Dikt
קאַטעגאָריע:אמעריקאנער פרעזידענט וואלן 2008	Kategori:Presidentvalget i USA 2008
קאַטעגאָריע:קילונג	Kategori:Kjøleteknikk
קאַטעגאָריע:פוליצער פרייז	Kategori:Pulitzerpriser
קאַטעגאָריע:מאנטרעאל	Kategori:Montréal
קאַטעגאָריע:מיסטעריעס	Kategori:Mysterier
קאַטעגאָריע:אנטיסעמיטיזם	Kategori:Antisemittisme
קאַטעגאָריע:אמעריקאנער גובערנאטארן	Kategori:USAs guvernører
קאַטעגאָריע:פאראייניגטע שטאטן סענאטארן	Kategori:USAs senatorer
קאַטעגאָריע:תל אביב	Kategori:Tel Aviv
קאַטעגאָריע:טעלעפאניע	Kategori:Telefoni
קאַטעגאָריע:שולן	Kategori:Synagoger
קאַטעגאָריע:סאו פאולא	Kategori:São Paulo
מוסטער:ביר סארטן	Mal:Øltyper
קאַטעגאָריע:באהאמאס	Kategori:Bahamas
קאַטעגאָריע:קאלירן	Kategori:Farge
קאַטעגאָריע:קאכן געצייג	Kategori:Kjøkkenutstyr
קאַטעגאָריע:גלחים	Kategori:Prester
קאַטעגאָריע:אנגעווענדעטע וויסנשאפטן	Kategori:Anvendt vitenskap
קאַטעגאָריע:האלבמעטאלן	Kategori:Halvmetall
מוסטער:בילד קלעבל אנהייב	Mal:Image label begin
קאַטעגאָריע:אפיקורסים	Kategori:Ateister
קאַטעגאָריע:פרעמיער מיניסטארן פון קאנאדע	Kategori:Canadiske premierministre
קאַטעגאָריע:פרעזידענטן פון ישראל	Kategori:Israelske presidenter
קאַטעגאָריע:רעוואלוציעס	Kategori:Revolusjoner
קאַטעגאָריע:זיבנבערגן	Kategori:Transilvania
קאַטעגאָריע:הייצונג	Kategori:Oppvarming
קאַטעגאָריע:שטעט	Kategori:Byer
קאַטעגאָריע:באַניצער yi-0	Kategori:Bruker yi-0
קאַטעגאָריע:באַניצער en-1	Kategori:Bruker en-1
קאַטעגאָריע:באַניצער de-1	Kategori:Bruker de-1
מוסטער:ישראל-שטומף	Mal:Israelstubb
מהללאל	Mahalalel
װיקיפּעדיע:קאנטראלירן בלעטער/Translation	Wikipedia:WikiProject Check Wikipedia/Translation
מוסטער:User nl-4	Mal:Bruker nl-4
מוסטער:User ru-3	Mal:Bruker ru-3
מוסטער:User nl-3	Mal:Bruker nl-3
מוסטער:Sfnref	Mal:SfnRef
סדר	Seder
מוסטער:מדינת ישראל	Mal:Staten Israel
באסטאנער מאראטאן אטאקע	Bombeangrepene ved Boston Marathon 2013
װיקיפּעדיע:וויזועל-רעדאקטירער	Wikipedia:VisualEditor
בין השמשות	Skumring
פימפ	Hallik
פלאטערל	Rhopalocera
הילף:אינהאלט/פאליסיס און אנווייזונגען	Hjelp:Portal/Regler og retningslinjer
מוסטער:Harvard citation/core	Mal:Harvard citation/core
רעטעך	Reddik
מוסטער:סוף	Mal:End
נעקראפאל פון גיזע	Giza nekropolis
מוסטער:Style/ril	Mal:Style/ril
מוסטער:קאנצלער פון דייטשלאנד	Mal:Tysklands forbundskanslere
כלל	Kollektiv
מוסטער:Style/IPA	Mal:Style/IPA
מוסטער:Style/yid	Mal:Style/yid
הילף:אינהאלט/מיטהאלטן ענדערונגן	Hjelp:Portal/Holde rede på endringer
נאריש און נארישער אויך	Dum og dummere To
סעינט ווינסענט	St. Vincent (film)
באַזונדער:לעצטע ענדערונגען	Spesial:Siste endringer
אדאם טשערניאקאוו	Adam Czerniaków
פויסט	Knyttneve
